disease,rag_top_node_id,common_symptoms,total_symptoms,rag_total_symptoms,rag_matches,rag_hallucinations,no_rag_total_symptoms,no_rag_matches,no_rag_hallucinations,rag_accuracy,no_rag_accuracy,rag_precision,rag_recall,no_rag_precision,no_rag_recall
Alexander disease,31783,1,17,54,14,40,15,1,14,0.8235294117647058,0.058823529411764705,0.25925925925925924,0.8235294117647058,0.06666666666666667,0.058823529411764705
Alpha-mannosidosis,99138,21,15,41,1,40,28,1,27,0.06666666666666667,0.06666666666666667,0.024390243902439025,0.06666666666666667,0.03571428571428571,0.06666666666666667
Aspartylglucosaminuria,31742,0,17,17,3,14,24,1,23,0.17647058823529413,0.058823529411764705,0.17647058823529413,0.17647058823529413,0.041666666666666664,0.058823529411764705
Multiple sulfatase deficiency,29444,2,11,16,3,13,22,2,20,0.2727272727272727,0.18181818181818182,0.1875,0.2727272727272727,0.09090909090909091,0.18181818181818182
Beta-mannosidosis,99138,13,6,23,0,23,32,0,32,0.0,0.0,0.0,0.0,0.0,0.0
Canavan disease,30772,3,6,18,3,15,27,1,26,0.5,0.16666666666666666,0.16666666666666666,0.5,0.037037037037037035,0.16666666666666666
Fucosidosis,27474,1,17,26,9,17,25,0,25,0.5294117647058824,0.0,0.34615384615384615,0.5294117647058824,0.0,0.0
Glycogen storage disease due to glycogen debranching enzyme deficiency,38668,17,6,27,2,25,24,2,22,0.3333333333333333,0.3333333333333333,0.07407407407407407,0.3333333333333333,0.08333333333333333,0.3333333333333333
Krabbe disease,33153,2,16,41,6,35,29,2,27,0.375,0.125,0.14634146341463414,0.375,0.06896551724137931,0.125
Glycogen storage disease due to muscle phosphofructokinase deficiency,27292,4,3,18,0,18,26,0,26,0.0,0.0,0.0,0.0,0.0,0.0
Mucopolysaccharidosis type 6,27436,10,13,22,3,19,26,3,23,0.23076923076923078,0.23076923076923078,0.13636363636363635,0.23076923076923078,0.11538461538461539,0.23076923076923078
Sialidosis type 1,33195,0,30,33,10,23,2,0,2,0.3333333333333333,0.0,0.30303030303030304,0.3333333333333333,0.0,0.0
Mucolipidosis type IV,27333,0,13,18,2,16,20,1,19,0.15384615384615385,0.07692307692307693,0.1111111111111111,0.15384615384615385,0.05,0.07692307692307693
Mucolipidosis type III,27333,0,11,18,2,16,19,0,19,0.18181818181818182,0.0,0.1111111111111111,0.18181818181818182,0.0,0.0
Mucopolysaccharidosis type 7,27436,9,14,18,2,16,24,2,22,0.14285714285714285,0.14285714285714285,0.1111111111111111,0.14285714285714285,0.08333333333333333,0.14285714285714285
Recessive X-linked ichthyosis,29420,2,4,18,2,16,23,3,20,0.5,0.75,0.1111111111111111,0.5,0.13043478260869565,0.75
Turner syndrome,32829,6,22,33,8,25,29,5,24,0.36363636363636365,0.22727272727272727,0.24242424242424243,0.36363636363636365,0.1724137931034483,0.22727272727272727
Beta-thalassemia,33434,1,6,23,6,17,25,1,24,1.0,0.16666666666666666,0.2608695652173913,1.0,0.04,0.16666666666666666
Cystic fibrosis,28714,5,7,26,5,21,21,4,17,0.7142857142857143,0.5714285714285714,0.19230769230769232,0.7142857142857143,0.19047619047619047,0.5714285714285714
Alpha-thalassemia,31842,5,2,22,2,20,31,0,31,1.0,0.0,0.09090909090909091,1.0,0.0,0.0
Facioscapulohumeral dystrophy,31356,10,6,21,3,18,18,0,18,0.5,0.0,0.14285714285714285,0.5,0.0,0.0
Emery-Dreifuss muscular dystrophy,27674,1,7,20,4,16,21,0,21,0.5714285714285714,0.0,0.2,0.5714285714285714,0.0,0.0
Kearns-Sayre syndrome,28773,3,3,17,0,17,19,2,17,0.0,0.6666666666666666,0.0,0.0,0.10526315789473684,0.6666666666666666
Thomsen and Becker disease,27944,0,5,17,0,17,21,2,19,0.0,0.4,0.0,0.0,0.09523809523809523,0.4
MERRF,29913,3,7,16,6,10,25,2,23,0.8571428571428571,0.2857142857142857,0.375,0.8571428571428571,0.08,0.2857142857142857
Central core disease,27799,3,0,24,0,24,21,0,21,0.0,0.0,0.0,0.0,0.0,0.0
Marfan syndrome,38220,21,10,27,1,26,24,1,23,0.1,0.1,0.037037037037037035,0.1,0.041666666666666664,0.1
Ataxia-telangiectasia,30665,2,23,19,5,14,29,3,26,0.21739130434782608,0.13043478260869565,0.2631578947368421,0.21739130434782608,0.10344827586206896,0.13043478260869565
Down syndrome,32076,3,14,51,9,42,23,3,20,0.6428571428571429,0.21428571428571427,0.17647058823529413,0.6428571428571429,0.13043478260869565,0.21428571428571427
CHARGE syndrome,31003,3,16,92,11,81,34,3,31,0.6875,0.1875,0.11956521739130435,0.6875,0.08823529411764706,0.1875
Oculocerebrorenal syndrome of Lowe,29016,0,22,24,1,23,32,3,29,0.045454545454545456,0.13636363636363635,0.041666666666666664,0.045454545454545456,0.09375,0.13636363636363635
Retinoblastoma,31883,2,1,21,1,20,25,0,25,1.0,0.0,0.047619047619047616,1.0,0.0,0.0
Fragile X syndrome,27967,5,7,23,2,21,27,0,27,0.2857142857142857,0.0,0.08695652173913043,0.2857142857142857,0.0,0.0
Mucopolysaccharidosis type 1,27436,9,17,19,5,14,22,3,19,0.29411764705882354,0.17647058823529413,0.2631578947368421,0.29411764705882354,0.13636363636363635,0.17647058823529413
Williams syndrome,30529,3,49,189,47,142,30,3,27,0.9591836734693877,0.061224489795918366,0.24867724867724866,0.9591836734693877,0.1,0.061224489795918366
Wolf-Hirschhorn syndrome,32102,5,29,115,27,88,32,5,27,0.9310344827586207,0.1724137931034483,0.23478260869565218,0.9310344827586207,0.15625,0.1724137931034483
Ataxia with vitamin E deficiency,28900,4,7,17,6,11,16,3,13,0.8571428571428571,0.42857142857142855,0.35294117647058826,0.8571428571428571,0.1875,0.42857142857142855
Rheumatic fever,32807,4,5,20,3,17,18,2,16,0.6,0.4,0.15,0.6,0.1111111111111111,0.4
X-linked agammaglobulinemia,38989,12,17,12,0,12,14,0,14,0.0,0.0,0.0,0.0,0.0,0.0
Wiskott-Aldrich syndrome,27973,3,15,22,4,18,26,3,23,0.26666666666666666,0.2,0.18181818181818182,0.26666666666666666,0.11538461538461539,0.2
Hypophosphatasia,29033,1,13,36,7,29,32,2,30,0.5384615384615384,0.15384615384615385,0.19444444444444445,0.5384615384615384,0.0625,0.15384615384615385
Hydrocephalus with stenosis of the aqueduct of Sylvius,94969,17,6,29,2,27,27,1,26,0.3333333333333333,0.16666666666666666,0.06896551724137931,0.3333333333333333,0.037037037037037035,0.16666666666666666
Ornithine transcarbamylase deficiency,31982,2,5,16,5,11,29,2,27,1.0,0.4,0.3125,1.0,0.06896551724137931,0.4
Kennedy disease,28888,4,10,19,8,11,28,2,26,0.8,0.2,0.42105263157894735,0.8,0.07142857142857142,0.2
X-linked retinoschisis,30609,0,6,17,5,12,27,2,25,0.8333333333333334,0.3333333333333333,0.29411764705882354,0.8333333333333334,0.07407407407407407,0.3333333333333333
Hypochondroplasia,98702,14,6,42,1,41,32,1,31,0.16666666666666666,0.16666666666666666,0.023809523809523808,0.16666666666666666,0.03125,0.16666666666666666
X-linked hypohidrotic ectodermal dysplasia,29412,0,9,31,7,24,32,1,31,0.7777777777777778,0.1111111111111111,0.22580645161290322,0.7777777777777778,0.03125,0.1111111111111111
Blue cone monochromatism,30200,5,1,17,1,16,14,0,14,1.0,0.0,0.058823529411764705,1.0,0.0,0.0
Neurofibromatosis type 1,27275,0,15,17,1,16,31,2,29,0.06666666666666667,0.13333333333333333,0.058823529411764705,0.06666666666666667,0.06451612903225806,0.13333333333333333
Non-acquired isolated growth hormone deficiency,33166,13,4,19,4,15,20,2,18,1.0,0.5,0.21052631578947367,1.0,0.1,0.5
Chronic granulomatous disease,97606,10,14,26,1,25,32,4,28,0.07142857142857142,0.2857142857142857,0.038461538461538464,0.07142857142857142,0.125,0.2857142857142857
Homocystinuria due to cystathionine beta-synthase deficiency,29289,0,9,21,1,20,25,2,23,0.1111111111111111,0.2222222222222222,0.047619047619047616,0.1111111111111111,0.08,0.2222222222222222
Lesch-Nyhan syndrome,30283,11,8,21,3,18,28,3,25,0.375,0.375,0.14285714285714285,0.375,0.10714285714285714,0.375
Cystinuria,96566,1,4,1,0,1,12,1,11,0.0,0.25,0.0,0.0,0.08333333333333333,0.25
Monosomy 5p syndrome,33419,4,12,19,2,17,31,2,29,0.16666666666666666,0.16666666666666666,0.10526315789473684,0.16666666666666666,0.06451612903225806,0.16666666666666666
Hereditary neuropathy with liability to pressure palsies,31538,0,2,17,2,15,30,0,30,1.0,0.0,0.11764705882352941,1.0,0.0,0.0
Norrie disease,32083,1,15,54,11,43,20,0,20,0.7333333333333333,0.0,0.2037037037037037,0.7333333333333333,0.0,0.0
Alpha-1-antitrypsin deficiency,30711,5,4,17,4,13,24,2,22,1.0,0.5,0.23529411764705882,1.0,0.08333333333333333,0.5
Hyperkalemic periodic paralysis,28042,10,6,26,1,25,21,0,21,0.16666666666666666,0.0,0.038461538461538464,0.16666666666666666,0.0,0.0
Schwartz-Jampel syndrome,31113,2,26,22,7,15,23,2,21,0.2692307692307692,0.07692307692307693,0.3181818181818182,0.2692307692307692,0.08695652173913043,0.07692307692307693
Diastrophic dysplasia,94720,14,21,38,3,35,33,1,32,0.14285714285714285,0.047619047619047616,0.07894736842105263,0.14285714285714285,0.030303030303030304,0.047619047619047616
Gorlin syndrome,28966,0,5,25,0,25,24,1,23,0.0,0.2,0.0,0.0,0.041666666666666664,0.2
"46,XY difference of sex development due to 17-beta-hydroxysteroid dehydrogenase 3 deficiency",30183,10,7,22,7,15,28,5,23,1.0,0.7142857142857143,0.3181818181818182,1.0,0.17857142857142858,0.7142857142857143
Fibrodysplasia ossificans progressiva,30328,1,12,28,10,18,29,2,27,0.8333333333333334,0.16666666666666666,0.35714285714285715,0.8333333333333334,0.06896551724137931,0.16666666666666666
Peutz-Jeghers syndrome,31798,4,5,24,3,21,21,0,21,0.6,0.0,0.125,0.6,0.0,0.0
Zellweger syndrome,32874,0,25,17,10,7,17,0,17,0.4,0.0,0.5882352941176471,0.4,0.0,0.0
WAGR syndrome,30855,3,1,16,1,15,24,0,24,1.0,0.0,0.0625,1.0,0.0,0.0
Waardenburg syndrome type 2,27569,5,3,27,2,25,37,3,34,0.6666666666666666,1.0,0.07407407407407407,0.6666666666666666,0.08108108108108109,1.0
Waardenburg syndrome type 3,27569,3,13,30,3,27,20,2,18,0.23076923076923078,0.15384615384615385,0.1,0.23076923076923078,0.1,0.15384615384615385
Townes-Brocks syndrome,30460,1,7,17,0,17,27,0,27,0.0,0.0,0.0,0.0,0.0,0.0
Waardenburg syndrome type 1,27569,4,16,31,9,22,28,7,21,0.5625,0.4375,0.2903225806451613,0.5625,0.25,0.4375
Crouzon syndrome,31582,1,5,17,2,15,31,3,28,0.4,0.6,0.11764705882352941,0.4,0.0967741935483871,0.6
Cowden syndrome,28086,3,10,24,2,22,31,0,31,0.2,0.0,0.08333333333333333,0.2,0.0,0.0
Crigler-Najjar syndrome,27412,3,3,17,2,15,32,1,31,0.6666666666666666,0.3333333333333333,0.11764705882352941,0.6666666666666666,0.03125,0.3333333333333333
Coffin-Lowry syndrome,33213,2,31,16,9,7,30,3,27,0.2903225806451613,0.0967741935483871,0.5625,0.2903225806451613,0.1,0.0967741935483871
Blepharophimosis-ptosis-epicanthus inversus syndrome,27485,2,4,17,3,14,25,4,21,0.75,1.0,0.17647058823529413,0.75,0.16,1.0
Hereditary hemorrhagic telangiectasia,28413,2,8,45,9,36,6,2,4,1.125,0.25,0.2,1.125,0.3333333333333333,0.25
Saethre-Chotzen syndrome,31475,0,7,18,2,16,21,3,18,0.2857142857142857,0.42857142857142855,0.1111111111111111,0.2857142857142857,0.14285714285714285,0.42857142857142855
Beckwith-Wiedemann syndrome,98136,13,3,31,0,31,26,0,26,0.0,0.0,0.0,0.0,0.0,0.0
Bartter syndrome,27629,2,2,18,2,16,21,0,21,1.0,0.0,0.1111111111111111,1.0,0.0,0.0
Albers-Schönberg osteopetrosis,27276,3,17,137,17,120,32,3,29,1.0,0.17647058823529413,0.12408759124087591,1.0,0.09375,0.17647058823529413
Aicardi syndrome,30689,0,9,16,1,15,15,1,14,0.1111111111111111,0.1111111111111111,0.0625,0.1111111111111111,0.06666666666666667,0.1111111111111111
Alagille syndrome,98197,16,6,30,1,29,39,2,37,0.16666666666666666,0.3333333333333333,0.03333333333333333,0.16666666666666666,0.05128205128205128,0.3333333333333333
Abetalipoproteinemia,31820,0,6,3,1,2,22,4,18,0.16666666666666666,0.6666666666666666,0.3333333333333333,0.16666666666666666,0.18181818181818182,0.6666666666666666
Cat-eye syndrome,28973,0,3,17,0,17,32,0,32,0.0,0.0,0.0,0.0,0.0,0.0
Ellis Van Creveld syndrome,32108,1,19,25,9,16,26,2,24,0.47368421052631576,0.10526315789473684,0.36,0.47368421052631576,0.07692307692307693,0.10526315789473684
Treacher-Collins syndrome,32816,2,12,20,3,17,17,4,13,0.25,0.3333333333333333,0.15,0.25,0.23529411764705882,0.3333333333333333
Cornelia de Lange syndrome,28431,7,35,156,35,121,39,3,36,1.0,0.08571428571428572,0.22435897435897437,1.0,0.07692307692307693,0.08571428571428572
Apert syndrome,30316,2,13,16,2,14,34,3,31,0.15384615384615385,0.23076923076923078,0.125,0.15384615384615385,0.08823529411764706,0.23076923076923078
Lamellar ichthyosis,30696,6,10,14,6,8,22,5,17,0.6,0.5,0.42857142857142855,0.6,0.22727272727272727,0.5
Menkes disease,31425,0,22,17,2,15,27,2,25,0.09090909090909091,0.09090909090909091,0.11764705882352941,0.09090909090909091,0.07407407407407407,0.09090909090909091
"Microphthalmia, Lenz type",33303,1,1,17,0,17,30,2,28,0.0,2.0,0.0,0.0,0.06666666666666667,2.0
Meckel syndrome,28420,1,6,76,5,71,31,0,31,0.8333333333333334,0.0,0.06578947368421052,0.8333333333333334,0.0,0.0
Triose phosphate-isomerase deficiency,30684,3,4,17,4,13,23,1,22,1.0,0.25,0.23529411764705882,1.0,0.043478260869565216,0.25
Distal monosomy 7q36 syndrome,33264,2,16,17,7,10,25,3,22,0.4375,0.1875,0.4117647058823529,0.4375,0.12,0.1875
Distal deletion 9p syndrome,31535,9,15,66,12,54,44,5,39,0.8,0.3333333333333333,0.18181818181818182,0.8,0.11363636363636363,0.3333333333333333
Trisomy 13 syndrome,98753,6,24,19,3,16,27,2,25,0.125,0.08333333333333333,0.15789473684210525,0.125,0.07407407407407407,0.08333333333333333
Distal duplication 15q syndrome,38960,11,13,33,1,32,22,1,21,0.07692307692307693,0.07692307692307693,0.030303030303030304,0.07692307692307693,0.045454545454545456,0.07692307692307693
Trisomy 18 syndrome,28757,1,30,18,0,18,40,7,33,0.0,0.23333333333333334,0.0,0.0,0.175,0.23333333333333334
Distal duplication 18q syndrome,32995,1,17,27,2,25,17,0,17,0.11764705882352941,0.0,0.07407407407407407,0.11764705882352941,0.0,0.0
Albinism-deafness syndrome,31604,5,4,22,3,19,27,0,27,0.75,0.0,0.13636363636363635,0.75,0.0,0.0
Ermine phenotype,27408,2,3,20,3,17,33,0,33,1.0,0.0,0.15,1.0,0.0,0.0
Ocular albinism with late-onset sensorineural deafness,29706,5,5,17,5,12,19,5,14,1.0,1.0,0.29411764705882354,1.0,0.2631578947368421,1.0
Bruck syndrome,27239,2,6,17,4,13,20,2,18,0.6666666666666666,0.3333333333333333,0.23529411764705882,0.6666666666666666,0.1,0.3333333333333333
Darier disease,31039,3,6,16,2,14,28,2,26,0.3333333333333333,0.3333333333333333,0.125,0.3333333333333333,0.07142857142857142,0.3333333333333333
"46,XY difference of sex development due to 5-alpha-reductase 2 deficiency",31923,4,10,17,9,8,36,3,33,0.9,0.3,0.5294117647058824,0.9,0.08333333333333333,0.3
Isolated complex I deficiency,30935,3,32,44,22,22,20,5,15,0.6875,0.15625,0.5,0.6875,0.25,0.15625
Bethlem muscular dystrophy,30345,5,6,30,4,26,31,2,29,0.6666666666666666,0.3333333333333333,0.13333333333333333,0.6666666666666666,0.06451612903225806,0.3333333333333333
Pentasomy X syndrome,32252,3,2,19,2,17,34,0,34,1.0,0.0,0.10526315789473684,1.0,0.0,0.0
Osteogenesis imperfecta-retinopathy-seizures-intellectual disability syndrome,32372,8,8,24,8,16,27,2,25,1.0,0.25,0.3333333333333333,1.0,0.07407407407407407,0.25
Congenital osteogenesis imperfecta-microcephaly-cataracts syndrome,28337,0,7,24,6,18,15,1,14,0.8571428571428571,0.14285714285714285,0.25,0.8571428571428571,0.06666666666666667,0.14285714285714285
Large/giant congenital melanocytic nevus,94937,14,3,18,4,14,23,4,19,1.3333333333333333,1.3333333333333333,0.2222222222222222,1.3333333333333333,0.17391304347826086,1.3333333333333333
Trisomy 9p syndrome,32458,1,15,17,10,7,41,3,38,0.6666666666666666,0.2,0.5882352941176471,0.6666666666666666,0.07317073170731707,0.2
22q11.2 duplication syndrome,30607,4,0,19,0,19,33,0,33,0.0,0.0,0.0,0.0,0.0,0.0
Tetrasomy 18p syndrome,39347,16,4,27,2,25,32,1,31,0.5,0.25,0.07407407407407407,0.5,0.03125,0.25
Incontinentia pigmenti,31045,7,13,37,6,31,33,2,31,0.46153846153846156,0.15384615384615385,0.16216216216216217,0.46153846153846156,0.06060606060606061,0.15384615384615385
Hereditary orotic aciduria,31298,0,5,22,4,18,20,0,20,0.8,0.0,0.18181818181818182,0.8,0.0,0.0
Acrocallosal syndrome,28425,0,5,68,5,63,12,0,12,1.0,0.0,0.07352941176470588,1.0,0.0,0.0
Succinic semialdehyde dehydrogenase deficiency,28588,1,5,18,5,13,30,1,29,1.0,0.2,0.2777777777777778,1.0,0.03333333333333333,0.2
Mevalonic aciduria,31768,0,13,18,5,13,24,0,24,0.38461538461538464,0.0,0.2777777777777778,0.38461538461538464,0.0,0.0
Neonatal adrenoleukodystrophy,32341,1,21,17,12,5,31,1,30,0.5714285714285714,0.047619047619047616,0.7058823529411765,0.5714285714285714,0.03225806451612903,0.047619047619047616
Alkaptonuria,30238,1,16,16,7,9,21,5,16,0.4375,0.3125,0.4375,0.4375,0.23809523809523808,0.3125
Nager syndrome,27252,1,8,18,4,14,20,0,20,0.5,0.0,0.2222222222222222,0.5,0.0,0.0
Smith-Magenis syndrome,27606,2,31,24,6,18,30,2,28,0.1935483870967742,0.06451612903225806,0.25,0.1935483870967742,0.06666666666666667,0.06451612903225806
Tetrasomy X syndrome,32515,1,0,18,0,18,40,0,40,0.0,0.0,0.0,0.0,0.0,0.0
Refsum disease,31275,1,18,20,9,11,27,2,25,0.5,0.1111111111111111,0.45,0.5,0.07407407407407407,0.1111111111111111
Retinitis pigmentosa-intellectual disability-deafness-hypogonadism syndrome,28195,4,11,28,7,21,42,5,37,0.6363636363636364,0.45454545454545453,0.25,0.6363636363636364,0.11904761904761904,0.45454545454545453
Isovaleric acidemia,28466,5,2,18,2,16,28,0,28,1.0,0.0,0.1111111111111111,1.0,0.0,0.0
Aarskog-Scott syndrome,27534,4,11,65,9,56,32,2,30,0.8181818181818182,0.18181818181818182,0.13846153846153847,0.8181818181818182,0.0625,0.18181818181818182
Chronic mucocutaneous candidiasis,29252,1,14,39,2,37,5,1,4,0.14285714285714285,0.07142857142857142,0.05128205128205128,0.14285714285714285,0.2,0.07142857142857142
Caffey disease,27926,1,2,17,1,16,28,0,28,0.5,0.0,0.058823529411764705,0.5,0.0,0.0
Arthrogryposis-oculomotor limitation-electroretinal anomalies syndrome,27633,3,6,21,2,19,22,1,21,0.3333333333333333,0.16666666666666666,0.09523809523809523,0.3333333333333333,0.045454545454545456,0.16666666666666666
Sheldon-Hall syndrome,33218,0,6,17,4,13,20,0,20,0.6666666666666666,0.0,0.23529411764705882,0.6666666666666666,0.0,0.0
Argininemia,29832,0,5,16,1,15,4,0,4,0.2,0.0,0.0625,0.2,0.0,0.0
Distal arthrogryposis type 1,99362,15,2,29,0,29,32,0,32,0.0,0.0,0.0,0.0,0.0,0.0
Alopecia antibody deficiency,33040,2,7,20,8,12,17,0,17,1.1428571428571428,0.0,0.4,1.1428571428571428,0.0,0.0
Aniridia-cerebellar ataxia-intellectual disability syndrome,28593,3,5,17,5,12,21,2,19,1.0,0.4,0.29411764705882354,1.0,0.09523809523809523,0.4
Blue rubber bleb nevus,97476,8,6,16,0,16,34,1,33,0.0,0.16666666666666666,0.0,0.0,0.029411764705882353,0.16666666666666666
Isolated Dandy-Walker malformation,38226,11,5,24,1,23,31,2,29,0.2,0.4,0.041666666666666664,0.2,0.06451612903225806,0.4
Dihydropteridine reductase deficiency,28246,0,4,18,3,15,28,0,28,0.75,0.0,0.16666666666666666,0.75,0.0,0.0
Argininosuccinic aciduria,30829,2,4,17,2,15,31,1,30,0.5,0.25,0.11764705882352941,0.5,0.03225806451612903,0.25
Carbamoyl-phosphate synthetase 1 deficiency,29186,2,7,18,6,12,25,1,24,0.8571428571428571,0.14285714285714285,0.3333333333333333,0.8571428571428571,0.04,0.14285714285714285
Corpus callosum agenesis-neuronopathy syndrome,31948,2,7,26,6,20,31,2,29,0.8571428571428571,0.2857142857142857,0.23076923076923078,0.8571428571428571,0.06451612903225806,0.2857142857142857
Craniosynostosis-Dandy-Walker malformation-hydrocephalus syndrome,31726,6,9,17,9,8,33,3,30,1.0,0.3333333333333333,0.5294117647058824,1.0,0.09090909090909091,0.3333333333333333
Cutis marmorata telangiectatica congenita,30815,1,9,24,7,17,13,1,12,0.7777777777777778,0.1111111111111111,0.2916666666666667,0.7777777777777778,0.07692307692307693,0.1111111111111111
Cohen syndrome,30788,2,29,18,3,15,8,2,6,0.10344827586206896,0.06896551724137931,0.16666666666666666,0.10344827586206896,0.25,0.06896551724137931
Cooper-Jabs syndrome,30472,0,12,17,5,12,16,0,16,0.4166666666666667,0.0,0.29411764705882354,0.4166666666666667,0.0,0.0
Congenital cataract-hypertrophic cardiomyopathy-mitochondrial myopathy syndrome,29649,4,6,17,4,13,27,2,25,0.6666666666666666,0.3333333333333333,0.23529411764705882,0.6666666666666666,0.07407407407407407,0.3333333333333333
Charlie M syndrome,32176,0,11,17,7,10,21,0,21,0.6363636363636364,0.0,0.4117647058823529,0.6363636363636364,0.0,0.0
Cholestasis-lymphedema syndrome,28982,5,12,20,10,10,29,7,22,0.8333333333333334,0.5833333333333334,0.5,0.8333333333333334,0.2413793103448276,0.5833333333333334
Cleidocranial dysplasia,28472,1,19,43,5,38,18,2,16,0.2631578947368421,0.10526315789473684,0.11627906976744186,0.2631578947368421,0.1111111111111111,0.10526315789473684
Fetal alcohol syndrome,33152,4,10,17,6,11,30,4,26,0.6,0.4,0.35294117647058826,0.6,0.13333333333333333,0.4
Isolated ectopia lentis,29210,10,2,17,1,16,22,0,22,0.5,0.0,0.058823529411764705,0.5,0.0,0.0
Ebstein malformation of the tricuspid valve,28145,2,7,17,5,12,27,1,26,0.7142857142857143,0.14285714285714285,0.29411764705882354,0.7142857142857143,0.037037037037037035,0.14285714285714285
Dyskeratosis congenita,28228,3,9,18,2,16,32,1,31,0.2222222222222222,0.1111111111111111,0.1111111111111111,0.2222222222222222,0.03125,0.1111111111111111
XY type gonadal dysgenesis-associated anomalies syndrome,28132,4,16,19,8,11,21,1,20,0.5,0.0625,0.42105263157894735,0.5,0.047619047619047616,0.0625
Familial dysautonomia,28693,5,12,19,3,16,35,6,29,0.25,0.5,0.15789473684210525,0.25,0.17142857142857143,0.5
Dubowitz syndrome,29628,0,10,19,5,14,11,0,11,0.5,0.0,0.2631578947368421,0.5,0.0,0.0
Diencephalic syndrome,33396,0,5,17,4,13,34,0,34,0.8,0.0,0.23529411764705882,0.8,0.0,0.0
Encephalopathy due to sulfite oxidase deficiency,33016,1,20,17,17,0,22,2,20,0.85,0.1,1.0,0.85,0.09090909090909091,0.1
Pyruvate dehydrogenase deficiency,31168,5,5,31,3,28,24,1,23,0.6,0.2,0.0967741935483871,0.6,0.041666666666666664,0.2
Isolated glycerol kinase deficiency,33481,5,11,17,9,8,19,3,16,0.8181818181818182,0.2727272727272727,0.5294117647058824,0.8181818181818182,0.15789473684210525,0.2727272727272727
Congenital diaphragmatic hernia,30076,12,1,28,0,28,34,0,34,0.0,0.0,0.0,0.0,0.0,0.0
Congenital hydrocephalus,28443,0,1,15,0,15,29,0,29,0.0,0.0,0.0,0.0,0.0,0.0
Neonatal hemochromatosis,30776,2,11,26,10,16,26,1,25,0.9090909090909091,0.09090909090909091,0.38461538461538464,0.9090909090909091,0.038461538461538464,0.09090909090909091
Cutaneous mastocytosis-deafness-microtia syndrome,31577,7,31,26,3,23,28,7,21,0.0967741935483871,0.22580645161290322,0.11538461538461539,0.0967741935483871,0.25,0.22580645161290322
Hartnup disease,31907,0,11,15,7,8,6,0,6,0.6363636363636364,0.0,0.4666666666666667,0.6363636363636364,0.0,0.0
Hawkinsinuria,30083,0,7,13,6,7,33,0,33,0.8571428571428571,0.0,0.46153846153846156,0.8571428571428571,0.0,0.0
Galactosialidosis,28079,2,9,16,11,5,28,2,26,1.2222222222222223,0.2222222222222222,0.6875,1.2222222222222223,0.07142857142857142,0.2222222222222222
Congenital fiber-type disproportion myopathy,31446,0,3,39,2,37,17,0,17,0.6666666666666666,0.0,0.05128205128205128,0.6666666666666666,0.0,0.0
Freeman-Sheldon syndrome,30510,0,16,22,5,17,18,1,17,0.3125,0.0625,0.22727272727272727,0.3125,0.05555555555555555,0.0625
"Mitochondrial DNA depletion syndrome, encephalomyopathic form with methylmalonic aciduria",29645,6,23,41,16,25,32,6,26,0.6956521739130435,0.2608695652173913,0.3902439024390244,0.6956521739130435,0.1875,0.2608695652173913
Fetal parvovirus syndrome,32419,4,4,23,4,19,26,2,24,1.0,0.5,0.17391304347826086,1.0,0.07692307692307693,0.5
Frontal encephalocele,98223,13,2,17,1,16,21,1,20,0.5,0.5,0.058823529411764705,0.5,0.047619047619047616,0.5
Congenital pulmonary airway malformation,33235,11,1,22,1,21,25,0,25,1.0,0.0,0.045454545454545456,1.0,0.0,0.0
Congenital macroglossia,28733,8,1,23,1,22,22,1,21,1.0,1.0,0.043478260869565216,1.0,0.045454545454545456,1.0
Moebius syndrome,32744,2,9,16,3,13,16,1,15,0.3333333333333333,0.1111111111111111,0.1875,0.3333333333333333,0.0625,0.1111111111111111
MASA syndrome,28587,0,9,22,9,13,36,0,36,1.0,0.0,0.4090909090909091,1.0,0.0,0.0
Marshall syndrome,32039,1,19,18,6,12,24,1,23,0.3157894736842105,0.05263157894736842,0.3333333333333333,0.3157894736842105,0.041666666666666664,0.05263157894736842
Neuroblastoma,37927,17,3,21,0,21,22,0,22,0.0,0.0,0.0,0.0,0.0,0.0
Thanatophoric dysplasia,30963,7,15,26,3,23,30,2,28,0.2,0.13333333333333333,0.11538461538461539,0.2,0.06666666666666667,0.13333333333333333
Metatropic dysplasia,33376,0,19,18,3,15,30,0,30,0.15789473684210525,0.0,0.16666666666666666,0.15789473684210525,0.0,0.0
Proximal myotonic myopathy,31717,0,6,14,0,14,18,0,18,0.0,0.0,0.0,0.0,0.0,0.0
Opsismodysplasia,29407,2,17,43,16,27,40,0,40,0.9411764705882353,0.0,0.37209302325581395,0.9411764705882353,0.0,0.0
Horizontal gaze palsy with progressive scoliosis,32396,7,3,21,3,18,31,4,27,1.0,1.3333333333333333,0.14285714285714285,1.0,0.12903225806451613,1.3333333333333333
Omphalocele,31866,6,4,18,0,18,20,0,20,0.0,0.0,0.0,0.0,0.0,0.0
Linear nevus sebaceus syndrome,28650,0,21,32,13,19,8,0,8,0.6190476190476191,0.0,0.40625,0.6190476190476191,0.0,0.0
Multiple intestinal atresia,27914,8,2,16,1,15,26,0,26,0.5,0.0,0.0625,0.5,0.0,0.0
Congenital short bowel syndrome,33057,8,1,16,1,15,31,0,31,1.0,0.0,0.0625,1.0,0.0,0.0
Hypoplastic left heart syndrome,28836,4,1,20,1,19,20,0,20,1.0,0.0,0.05,1.0,0.0,0.0
Foveal hypoplasia-presenile cataract syndrome,33513,5,6,23,9,14,26,3,23,1.5,0.5,0.391304347826087,1.5,0.11538461538461539,0.5
Jacobsen syndrome,31052,0,6,84,7,77,18,0,18,1.1666666666666667,0.0,0.08333333333333333,1.1666666666666667,0.0,0.0
Larsen-like osseous dysplasia-short stature syndrome,29567,4,11,38,8,30,38,4,34,0.7272727272727273,0.36363636363636365,0.21052631578947367,0.7272727272727273,0.10526315789473684,0.36363636363636365
Congenital laryngomalacia,31645,16,2,29,2,27,29,1,28,1.0,0.5,0.06896551724137931,1.0,0.034482758620689655,0.5
Trichorhinophalangeal syndrome type 2,27224,0,13,93,13,80,18,0,18,1.0,0.0,0.13978494623655913,1.0,0.0,0.0
Congenital pulmonary lymphangiectasia,27545,5,3,16,3,13,28,2,26,1.0,0.6666666666666666,0.1875,1.0,0.07142857142857142,0.6666666666666666
Isolated congenital laryngeal web,31972,9,4,18,4,14,33,1,32,1.0,0.25,0.2222222222222222,1.0,0.030303030303030304,0.25
Laurence-Moon syndrome,29982,0,5,17,4,13,10,0,10,0.8,0.0,0.23529411764705882,0.8,0.0,0.0
Schizencephaly,30348,3,5,21,5,16,19,0,19,1.0,0.0,0.23809523809523808,1.0,0.0,0.0
Silver-Russell syndrome,32863,3,10,18,4,14,35,2,33,0.4,0.2,0.2222222222222222,0.4,0.05714285714285714,0.2
Multiple sclerosis-ichthyosis-factor VIII deficiency syndrome,32289,6,11,20,11,9,31,1,30,1.0,0.09090909090909091,0.55,1.0,0.03225806451612903,0.09090909090909091
Sjögren-Larsson syndrome,27310,0,10,17,7,10,39,2,37,0.7,0.2,0.4117647058823529,0.7,0.05128205128205128,0.2
Sirenomelia,32287,0,6,26,5,21,9,0,9,0.8333333333333334,0.0,0.19230769230769232,0.8333333333333334,0.0,0.0
Infantile spasms-broad thumbs syndrome,32276,0,15,22,13,9,49,1,48,0.8666666666666667,0.06666666666666667,0.5909090909090909,0.8666666666666667,0.02040816326530612,0.06666666666666667
Stormorken-Sjaastad-Langslet syndrome,31514,0,12,22,6,16,42,0,42,0.5,0.0,0.2727272727272727,0.5,0.0,0.0
Congenital toxoplasmosis,32823,5,2,16,2,14,21,0,21,1.0,0.0,0.125,1.0,0.0,0.0
Thrombocytopenia-absent radius syndrome,27287,1,3,18,2,16,26,1,25,0.6666666666666666,0.3333333333333333,0.1111111111111111,0.6666666666666666,0.038461538461538464,0.3333333333333333
Tracheal agenesis,32543,5,5,23,6,17,26,2,24,1.2,0.4,0.2608695652173913,1.2,0.07692307692307693,0.4
VACTERL/VATER association,30889,3,5,47,4,43,22,1,21,0.8,0.2,0.0851063829787234,0.8,0.045454545454545456,0.2
Congenital varicella syndrome,32424,10,2,21,2,19,31,0,31,1.0,0.0,0.09523809523809523,1.0,0.0,0.0
Juvenile Paget disease,31137,0,10,16,6,10,27,1,26,0.6,0.1,0.375,0.6,0.037037037037037035,0.1
Tetrasomy 12p syndrome,38887,12,18,21,2,19,27,2,25,0.1111111111111111,0.1111111111111111,0.09523809523809523,0.1111111111111111,0.07407407407407407,0.1111111111111111
Pendred syndrome,32139,2,4,17,4,13,43,1,42,1.0,0.25,0.23529411764705882,1.0,0.023255813953488372,0.25
Neuralgic amyotrophy,33286,4,6,17,3,14,16,0,16,0.5,0.0,0.17647058823529413,0.5,0.0,0.0
Familial spontaneous pneumothorax,30499,15,3,23,3,20,20,0,20,1.0,0.0,0.13043478260869565,1.0,0.0,0.0
Proteus syndrome,29044,1,27,18,7,11,31,1,30,0.25925925925925924,0.037037037037037035,0.3888888888888889,0.25925925925925924,0.03225806451612903,0.037037037037037035
Prune belly syndrome,27929,0,9,30,5,25,22,2,20,0.5555555555555556,0.2222222222222222,0.16666666666666666,0.5555555555555556,0.09090909090909091,0.2222222222222222
Peroxisomal acyl-CoA oxidase deficiency,30385,2,15,20,8,12,22,1,21,0.5333333333333333,0.06666666666666667,0.4,0.5333333333333333,0.045454545454545456,0.06666666666666667
Difference of sex development-intellectual disability syndrome,31549,2,23,30,20,10,30,3,27,0.8695652173913043,0.13043478260869565,0.6666666666666666,0.8695652173913043,0.1,0.13043478260869565
Costello syndrome,29157,1,19,19,3,16,28,0,28,0.15789473684210525,0.0,0.15789473684210525,0.15789473684210525,0.0,0.0
Congenital rubella syndrome,32425,2,4,17,1,16,23,1,22,0.25,0.25,0.058823529411764705,0.25,0.043478260869565216,0.25
Free sialic acid storage disease,29492,1,10,17,2,15,32,2,30,0.2,0.2,0.11764705882352941,0.2,0.0625,0.2
Osteogenesis imperfecta,27158,4,18,123,10,113,29,1,28,0.5555555555555556,0.05555555555555555,0.08130081300813008,0.5555555555555556,0.034482758620689655,0.05555555555555555
Mucopolysaccharidosis type 3,27436,10,12,21,2,19,22,0,22,0.16666666666666666,0.0,0.09523809523809523,0.16666666666666666,0.0,0.0
Hirschsprung disease,27867,0,6,17,1,16,22,3,19,0.16666666666666666,0.5,0.058823529411764705,0.16666666666666666,0.13636363636363635,0.5
Glycogen storage disease due to glucose-6-phosphatase deficiency,27295,8,10,18,4,14,23,4,19,0.4,0.4,0.2222222222222222,0.4,0.17391304347826086,0.4
Gaucher disease,28772,3,5,38,2,36,28,4,24,0.4,0.8,0.05263157894736842,0.4,0.14285714285714285,0.8
GM1 gangliosidosis,27167,2,17,16,1,15,41,0,41,0.058823529411764705,0.0,0.0625,0.058823529411764705,0.0,0.0
Waardenburg syndrome,27569,4,9,24,3,21,24,2,22,0.3333333333333333,0.2222222222222222,0.125,0.3333333333333333,0.08333333333333333,0.2222222222222222
Usher syndrome,27268,5,10,17,4,13,24,2,22,0.4,0.2,0.23529411764705882,0.4,0.08333333333333333,0.2
Retinitis pigmentosa,38253,11,13,19,4,15,27,4,23,0.3076923076923077,0.3076923076923077,0.21052631578947367,0.3076923076923077,0.14814814814814814,0.3076923076923077
Pelizaeus-Merzbacher disease,32148,12,17,28,6,22,23,8,15,0.35294117647058826,0.47058823529411764,0.21428571428571427,0.35294117647058826,0.34782608695652173,0.47058823529411764
X-linked recessive ocular albinism,30734,5,6,16,4,12,23,3,20,0.6666666666666666,0.5,0.25,0.6666666666666666,0.13043478260869565,0.5
Phenylketonuria,31918,3,1,20,0,20,38,0,38,0.0,0.0,0.0,0.0,0.0,0.0
Chondrodysplasia-difference of sex development syndrome,38558,22,14,35,1,34,44,1,43,0.07142857142857142,0.07142857142857142,0.02857142857142857,0.07142857142857142,0.022727272727272728,0.07142857142857142
Weaver syndrome,28188,2,22,16,6,10,32,3,29,0.2727272727272727,0.13636363636363635,0.375,0.2727272727272727,0.09375,0.13636363636363635
Fanconi anemia,32319,1,13,31,6,25,27,2,25,0.46153846153846156,0.15384615384615385,0.1935483870967742,0.46153846153846156,0.07407407407407407,0.15384615384615385
Familial isolated dilated cardiomyopathy,32609,10,2,29,1,28,19,0,19,0.5,0.0,0.034482758620689655,0.5,0.0,0.0
Eosinophilic fasciitis,31808,3,10,16,9,7,27,2,25,0.9,0.2,0.5625,0.9,0.07407407407407407,0.2
Granulomatosis with polyangiitis,32099,10,17,94,18,76,21,4,17,1.0588235294117647,0.23529411764705882,0.19148936170212766,1.0588235294117647,0.19047619047619047,0.23529411764705882
Immunoglobulin A vasculitis,32987,8,10,17,3,14,33,6,27,0.3,0.6,0.17647058823529413,0.3,0.18181818181818182,0.6
Anti-glomerular basement membrane disease,38482,18,11,22,5,17,23,4,19,0.45454545454545453,0.36363636363636365,0.22727272727272727,0.45454545454545453,0.17391304347826086,0.36363636363636365
Microscopic polyangiitis,33208,3,13,17,6,11,16,4,12,0.46153846153846156,0.3076923076923077,0.35294117647058826,0.46153846153846156,0.25,0.3076923076923077
Locked-in syndrome,33246,3,12,19,11,8,36,3,33,0.9166666666666666,0.25,0.5789473684210527,0.9166666666666666,0.08333333333333333,0.25
Congenital herpes simplex virus infection,32426,10,0,26,0,26,30,0,30,0.0,0.0,0.0,0.0,0.0,0.0
Congenital lobar emphysema,30057,9,2,20,2,18,20,1,19,1.0,0.5,0.1,1.0,0.05,0.5
Takayasu arteritis,32123,3,9,16,3,13,28,3,25,0.3333333333333333,0.3333333333333333,0.1875,0.3333333333333333,0.10714285714285714,0.3333333333333333
Dubin-Johnson syndrome,29712,7,5,24,7,17,22,3,19,1.4,0.6,0.2916666666666667,1.4,0.13636363636363635,0.6
Whipple disease,33359,5,13,17,5,12,29,8,21,0.38461538461538464,0.6153846153846154,0.29411764705882354,0.38461538461538464,0.27586206896551724,0.6153846153846154
Kawasaki disease,33038,5,8,21,2,19,30,1,29,0.25,0.125,0.09523809523809523,0.25,0.03333333333333333,0.125
Congenital respiratory-biliary fistula,32507,15,2,22,2,20,27,0,27,1.0,0.0,0.09090909090909091,1.0,0.0,0.0
Congenital atransferrinemia,29483,5,1,20,1,19,28,1,27,1.0,1.0,0.05,1.0,0.03571428571428571,1.0
Multiminicore myopathy,27748,0,3,19,3,16,26,0,26,1.0,0.0,0.15789473684210525,1.0,0.0,0.0
Polymyositis,32978,6,9,25,6,19,16,0,16,0.6666666666666666,0.0,0.24,0.6666666666666666,0.0,0.0
Dermatomyositis,28745,2,10,19,4,15,12,2,10,0.4,0.2,0.21052631578947367,0.4,0.16666666666666666,0.2
Behçet disease,30171,5,14,65,12,53,28,5,23,0.8571428571428571,0.35714285714285715,0.18461538461538463,0.8571428571428571,0.17857142857142858,0.35714285714285715
Oculopharyngeal muscular dystrophy,27548,1,9,23,7,16,3,2,1,0.7777777777777778,0.2222222222222222,0.30434782608695654,0.7777777777777778,0.6666666666666666,0.2222222222222222
Alpha-N-acetylgalactosaminidase deficiency,28665,0,8,25,4,21,2,0,2,0.5,0.0,0.16,0.5,0.0,0.0
Inclusion body myositis,30448,4,10,16,9,7,22,1,21,0.9,0.1,0.5625,0.9,0.045454545454545456,0.1
Larynx atresia,31647,9,4,21,4,17,27,2,25,1.0,0.5,0.19047619047619047,1.0,0.07407407407407407,0.5
Allergic bronchopulmonary aspergillosis,31008,6,4,20,2,18,21,1,20,0.5,0.25,0.1,0.5,0.047619047619047616,0.25
Eosinophilic granulomatosis with polyangiitis,32099,4,12,17,2,15,30,3,27,0.16666666666666666,0.25,0.11764705882352941,0.16666666666666666,0.1,0.25
Maple syrup urine disease,95137,17,9,25,2,23,25,1,24,0.2222222222222222,0.1111111111111111,0.08,0.2222222222222222,0.04,0.1111111111111111
Methylmalonic acidemia with homocystinuria,33171,7,12,20,5,15,38,2,36,0.4166666666666667,0.16666666666666666,0.25,0.4166666666666667,0.05263157894736842,0.16666666666666666
Glutathione synthetase deficiency,31963,10,5,24,1,23,36,0,36,0.2,0.0,0.041666666666666664,0.2,0.0,0.0
X-linked alpha-thalassemia-intellectual disability syndrome,31249,2,14,75,9,66,24,2,22,0.6428571428571429,0.14285714285714285,0.12,0.6428571428571429,0.08333333333333333,0.14285714285714285
Familial Mediterranean fever,32202,6,6,17,5,12,32,5,27,0.8333333333333334,0.8333333333333334,0.29411764705882354,0.8333333333333334,0.15625,0.8333333333333334
Simpson-Golabi-Behmel syndrome,30745,4,21,124,19,105,24,2,22,0.9047619047619048,0.09523809523809523,0.1532258064516129,0.9047619047619048,0.08333333333333333,0.09523809523809523
Multiple symmetric lipomatosis,28575,0,4,17,4,13,15,2,13,1.0,0.5,0.23529411764705882,1.0,0.13333333333333333,0.5
Dermatitis herpetiformis,33410,8,11,17,8,9,22,6,16,0.7272727272727273,0.5454545454545454,0.47058823529411764,0.7272727272727273,0.2727272727272727,0.5454545454545454
Mucopolysaccharidosis type 4,27436,10,17,20,3,17,22,2,20,0.17647058823529413,0.11764705882352941,0.15,0.17647058823529413,0.09090909090909091,0.11764705882352941
Giant cell arteritis,27692,1,10,20,5,15,20,2,18,0.5,0.2,0.25,0.5,0.1,0.2
Budd-Chiari syndrome,31637,6,3,17,3,14,24,1,23,1.0,0.3333333333333333,0.17647058823529413,1.0,0.041666666666666664,0.3333333333333333
Niemann-Pick disease type C,98094,8,10,32,2,30,23,1,22,0.2,0.1,0.0625,0.2,0.043478260869565216,0.1
Nephroblastoma,33158,9,3,17,2,15,21,0,21,0.6666666666666666,0.0,0.11764705882352941,0.6666666666666666,0.0,0.0
Legg-Calvé-Perthes disease,31228,1,8,22,8,14,20,0,20,1.0,0.0,0.36363636363636365,1.0,0.0,0.0
Rabies,32981,2,15,16,11,5,29,4,25,0.7333333333333333,0.26666666666666666,0.6875,0.7333333333333333,0.13793103448275862,0.26666666666666666
Botulism,32729,6,11,20,10,10,24,3,21,0.9090909090909091,0.2727272727272727,0.5,0.9090909090909091,0.125,0.2727272727272727
Legionnaires disease,33292,2,6,17,4,13,19,3,16,0.6666666666666666,0.5,0.23529411764705882,0.6666666666666666,0.15789473684210525,0.5
Wolfram syndrome,31066,2,5,16,1,15,32,3,29,0.2,0.6,0.0625,0.2,0.09375,0.6
Pemphigus vulgaris,30998,3,10,12,9,3,20,4,16,0.9,0.4,0.75,0.9,0.2,0.4
Autosomal dominant hyper-IgE syndrome due to STAT3 deficiency,31806,5,9,16,5,11,26,2,24,0.5555555555555556,0.2222222222222222,0.3125,0.5555555555555556,0.07692307692307693,0.2222222222222222
Stickler syndrome,32565,3,18,25,9,16,17,2,15,0.5,0.1111111111111111,0.36,0.5,0.11764705882352941,0.1111111111111111
Tetralogy of Fallot,27857,2,5,17,4,13,25,0,25,0.8,0.0,0.23529411764705882,0.8,0.0,0.0
Bazex-Dupré-Christol syndrome,30212,2,1,25,1,24,30,0,30,1.0,0.0,0.04,1.0,0.0,0.0
"46,XX gonadal dysgenesis",38652,20,8,27,5,22,31,3,28,0.625,0.375,0.18518518518518517,0.625,0.0967741935483871,0.375
ICF syndrome,39876,12,6,27,0,27,24,0,24,0.0,0.0,0.0,0.0,0.0,0.0
Holt-Oram syndrome,31211,1,4,21,1,20,40,1,39,0.25,0.25,0.047619047619047616,0.25,0.025,0.25
Roberts syndrome,32857,1,18,16,6,10,26,1,25,0.3333333333333333,0.05555555555555555,0.375,0.3333333333333333,0.038461538461538464,0.05555555555555555
Uveal coloboma-cleft lip and palate-intellectual disability,31143,9,2,22,1,21,24,0,24,0.5,0.0,0.045454545454545456,0.5,0.0,0.0
Cherubism,27195,1,4,17,2,15,28,0,28,0.5,0.0,0.11764705882352941,0.5,0.0,0.0
Caudal regression syndrome,32697,0,9,17,4,13,2,0,2,0.4444444444444444,0.0,0.23529411764705882,0.4444444444444444,0.0,0.0
Werner syndrome,32590,5,15,37,10,27,26,4,22,0.6666666666666666,0.26666666666666666,0.2702702702702703,0.6666666666666666,0.15384615384615385,0.26666666666666666
Waardenburg-Shah syndrome,32808,3,14,17,11,6,26,4,22,0.7857142857142857,0.2857142857142857,0.6470588235294118,0.7857142857142857,0.15384615384615385,0.2857142857142857
Familial progressive cardiac conduction defect,28103,4,0,17,0,17,17,0,17,0.0,0.0,0.0,0.0,0.0,0.0
Peters plus syndrome,30639,1,22,104,20,84,47,1,46,0.9090909090909091,0.045454545454545456,0.19230769230769232,0.9090909090909091,0.02127659574468085,0.045454545454545456
LCAT deficiency,33178,5,3,23,0,23,23,1,22,0.0,0.3333333333333333,0.0,0.0,0.043478260869565216,0.3333333333333333
Choroideremia,96981,22,5,28,2,26,31,2,29,0.4,0.4,0.07142857142857142,0.4,0.06451612903225806,0.4
Neurofibromatosis-Noonan syndrome,30868,2,13,18,4,14,39,1,38,0.3076923076923077,0.07692307692307693,0.2222222222222222,0.3076923076923077,0.02564102564102564,0.07692307692307693
Liddle syndrome,28419,6,4,16,4,12,25,3,22,1.0,0.75,0.25,1.0,0.12,0.75
Campomelic dysplasia,28683,2,21,55,21,34,30,2,28,1.0,0.09523809523809523,0.38181818181818183,1.0,0.06666666666666667,0.09523809523809523
Nance-Horan syndrome,32072,1,10,17,7,10,25,3,22,0.7,0.3,0.4117647058823529,0.7,0.12,0.3
Netherton syndrome,29333,4,14,37,8,29,25,3,22,0.5714285714285714,0.21428571428571427,0.21621621621621623,0.5714285714285714,0.12,0.21428571428571427
Hereditary sensory and autonomic neuropathy type 4,27625,9,9,32,4,28,44,0,44,0.4444444444444444,0.0,0.125,0.4444444444444444,0.0,0.0
Non-distal duplication 10q syndrome,39196,12,15,26,1,25,46,1,45,0.06666666666666667,0.06666666666666667,0.038461538461538464,0.06666666666666667,0.021739130434782608,0.06666666666666667
Trisomy 12p syndrome,33391,3,20,29,19,10,40,1,39,0.95,0.05,0.6551724137931034,0.95,0.025,0.05
3q13 microdeletion syndrome,33028,2,17,23,0,23,28,1,27,0.0,0.058823529411764705,0.0,0.0,0.03571428571428571,0.058823529411764705
Xp22.3 microdeletion syndrome,33253,4,3,24,3,21,25,1,24,1.0,0.3333333333333333,0.125,1.0,0.04,0.3333333333333333
Distal deletion 17q syndrome,32575,0,31,17,16,1,36,3,33,0.5161290322580645,0.0967741935483871,0.9411764705882353,0.5161290322580645,0.08333333333333333,0.0967741935483871
Distal deletion 3p syndrome,28213,4,7,18,3,15,34,2,32,0.42857142857142855,0.2857142857142857,0.16666666666666666,0.42857142857142855,0.058823529411764705,0.2857142857142857
Monosomy 13q14 syndrome,32684,1,8,31,2,29,17,2,15,0.25,0.25,0.06451612903225806,0.25,0.11764705882352941,0.25
Distal deletion 10p syndrome,30426,7,5,28,2,26,29,1,28,0.4,0.2,0.07142857142857142,0.4,0.034482758620689655,0.2
Non-distal deletion 10q syndrome,29728,3,7,25,4,21,30,3,27,0.5714285714285714,0.42857142857142855,0.16,0.5714285714285714,0.1,0.42857142857142855
Ring chromosome 8 syndrome,32385,0,14,20,0,20,28,1,27,0.0,0.07142857142857142,0.0,0.0,0.03571428571428571,0.07142857142857142
Currarino syndrome,29008,0,2,18,1,17,32,0,32,0.5,0.0,0.05555555555555555,0.5,0.0,0.0
Ring chromosome 4 syndrome,32375,2,1,24,0,24,30,0,30,0.0,0.0,0.0,0.0,0.0,0.0
Ring chromosome 6 syndrome,32374,7,11,20,10,10,33,1,32,0.9090909090909091,0.09090909090909091,0.5,0.9090909090909091,0.030303030303030304,0.09090909090909091
Ring chromosome 1 syndrome,32387,3,13,19,12,7,39,1,38,0.9230769230769231,0.07692307692307693,0.631578947368421,0.9230769230769231,0.02564102564102564,0.07692307692307693
Ring chromosome 10 syndrome,32386,1,24,17,17,0,31,1,30,0.7083333333333334,0.041666666666666664,1.0,0.7083333333333334,0.03225806451612903,0.041666666666666664
Progressive familial intrahepatic cholestasis,32629,3,9,15,6,9,25,3,22,0.6666666666666666,0.3333333333333333,0.4,0.6666666666666666,0.12,0.3333333333333333
Carey-Fineman-Ziter syndrome,31811,0,15,58,15,43,23,0,23,1.0,0.0,0.25862068965517243,1.0,0.0,0.0
Heart defects-limb shortening syndrome,30939,2,8,16,6,10,32,3,29,0.75,0.375,0.375,0.75,0.09375,0.375
C syndrome,31628,0,20,66,17,49,10,0,10,0.85,0.0,0.25757575757575757,0.85,0.0,0.0
Barth syndrome,30347,1,1,24,0,24,31,0,31,0.0,0.0,0.0,0.0,0.0,0.0
"48,XXYY syndrome",32250,2,7,45,6,39,29,3,26,0.8571428571428571,0.42857142857142855,0.13333333333333333,0.8571428571428571,0.10344827586206896,0.42857142857142855
Fraser syndrome,30452,1,8,24,0,24,26,0,26,0.0,0.0,0.0,0.0,0.0,0.0
"46,XY complete gonadal dysgenesis",38781,18,4,31,1,30,35,2,33,0.25,0.5,0.03225806451612903,0.25,0.05714285714285714,0.5
Léri-Weill dyschondrosteosis,30851,0,34,33,21,12,29,0,29,0.6176470588235294,0.0,0.6363636363636364,0.6176470588235294,0.0,0.0
Autosomal recessive spondylocostal dysostosis,29480,1,13,24,8,16,26,4,22,0.6153846153846154,0.3076923076923077,0.3333333333333333,0.6153846153846154,0.15384615384615385,0.3076923076923077
Duane retraction syndrome,30399,12,6,19,3,16,27,2,25,0.5,0.3333333333333333,0.15789473684210525,0.5,0.07407407407407407,0.3333333333333333
Noonan syndrome with multiple lentigines,33317,2,16,37,15,22,28,3,25,0.9375,0.1875,0.40540540540540543,0.9375,0.10714285714285714,0.1875
Mosaic trisomy 15 syndrome,33444,6,3,21,3,18,35,1,34,1.0,0.3333333333333333,0.14285714285714285,1.0,0.02857142857142857,0.3333333333333333
3C syndrome,28191,0,9,17,1,16,9,0,9,0.1111111111111111,0.0,0.058823529411764705,0.1111111111111111,0.0,0.0
Aase-Smith syndrome,29084,1,9,17,6,11,24,1,23,0.6666666666666666,0.1111111111111111,0.35294117647058826,0.6666666666666666,0.041666666666666664,0.1111111111111111
Ablepharon macrostomia syndrome,29773,0,11,41,11,30,25,0,25,1.0,0.0,0.2682926829268293,1.0,0.0,0.0
Spina bifida-hypospadias syndrome,32279,8,3,29,2,27,37,0,37,0.6666666666666666,0.0,0.06896551724137931,0.6666666666666666,0.0,0.0
Tetraploidy syndrome,32570,1,5,19,4,15,31,1,30,0.8,0.2,0.21052631578947367,0.8,0.03225806451612903,0.2
Trisomy X syndrome,32515,0,1,17,1,16,34,0,34,1.0,0.0,0.058823529411764705,1.0,0.0,0.0
Triploidy syndrome,32516,1,10,18,5,13,32,0,32,0.5,0.0,0.2777777777777778,0.5,0.0,0.0
Familial peripheral male-limited precocious puberty,29908,7,4,16,4,12,35,4,31,1.0,1.0,0.25,1.0,0.11428571428571428,1.0
Familial visceral myopathy,30255,3,3,17,1,16,26,0,26,0.3333333333333333,0.0,0.058823529411764705,0.3333333333333333,0.0,0.0
Mitochondrial myopathy-lactic acidosis-deafness syndrome,29082,4,8,17,4,13,23,0,23,0.5,0.0,0.23529411764705882,0.5,0.0,0.0
Mitochondrial myopathy and sideroblastic anemia,30011,3,12,35,11,24,27,2,25,0.9166666666666666,0.16666666666666666,0.3142857142857143,0.9166666666666666,0.07407407407407407,0.16666666666666666
Carnitine palmitoyl transferase 1A deficiency,27251,2,11,16,8,8,32,3,29,0.7272727272727273,0.2727272727272727,0.5,0.7272727272727273,0.09375,0.2727272727272727
Epilepsy-microcephaly-skeletal dysplasia syndrome,29253,9,7,21,6,15,39,3,36,0.8571428571428571,0.42857142857142855,0.2857142857142857,0.8571428571428571,0.07692307692307693,0.42857142857142855
Amelocerebrohypohidrotic syndrome,29223,0,11,16,4,12,21,0,21,0.36363636363636365,0.0,0.25,0.36363636363636365,0.0,0.0
Griscelli syndrome,27582,1,4,58,4,54,30,0,30,1.0,0.0,0.06896551724137931,1.0,0.0,0.0
Epilepsy-telangiectasia syndrome,31526,2,9,17,8,9,28,0,28,0.8888888888888888,0.0,0.47058823529411764,0.8888888888888888,0.0,0.0
Oculogastrointestinal muscular dystrophy,31123,1,12,18,10,8,21,0,21,0.8333333333333334,0.0,0.5555555555555556,0.8333333333333334,0.0,0.0
Trisomy 5p syndrome,39338,19,17,28,1,27,27,1,26,0.058823529411764705,0.058823529411764705,0.03571428571428571,0.058823529411764705,0.037037037037037035,0.058823529411764705
Trisomy 4p syndrome,33428,2,20,16,12,4,38,5,33,0.6,0.25,0.75,0.6,0.13157894736842105,0.25
Trisomy 8q syndrome,33414,1,12,23,9,14,28,0,28,0.75,0.0,0.391304347826087,0.75,0.0,0.0
Distal duplication 6p syndrome,39199,20,17,31,1,30,31,1,30,0.058823529411764705,0.058823529411764705,0.03225806451612903,0.058823529411764705,0.03225806451612903,0.058823529411764705
Mosaic trisomy 14 syndrome,33446,2,12,19,7,12,30,1,29,0.5833333333333334,0.08333333333333333,0.3684210526315789,0.5833333333333334,0.03333333333333333,0.08333333333333333
Non-distal duplication 13q syndrome,39189,10,15,28,0,28,37,0,37,0.0,0.0,0.0,0.0,0.0,0.0
17p11.2 microduplication syndrome,33180,4,13,18,2,16,30,1,29,0.15384615384615385,0.07692307692307693,0.1111111111111111,0.15384615384615385,0.03333333333333333,0.07692307692307693
Distal duplication 14q syndrome,33445,0,3,17,3,14,16,0,16,1.0,0.0,0.17647058823529413,1.0,0.0,0.0
PAGOD syndrome,32665,0,5,19,3,16,27,0,27,0.6,0.0,0.15789473684210525,0.6,0.0,0.0
Aicardi-Goutières syndrome,27962,2,7,112,7,105,4,0,4,1.0,0.0,0.0625,1.0,0.0,0.0
Hypoglossia-hypodactyly syndrome,39017,17,5,29,1,28,30,1,29,0.2,0.2,0.034482758620689655,0.2,0.03333333333333333,0.2
Agnathia-holoprosencephaly-situs inversus syndrome,29148,3,19,26,16,10,42,2,40,0.8421052631578947,0.10526315789473684,0.6153846153846154,0.8421052631578947,0.047619047619047616,0.10526315789473684
Testicular regression syndrome,30323,4,10,23,11,12,33,5,28,1.1,0.5,0.4782608695652174,1.1,0.15151515151515152,0.5
Tibial hemimelia-polysyndactyly-triphalangeal thumb syndrome,32671,5,4,16,3,13,13,0,13,0.75,0.0,0.1875,0.75,0.0,0.0
Adrenomyodystrophy,29439,1,10,17,9,8,28,1,27,0.9,0.1,0.5294117647058824,0.9,0.03571428571428571,0.1
ADULT syndrome,37839,11,15,39,0,39,17,0,17,0.0,0.0,0.0,0.0,0.0,0.0
Alopecia-epilepsy-pyorrhea-intellectual disability syndrome,30393,4,10,16,1,15,30,4,26,0.1,0.4,0.0625,0.1,0.13333333333333333,0.4
Alopecia universalis,38135,5,4,7,2,5,5,1,4,0.5,0.25,0.2857142857142857,0.5,0.2,0.25
Scalp defects-postaxial polydactyly syndrome,29677,4,1,22,0,22,30,0,30,0.0,0.0,0.0,0.0,0.0,0.0
Alopecia-contractures-dwarfism-intellectual disability syndrome,31416,3,8,36,6,30,16,2,14,0.75,0.25,0.16666666666666666,0.75,0.125,0.25
Fetal akinesia deformation sequence,29919,0,12,25,6,19,24,0,24,0.5,0.0,0.24,0.5,0.0,0.0
2q37 microdeletion syndrome,33271,2,5,17,4,13,31,2,29,0.8,0.4,0.23529411764705882,0.8,0.06451612903225806,0.4
Amelo-onycho-hypohidrotic syndrome,29223,1,8,17,8,9,34,2,32,1.0,0.25,0.47058823529411764,1.0,0.058823529411764705,0.25
Amaurosis-hypertrichosis syndrome,27602,3,11,17,11,6,24,1,23,1.0,0.09090909090909091,0.6470588235294118,1.0,0.041666666666666664,0.09090909090909091
Alopecia-intellectual disability-hypergonadotropic hypogonadism syndrome,30707,4,3,21,2,19,27,0,27,0.6666666666666666,0.0,0.09523809523809523,0.6666666666666666,0.0,0.0
Hereditary neurocutaneous malformation,29587,4,2,32,1,31,21,0,21,0.5,0.0,0.03125,0.5,0.0,0.0
Congenital left ventricular aneurysm,39231,9,1,14,0,14,23,0,23,0.0,0.0,0.0,0.0,0.0,0.0
Vein of Galen aneurysmal malformation,33012,12,1,23,0,23,30,0,30,0.0,0.0,0.0,0.0,0.0,0.0
Mosaic variegated aneuploidy syndrome,28004,4,13,105,9,96,23,1,22,0.6923076923076923,0.07692307692307693,0.08571428571428572,0.6923076923076923,0.043478260869565216,0.07692307692307693
Metaphyseal anadysplasia,27535,4,9,17,10,7,34,1,33,1.1111111111111112,0.1111111111111111,0.5882352941176471,1.1111111111111112,0.029411764705882353,0.1111111111111111
Beta-mercaptolactate cysteine disulfiduria,31387,0,4,21,5,16,35,0,35,1.25,0.0,0.23809523809523808,1.25,0.0,0.0
Isolated acheiropodia,29085,1,8,19,6,13,24,0,24,0.75,0.0,0.3157894736842105,0.75,0.0,0.0
Achondrogenesis,27350,2,18,31,9,22,24,3,21,0.5,0.16666666666666666,0.2903225806451613,0.5,0.125,0.16666666666666666
Short-limb skeletal dysplasia with severe combined immunodeficiency,29100,1,5,17,2,15,32,1,31,0.4,0.2,0.11764705882352941,0.4,0.03125,0.2
Oxoglutaric aciduria,38526,17,7,26,1,25,42,1,41,0.14285714285714285,0.14285714285714285,0.038461538461538464,0.14285714285714285,0.023809523809523808,0.14285714285714285
Abruzzo-Erickson syndrome,32125,1,6,23,3,20,18,1,17,0.5,0.16666666666666666,0.13043478260869565,0.5,0.05555555555555555,0.16666666666666666
Insulin-resistance syndrome type A,33489,5,7,49,7,42,31,1,30,1.0,0.14285714285714285,0.14285714285714285,1.0,0.03225806451612903,0.14285714285714285
Triple A syndrome,31081,0,4,18,1,17,18,0,18,0.25,0.0,0.05555555555555555,0.25,0.0,0.0
Achalasia-microcephaly syndrome,28820,4,7,25,5,20,29,1,28,0.7142857142857143,0.14285714285714285,0.2,0.7142857142857143,0.034482758620689655,0.14285714285714285
Acrocraniofacial dysostosis,28444,1,24,18,10,8,9,1,8,0.4166666666666667,0.041666666666666664,0.5555555555555556,0.4166666666666667,0.1111111111111111,0.041666666666666664
Acrodermatitis enteropathica,31937,2,12,21,7,14,27,2,25,0.5833333333333334,0.16666666666666666,0.3333333333333333,0.5833333333333334,0.07407407407407407,0.16666666666666666
Acrodysostosis,32833,2,19,18,6,12,35,2,33,0.3157894736842105,0.10526315789473684,0.3333333333333333,0.3157894736842105,0.05714285714285714,0.10526315789473684
3-hydroxyisobutyric aciduria,30400,0,2,19,1,18,28,0,28,0.5,0.0,0.05263157894736842,0.5,0.0,0.0
Vitamin B12-unresponsive methylmalonic acidemia,33189,1,5,17,2,15,33,1,32,0.4,0.2,0.11764705882352941,0.4,0.030303030303030304,0.2
Acro-renal-ocular syndrome,28155,7,8,22,0,22,40,0,40,0.0,0.0,0.0,0.0,0.0,0.0
Acro-renal-mandibular syndrome,31163,0,7,53,4,49,31,0,31,0.5714285714285714,0.0,0.07547169811320754,0.5714285714285714,0.0,0.0
Hajdu-Cheney syndrome,30947,2,18,34,2,32,36,1,35,0.1111111111111111,0.05555555555555555,0.058823529411764705,0.1111111111111111,0.027777777777777776,0.05555555555555555
"Acrofacial dysostosis, Weyers type",28047,0,14,27,0,27,34,0,34,0.0,0.0,0.0,0.0,0.0,0.0
Acropectorovertebral dysplasia,27947,0,7,21,6,15,18,0,18,0.8571428571428571,0.0,0.2857142857142857,0.8571428571428571,0.0,0.0
Hereditary continuous muscle fiber activity,32842,7,5,16,3,13,17,0,17,0.6,0.0,0.1875,0.6,0.0,0.0
Adams-Oliver syndrome,28022,2,10,79,7,72,25,0,25,0.7,0.0,0.08860759493670886,0.7,0.0,0.0
"Isolated absence/hypoplasia of fingers excluding thumb, unilateral",31277,1,5,29,4,25,19,0,19,0.8,0.0,0.13793103448275862,0.8,0.0,0.0
"Acromesomelic dysplasia, Maroteaux type",99045,20,0,30,0,30,38,0,38,0.0,0.0,0.0,0.0,0.0,0.0
"Acromesomelic dysplasia, Hunter-Thompson type",30051,1,9,23,7,16,19,0,19,0.7777777777777778,0.0,0.30434782608695654,0.7777777777777778,0.0,0.0
Hereditary sensory and autonomic neuropathy type 2,27625,8,15,30,0,30,39,0,39,0.0,0.0,0.0,0.0,0.0,0.0
Acromicric dysplasia,28047,0,10,21,5,16,19,0,19,0.5,0.0,0.23809523809523808,0.5,0.0,0.0
Cerebellar ataxia-ectodermal dysplasia syndrome,27387,2,7,14,7,7,16,1,15,1.0,0.14285714285714285,0.5,1.0,0.0625,0.14285714285714285
Congenital unilateral hypoplasia of depressor anguli oris,29255,1,2,18,1,17,21,1,20,0.5,0.5,0.05555555555555555,0.5,0.047619047619047616,0.5
Ataxia-oculomotor apraxia type 1,27817,2,5,19,4,15,3,1,2,0.8,0.2,0.21052631578947367,0.8,0.3333333333333333,0.2
Cerebellar ataxia-hypogonadism syndrome,28370,3,11,21,9,12,5,3,2,0.8181818181818182,0.2727272727272727,0.42857142857142855,0.8181818181818182,0.6,0.2727272727272727
Ataxia-hypogonadism-choroidal dystrophy syndrome,29798,2,3,17,3,14,23,3,20,1.0,1.0,0.17647058823529413,1.0,0.13043478260869565,1.0
Ataxia-tapetoretinal degeneration syndrome,30850,4,0,21,0,21,33,0,33,0.0,0.0,0.0,0.0,0.0,0.0
Benign paroxysmal tonic upgaze of childhood with ataxia,30987,6,3,26,4,22,6,2,4,1.3333333333333333,0.6666666666666666,0.15384615384615385,1.3333333333333333,0.3333333333333333,0.6666666666666666
Spinocerebellar ataxia-dysmorphism syndrome,27662,2,21,31,1,30,18,2,16,0.047619047619047616,0.09523809523809523,0.03225806451612903,0.047619047619047616,0.1111111111111111,0.09523809523809523
Infantile-onset spinocerebellar ataxia,31537,1,7,18,7,11,5,3,2,1.0,0.42857142857142855,0.3888888888888889,1.0,0.6,0.42857142857142855
Spastic ataxia with congenital miosis,27721,0,3,19,2,17,19,3,16,0.6666666666666666,1.0,0.10526315789473684,0.6666666666666666,0.15789473684210525,1.0
Ataxia-photosensitivity-short stature syndrome,33200,4,11,16,11,5,39,5,34,1.0,0.45454545454545453,0.6875,1.0,0.1282051282051282,0.45454545454545453
Colonic atresia,28880,9,2,20,1,19,18,0,18,0.5,0.0,0.05,0.5,0.0,0.0
Ataxia-deafness-intellectual disability syndrome,29667,15,5,33,4,29,26,2,24,0.8,0.4,0.12121212121212122,0.8,0.07692307692307693,0.4
Progressive hemifacial atrophy,31985,1,4,17,6,11,22,1,21,1.5,0.25,0.35294117647058826,1.5,0.045454545454545456,0.25
Pulmonary atresia-intact ventricular septum syndrome,30358,11,3,30,2,28,24,0,24,0.6666666666666666,0.0,0.06666666666666667,0.6666666666666666,0.0,0.0
Duodenal atresia,28562,9,2,22,0,22,14,0,14,0.0,0.0,0.0,0.0,0.0,0.0
Baller-Gerold syndrome,31947,0,11,67,13,54,1,0,1,1.1818181818181819,0.0,0.19402985074626866,1.1818181818181819,0.0,0.0
Cheilitis glandularis,31409,0,5,16,4,12,20,0,20,0.8,0.0,0.25,0.8,0.0,0.0
Bannayan-Riley-Ruvalcaba syndrome,29873,3,12,17,4,13,19,2,17,0.3333333333333333,0.16666666666666666,0.23529411764705882,0.3333333333333333,0.10526315789473684,0.16666666666666666
Banki syndrome,30390,0,4,23,2,21,37,0,37,0.5,0.0,0.08695652173913043,0.5,0.0,0.0
Bangstad syndrome,28893,1,21,20,15,5,26,1,25,0.7142857142857143,0.047619047619047616,0.75,0.7142857142857143,0.038461538461538464,0.047619047619047616
Severe microbrachycephaly-intellectual disability-athetoid cerebral palsy syndrome,32741,1,19,17,8,9,24,4,20,0.42105263157894735,0.21052631578947367,0.47058823529411764,0.42105263157894735,0.16666666666666666,0.21052631578947367
Bartsocas-Papas syndrome,28697,0,16,41,15,26,22,0,22,0.9375,0.0,0.36585365853658536,0.9375,0.0,0.0
Barber-Say syndrome,30037,0,16,34,15,19,7,0,7,0.9375,0.0,0.4411764705882353,0.9375,0.0,0.0
Congenital intrauterine infection-like syndrome,32427,2,5,17,0,17,22,0,22,0.0,0.0,0.0,0.0,0.0,0.0
Aniridia-renal agenesis-psychomotor retardation syndrome,29961,3,12,18,12,6,36,1,35,1.0,0.08333333333333333,0.6666666666666666,1.0,0.027777777777777776,0.08333333333333333
Aniridia-ptosis-intellectual disability-familial obesity syndrome,33002,6,7,25,7,18,35,5,30,1.0,0.7142857142857143,0.28,1.0,0.14285714285714285,0.7142857142857143
Aniridia-intellectual disability syndrome,33001,13,5,29,3,26,28,1,27,0.6,0.2,0.10344827586206896,0.6,0.03571428571428571,0.2
Aniridia-absent patella syndrome,30456,2,2,30,3,27,31,2,29,1.5,1.0,0.1,1.5,0.06451612903225806,1.0
Ankyloblepharon-ectodermal defects-cleft lip/palate syndrome,27391,3,11,17,4,13,37,1,36,0.36363636363636365,0.09090909090909091,0.23529411764705882,0.36363636363636365,0.02702702702702703,0.09090909090909091
Ankyloblepharon filiforme adnatum-cleft palate syndrome,29953,6,1,25,1,24,30,1,29,1.0,1.0,0.04,1.0,0.03333333333333333,1.0
Ankyloblepharon filiforme adnatum-imperforate anus syndrome,32997,7,2,31,1,30,26,1,25,0.5,0.5,0.03225806451612903,0.5,0.038461538461538464,0.5
Dental ankylosis,31838,2,1,20,1,19,15,0,15,1.0,0.0,0.05,1.0,0.0,0.0
Thumb stiffness-brachydactyly-intellectual disability syndrome,31548,5,5,33,5,28,25,1,24,1.0,0.2,0.15151515151515152,1.0,0.04,0.2
Anonychia-microcephaly syndrome,33187,5,2,20,2,18,20,1,19,1.0,0.5,0.1,1.0,0.05,0.5
Anophthalmia plus syndrome,28468,2,1,15,1,14,26,1,25,1.0,1.0,0.06666666666666667,1.0,0.038461538461538464,1.0
Microphthalmia with limb anomalies,31021,0,15,17,0,17,38,5,33,0.0,0.3333333333333333,0.0,0.0,0.13157894736842105,0.3333333333333333
Antley-Bixler syndrome,32124,1,16,40,4,36,39,1,38,0.25,0.0625,0.1,0.25,0.02564102564102564,0.0625
Aortic arch anomaly-facial dysmorphism-intellectual disability syndrome,28747,3,14,17,8,9,32,3,29,0.5714285714285714,0.21428571428571427,0.47058823529411764,0.5714285714285714,0.09375,0.21428571428571427
Aphalangy-syndactyly-microcephaly syndrome,29724,2,5,17,4,13,28,2,26,0.8,0.4,0.23529411764705882,0.8,0.07142857142857142,0.4
Aplasia cutis congenita-intestinal lymphangiectasia syndrome,30290,2,4,18,3,15,29,2,27,0.75,0.5,0.16666666666666666,0.75,0.06896551724137931,0.5
Fibular aplasia-ectrodactyly syndrome,28530,1,1,23,1,22,29,0,29,1.0,0.0,0.043478260869565216,1.0,0.0,0.0
Aplasia cutis-myopia syndrome,30852,1,5,17,3,14,31,0,31,0.6,0.0,0.17647058823529413,0.6,0.0,0.0
Ulnar hypoplasia-split foot syndrome,28652,2,3,25,3,22,22,1,21,1.0,0.3333333333333333,0.12,1.0,0.045454545454545456,0.3333333333333333
Lung agenesis-heart defect-thumb anomalies syndrome,32165,1,1,21,1,20,39,0,39,1.0,0.0,0.047619047619047616,1.0,0.0,0.0
X-linked mandibulofacial dysostosis,30401,2,14,18,3,15,31,1,30,0.21428571428571427,0.07142857142857142,0.16666666666666666,0.21428571428571427,0.03225806451612903,0.07142857142857142
Arthrogryposis-like hand anomaly-sensorineural deafness syndrome,30721,6,3,18,2,16,40,1,39,0.6666666666666666,0.3333333333333333,0.1111111111111111,0.6666666666666666,0.025,0.3333333333333333
Arthrogryposis multiplex congenita-whistling face syndrome,28356,1,14,18,6,12,40,1,39,0.42857142857142855,0.07142857142857142,0.3333333333333333,0.42857142857142855,0.025,0.07142857142857142
Chylous ascites,30152,8,2,23,3,20,16,1,15,1.5,0.5,0.13043478260869565,1.5,0.0625,0.5
Atrioventricular defect-blepharophimosis-radial and anal defect syndrome,29364,2,5,22,3,19,34,1,33,0.6,0.2,0.13636363636363635,0.6,0.029411764705882353,0.2
Heart-hand syndrome type 2,30839,1,11,19,6,13,13,0,13,0.5454545454545454,0.0,0.3157894736842105,0.5454545454545454,0.0,0.0
Cardiomyopathy-cataract-hip spine disease syndrome,32896,4,5,24,4,20,35,1,34,0.8,0.2,0.16666666666666666,0.8,0.02857142857142857,0.2
Cardiofaciocutaneous syndrome,28065,2,27,16,3,13,35,4,31,0.1111111111111111,0.14814814814814814,0.1875,0.1111111111111111,0.11428571428571428,0.14814814814814814
Heart defect-tongue hamartoma-polysyndactyly syndrome,27309,3,3,19,3,16,28,2,26,1.0,0.6666666666666666,0.15789473684210525,1.0,0.07142857142857142,0.6666666666666666
Hyperkeratosis-hyperpigmentation syndrome,32913,5,3,14,3,11,15,1,14,1.0,0.3333333333333333,0.21428571428571427,1.0,0.06666666666666667,0.3333333333333333
Pentalogy of Cantrell,31497,2,6,17,3,14,32,4,28,0.5,0.6666666666666666,0.17647058823529413,0.5,0.125,0.6666666666666666
Persistent Müllerian duct syndrome,31830,11,1,20,2,18,28,1,27,2.0,1.0,0.1,2.0,0.03571428571428571,1.0
Camurati-Engelmann disease,29176,1,15,67,15,52,18,1,17,1.0,0.06666666666666667,0.22388059701492538,1.0,0.05555555555555555,0.06666666666666667
"Camptodactyly syndrome, Guadalajara type 1",27865,1,12,106,13,93,14,1,13,1.0833333333333333,0.08333333333333333,0.12264150943396226,1.0833333333333333,0.07142857142857142,0.08333333333333333
"Camptodactyly syndrome, Guadalajara type 2",27865,0,13,33,7,26,17,0,17,0.5384615384615384,0.0,0.21212121212121213,0.5384615384615384,0.0,0.0
Camptodactyly-taurinuria syndrome,32919,12,4,26,2,24,35,1,34,0.5,0.25,0.07692307692307693,0.5,0.02857142857142857,0.25
Camptobrachydactyly,31694,2,2,26,0,26,25,1,24,0.0,0.5,0.0,0.0,0.04,0.5
Night blindness-skeletal anomalies-dysmorphism syndrome,32860,0,14,18,11,7,44,2,42,0.7857142857142857,0.14285714285714285,0.6111111111111112,0.7857142857142857,0.045454545454545456,0.14285714285714285
Cerebrocostomandibular syndrome,28611,0,5,18,0,18,14,0,14,0.0,0.0,0.0,0.0,0.0,0.0
Catel-Manzke syndrome,31360,1,7,41,7,34,23,1,22,1.0,0.14285714285714285,0.17073170731707318,1.0,0.043478260869565216,0.14285714285714285
Cortical blindness-intellectual disability-polydactyly syndrome,29088,2,12,18,12,6,32,2,30,1.0,0.16666666666666666,0.6666666666666666,1.0,0.0625,0.16666666666666666
Cataract-intellectual disability-anal atresia-urinary defects syndrome,32865,6,5,26,4,22,27,3,24,0.8,0.6,0.15384615384615385,0.8,0.1111111111111111,0.6
Cataract-intellectual disability-hypogonadism syndrome,30594,1,14,29,9,20,11,1,10,0.6428571428571429,0.07142857142857142,0.3103448275862069,0.6428571428571429,0.09090909090909091,0.07142857142857142
Cataract-microcornea syndrome,29582,5,2,20,1,19,23,1,22,0.5,0.5,0.05,0.5,0.043478260869565216,0.5
Cataract-nephropathy-encephalopathy syndrome,30101,3,5,25,5,20,38,1,37,1.0,0.2,0.2,1.0,0.02631578947368421,0.2
Cataract-hypertrichosis-intellectual disability syndrome,30120,2,8,24,7,17,18,1,17,0.875,0.125,0.2916666666666667,0.875,0.05555555555555555,0.125
Cataract-aberrant oral frenula-growth delay syndrome,31097,1,0,14,0,14,23,0,23,0.0,0.0,0.0,0.0,0.0,0.0
Hereditary hyperferritinemia-cataract syndrome,27324,0,2,7,1,6,32,1,31,0.5,0.5,0.14285714285714285,0.5,0.03125,0.5
Autosomal recessive palmoplantar keratoderma and congenital alopecia,29558,2,10,20,8,12,14,2,12,0.8,0.2,0.4,0.8,0.14285714285714285,0.2
Congenital heart defect-round face-developmental delay syndrome,30832,2,11,17,10,7,25,1,24,0.9090909090909091,0.09090909090909091,0.5882352941176471,0.9090909090909091,0.04,0.09090909090909091
Carnosinase deficiency,29697,9,5,27,5,22,33,0,33,1.0,0.0,0.18518518518518517,1.0,0.0,0.0
Böök syndrome,27208,0,5,16,6,10,12,0,12,1.2,0.0,0.375,1.2,0.0,0.0
Tricho-retino-dento-digital syndrome,27849,2,6,16,5,11,48,1,47,0.8333333333333334,0.16666666666666666,0.3125,0.8333333333333334,0.020833333333333332,0.16666666666666666
Borjeson-Forssman-Lehmann syndrome,32096,2,16,17,7,10,34,1,33,0.4375,0.0625,0.4117647058823529,0.4375,0.029411764705882353,0.0625
Ascher syndrome,31447,0,4,15,3,12,24,0,24,0.75,0.0,0.2,0.75,0.0,0.0
Bonnemann-Meinecke-Reich syndrome,30769,0,9,16,7,9,21,0,21,0.7777777777777778,0.0,0.4375,0.7777777777777778,0.0,0.0
Blepharoptosis-myopia-ectopia lentis syndrome,31260,3,4,20,2,18,24,3,21,0.5,0.75,0.1,0.5,0.125,0.75
Bencze syndrome,28378,0,2,23,3,20,21,0,21,1.5,0.0,0.13043478260869565,1.5,0.0,0.0
Blepharonasofacial malformation syndrome,29759,2,12,25,11,14,30,0,30,0.9166666666666666,0.0,0.44,0.9166666666666666,0.0,0.0
Maxillonasal dysplasia,30733,5,8,21,0,21,11,0,11,0.0,0.0,0.0,0.0,0.0,0.0
Auriculoosteodysplasia,29573,0,6,18,7,11,16,0,16,1.1666666666666667,0.0,0.3888888888888889,1.1666666666666667,0.0,0.0
Congenital contractural arachnodactyly,97927,10,13,32,5,27,27,2,25,0.38461538461538464,0.15384615384615385,0.15625,0.38461538461538464,0.07407407407407407,0.15384615384615385
Beemer-Ertbruggen syndrome,30487,0,9,17,7,10,4,0,4,0.7777777777777778,0.0,0.4117647058823529,0.7777777777777778,0.0,0.0
Distal limb deficiencies-micrognathia syndrome,31198,3,7,23,0,23,36,1,35,0.0,0.14285714285714285,0.0,0.0,0.027777777777777776,0.14285714285714285
Infantile choroidocerebral calcification syndrome,30703,4,5,19,5,14,31,1,30,1.0,0.2,0.2631578947368421,1.0,0.03225806451612903,0.2
Symmetrical thalamic calcifications,32925,3,9,19,10,9,23,4,19,1.1111111111111112,0.4444444444444444,0.5263157894736842,1.1111111111111112,0.17391304347826086,0.4444444444444444
"Campomelia, Cumming type",31707,2,16,17,6,11,30,2,28,0.375,0.125,0.35294117647058826,0.375,0.06666666666666667,0.125
Lambert syndrome,28157,0,7,17,6,11,24,0,24,0.8571428571428571,0.0,0.35294117647058826,0.8571428571428571,0.0,0.0
Branchio-oculo-facial syndrome,28514,1,11,81,9,72,17,0,17,0.8181818181818182,0.0,0.1111111111111111,0.8181818181818182,0.0,0.0
Autosomal dominant popliteal pterygium syndrome,38207,3,6,3,0,3,8,0,8,0.0,0.0,0.0,0.0,0.0,0.0
Brachydactyly-preaxial hallux varus syndrome,30364,0,5,17,5,12,36,1,35,1.0,0.2,0.29411764705882354,1.0,0.027777777777777776,0.2
Brachytelephalangy-dysmorphism-Kallmann syndrome,28377,0,12,19,9,10,22,2,20,0.75,0.16666666666666666,0.47368421052631576,0.75,0.09090909090909091,0.16666666666666666
Bowen-Conradi syndrome,32137,6,10,21,3,18,30,2,28,0.3,0.2,0.14285714285714285,0.3,0.06666666666666667,0.2
Brachydactyly-elbow wrist dysplasia syndrome,28535,0,11,16,9,7,27,2,25,0.8181818181818182,0.18181818181818182,0.5625,0.8181818181818182,0.07407407407407407,0.18181818181818182
Brachydactyly-arterial hypertension syndrome,31964,0,5,16,3,13,22,1,21,0.6,0.2,0.1875,0.6,0.045454545454545456,0.2
Craniofrontonasal dysplasia,27877,0,8,18,1,17,15,0,15,0.125,0.0,0.05555555555555555,0.125,0.0,0.0
SPECC1L-related hypertelorism syndrome,31236,0,6,18,3,15,32,1,31,0.5,0.16666666666666666,0.16666666666666666,0.5,0.03125,0.16666666666666666
Non-syndromic bilambdoid and sagittal craniosynostosis,32568,4,7,21,2,19,40,2,38,0.2857142857142857,0.2857142857142857,0.09523809523809523,0.2857142857142857,0.05,0.2857142857142857
Craniotelencephalic dysplasia,30450,0,3,17,3,14,20,0,20,1.0,0.0,0.17647058823529413,1.0,0.0,0.0
"Craniosynostosis, Philadelphia type",29816,3,3,18,0,18,20,0,20,0.0,0.0,0.0,0.0,0.0,0.0
Cranio-osteoarthropathy,29816,6,4,25,1,24,36,1,35,0.25,0.25,0.04,0.25,0.027777777777777776,0.25
Craniometaphyseal dysplasia,27596,0,6,16,1,15,32,1,31,0.16666666666666666,0.16666666666666666,0.0625,0.16666666666666666,0.03125,0.16666666666666666
Coxopodopatellar syndrome,30567,0,3,31,0,31,10,1,9,0.0,0.3333333333333333,0.0,0.0,0.1,0.3333333333333333
Coxoauricular syndrome,30881,0,9,17,10,7,20,0,20,1.1111111111111112,0.0,0.5882352941176471,1.1111111111111112,0.0,0.0
Autosomal recessive Robinow syndrome,29073,1,16,17,3,14,38,0,38,0.1875,0.0,0.17647058823529413,0.1875,0.0,0.0
Thin ribs-tubular bones-dysmorphism syndrome,32431,1,8,8,7,1,26,1,25,0.875,0.125,0.875,0.875,0.038461538461538464,0.125
Cranioectodermal dysplasia,27422,0,16,22,5,17,15,0,15,0.3125,0.0,0.22727272727272727,0.3125,0.0,0.0
Craniodigital-intellectual disability syndrome,32414,2,13,19,12,7,23,2,21,0.9230769230769231,0.15384615384615385,0.631578947368421,0.9230769230769231,0.08695652173913043,0.15384615384615385
Craniodiaphyseal dysplasia,27877,1,10,18,5,13,66,1,65,0.5,0.1,0.2777777777777778,0.5,0.015151515151515152,0.1
Crane-Heise syndrome,32415,0,11,18,9,9,5,0,5,0.8181818181818182,0.0,0.5,0.8181818181818182,0.0,0.0
Dahlberg-Borer-Newcomer syndrome,32006,0,15,17,12,5,25,0,25,0.8,0.0,0.7058823529411765,0.8,0.0,0.0
Curry-Jones syndrome,29096,0,3,17,2,15,21,0,21,0.6666666666666666,0.0,0.11764705882352941,0.6666666666666666,0.0,0.0
Cutis gyrata-acanthosis nigricans-craniosynostosis syndrome,28632,4,26,55,23,32,44,2,42,0.8846153846153846,0.07692307692307693,0.41818181818181815,0.8846153846153846,0.045454545454545456,0.07692307692307693
Knobloch syndrome,28312,0,5,17,2,15,10,0,10,0.4,0.0,0.11764705882352941,0.4,0.0,0.0
Familial benign copper deficiency,28458,0,2,16,2,14,16,0,16,1.0,0.0,0.125,1.0,0.0,0.0
Dandy-Walker malformation-postaxial polydactyly syndrome,30740,2,2,18,1,17,36,1,35,0.5,0.5,0.05555555555555555,0.5,0.027777777777777776,0.5
X-linked intellectual disability-Dandy-Walker malformation-basal ganglia disease-seizures syndrome,27376,7,7,23,2,21,25,1,24,0.2857142857142857,0.14285714285714285,0.08695652173913043,0.2857142857142857,0.04,0.14285714285714285
Craniofacial-deafness-hand syndrome,29298,1,16,19,14,5,40,2,38,0.875,0.125,0.7368421052631579,0.875,0.05,0.125
Cryptomicrotia-brachydactyly-excess fingertip arch syndrome,27451,1,3,18,3,15,22,0,22,1.0,0.0,0.16666666666666666,1.0,0.0,0.0
Cryptorchidism-arachnodactyly-intellectual disability syndrome,32599,2,9,19,8,11,25,1,24,0.8888888888888888,0.1111111111111111,0.42105263157894735,0.8888888888888888,0.04,0.1111111111111111
Jackson-Weiss syndrome,32031,0,7,20,6,14,21,0,21,0.8571428571428571,0.0,0.3,0.8571428571428571,0.0,0.0
Crisponi syndrome,32013,5,17,20,2,18,25,0,25,0.11764705882352941,0.0,0.1,0.11764705882352941,0.0,0.0
Familial calcium pyrophosphate deposition,27424,14,5,30,4,26,20,3,17,0.8,0.6,0.13333333333333333,0.8,0.15,0.6
Tarsal-carpal coalition syndrome,27284,0,3,11,3,8,15,0,15,1.0,0.0,0.2727272727272727,1.0,0.0,0.0
Greenberg dysplasia,31956,0,12,17,5,12,27,0,27,0.4166666666666667,0.0,0.29411764705882354,0.4166666666666667,0.0,0.0
Benign hereditary chorea,28939,11,2,24,4,20,22,2,20,2.0,1.0,0.16666666666666666,2.0,0.09090909090909091,1.0
Cerebrofaciothoracic dysplasia,32129,0,15,69,13,56,10,0,10,0.8666666666666667,0.0,0.18840579710144928,0.8666666666666667,0.0,0.0
Hydrocephaly-cerebellar agenesis syndrome,30355,6,5,18,4,14,22,3,19,0.8,0.6,0.2222222222222222,0.8,0.13636363636363635,0.6
Richards-Rundle syndrome,31837,0,6,16,5,11,16,0,16,0.8333333333333334,0.0,0.3125,0.8333333333333334,0.0,0.0
Uncombable hair syndrome,28500,2,5,16,3,13,12,0,12,0.6,0.0,0.1875,0.6,0.0,0.0
Coloboma of macula-brachydactyly type B syndrome,28908,6,3,18,4,14,29,1,28,1.3333333333333333,0.3333333333333333,0.2222222222222222,1.3333333333333333,0.034482758620689655,0.3333333333333333
Contractures-ectodermal dysplasia-cleft lip/palate syndrome,28770,3,8,15,6,9,28,1,27,0.75,0.125,0.4,0.75,0.03571428571428571,0.125
Lethal congenital contracture syndrome type 1,27984,1,6,16,2,14,36,1,35,0.3333333333333333,0.16666666666666666,0.125,0.3333333333333333,0.027777777777777776,0.16666666666666666
Cooks syndrome,28102,0,7,16,3,13,28,0,28,0.42857142857142855,0.0,0.1875,0.42857142857142855,0.0,0.0
Corneal dystrophy-perceptive deafness syndrome,27893,8,4,29,4,25,15,2,13,1.0,0.5,0.13793103448275862,1.0,0.13333333333333333,0.5
Vici syndrome,28110,0,14,59,13,46,18,0,18,0.9285714285714286,0.0,0.22033898305084745,0.9285714285714286,0.0,0.0
Intellectual disability-hypoplastic corpus callosum-preauricular tag syndrome,32348,1,11,22,6,16,20,1,19,0.5454545454545454,0.09090909090909091,0.2727272727272727,0.5454545454545454,0.05,0.09090909090909091
Choroidal atrophy-alopecia syndrome,32382,4,9,23,8,15,26,2,24,0.8888888888888888,0.2222222222222222,0.34782608695652173,0.8888888888888888,0.07692307692307693,0.2222222222222222
Xq21 microdeletion syndrome,32429,4,4,99,0,99,25,0,25,0.0,0.0,0.0,0.0,0.0,0.0
X-linked skeletal dysplasia-intellectual disability syndrome,30680,3,7,19,5,14,39,2,37,0.7142857142857143,0.2857142857142857,0.2631578947368421,0.7142857142857143,0.05128205128205128,0.2857142857142857
Cleidorhizomelic syndrome,28603,0,6,14,4,10,23,0,23,0.6666666666666666,0.0,0.2857142857142857,0.6666666666666666,0.0,0.0
Coats disease,39106,21,2,29,2,27,28,2,26,1.0,1.0,0.06896551724137931,1.0,0.07142857142857142,1.0
CODAS syndrome,29615,1,20,54,19,35,26,0,26,0.95,0.0,0.35185185185185186,0.95,0.0,0.0
COFS syndrome,32357,1,20,17,9,8,31,1,30,0.45,0.05,0.5294117647058824,0.45,0.03225806451612903,0.05
"Bone dysplasia, lethal Holmgren type",27168,1,9,17,2,15,23,2,21,0.2222222222222222,0.2222222222222222,0.11764705882352941,0.2222222222222222,0.08695652173913043,0.2222222222222222
X-linked retinal dysplasia,30207,7,5,26,5,21,28,3,25,1.0,0.6,0.19230769230769232,1.0,0.10714285714285714,0.6
Axial mesodermal dysplasia spectrum,32945,0,37,17,13,4,12,0,12,0.35135135135135137,0.0,0.7647058823529411,0.35135135135135137,0.0,0.0
Hereditary mucoepithelial dysplasia,31858,0,11,18,6,12,15,0,15,0.5454545454545454,0.0,0.3333333333333333,0.5454545454545454,0.0,0.0
Progressive cone dystrophy,28237,9,5,20,4,16,26,3,23,0.8,0.6,0.2,0.8,0.11538461538461539,0.6
Jalili syndrome,32115,0,8,19,9,10,39,0,39,1.125,0.0,0.47368421052631576,1.125,0.0,0.0
Cone rod dystrophy,29580,3,3,17,3,14,17,1,16,1.0,0.3333333333333333,0.17647058823529413,1.0,0.058823529411764705,0.3333333333333333
Thanatophoric dysplasia type 1,30963,7,21,28,2,26,42,4,38,0.09523809523809523,0.19047619047619047,0.07142857142857142,0.09523809523809523,0.09523809523809523,0.19047619047619047
Skeletal dysplasia-epilepsy-short stature syndrome,28392,5,15,17,13,4,36,9,27,0.8666666666666667,0.6,0.7647058823529411,0.8666666666666667,0.25,0.6
Thoracic dysplasia-hydrocephalus syndrome,27969,0,4,16,4,12,23,0,23,1.0,0.0,0.25,1.0,0.0,0.0
Familial developmental dysphasia,29936,5,3,16,3,13,17,2,15,1.0,0.6666666666666666,0.1875,1.0,0.11764705882352941,0.6666666666666666
Kyphomelic dysplasia,31825,0,9,18,4,14,19,1,18,0.4444444444444444,0.1111111111111111,0.2222222222222222,0.4444444444444444,0.05263157894736842,0.1111111111111111
Ghosal hematodiaphyseal dysplasia,32156,1,11,17,8,9,26,1,25,0.7272727272727273,0.09090909090909091,0.47058823529411764,0.7272727272727273,0.038461538461538464,0.09090909090909091
Thoracomelic dysplasia,28177,4,16,21,3,18,37,1,36,0.1875,0.0625,0.14285714285714285,0.1875,0.02702702702702703,0.0625
"Acrofacial dysostosis, Rodríguez type",31874,0,5,20,2,18,20,0,20,0.4,0.0,0.1,0.4,0.0,0.0
Hypomandibular faciocranial dysostosis,29184,1,9,29,9,20,28,0,28,1.0,0.0,0.3103448275862069,1.0,0.0,0.0
Oculomaxillofacial dysostosis,33546,0,0,19,0,19,34,0,34,0.0,0.0,0.0,0.0,0.0,0.0
Craniofacial dysostosis-diaphyseal hyperplasia syndrome,27877,0,25,18,2,16,32,4,28,0.08,0.16,0.1111111111111111,0.08,0.125,0.16
Ectodermal dysplasia-intellectual disability-central nervous system malformation syndrome,30676,1,25,34,20,14,33,2,31,0.8,0.08,0.5882352941176471,0.8,0.06060606060606061,0.08
Epiphyseal dysplasia-hearing loss-dysmorphism syndrome,32946,2,18,19,14,5,37,2,35,0.7777777777777778,0.1111111111111111,0.7368421052631579,0.7777777777777778,0.05405405405405406,0.1111111111111111
Ectodermal dysplasia-blindness syndrome,30336,0,13,22,9,13,6,0,6,0.6923076923076923,0.0,0.4090909090909091,0.6923076923076923,0.0,0.0
"Hidrotic ectodermal dysplasia, Christianson-Fourie type",27194,2,7,16,5,11,33,2,31,0.7142857142857143,0.2857142857142857,0.3125,0.7142857142857143,0.06060606060606061,0.2857142857142857
"Hidrotic ectodermal dysplasia, Halal type",32947,0,13,17,13,4,35,0,35,1.0,0.0,0.7647058823529411,1.0,0.0,0.0
Odontomicronychial dysplasia,29495,4,9,23,6,17,8,2,6,0.6666666666666666,0.2222222222222222,0.2608695652173913,0.6666666666666666,0.25,0.2222222222222222
Fibular dimelia-diplopodia syndrome,33416,5,1,15,1,14,14,0,14,1.0,0.0,0.06666666666666667,1.0,0.0,0.0
Caudal duplication,28997,0,0,19,0,19,3,0,3,0.0,0.0,0.0,0.0,0.0,0.0
Arterial dissection-lentiginosis syndrome,31591,2,3,27,2,25,30,0,30,0.6666666666666666,0.0,0.07407407407407407,0.6666666666666666,0.0,0.0
Split cord malformation type I,94628,6,1,11,0,11,10,0,10,0.0,0.0,0.0,0.0,0.0,0.0
Wolcott-Rallison syndrome,30988,2,5,78,3,75,25,0,25,0.6,0.0,0.038461538461538464,0.6,0.0,0.0
Sporadic fetal brain disruption sequence,33403,0,8,23,6,17,22,1,21,0.75,0.125,0.2608695652173913,0.75,0.045454545454545456,0.125
X-linked corneal dermoid,30185,2,2,22,3,19,17,0,17,1.5,0.0,0.13636363636363635,1.5,0.0,0.0
Acrofrontofacionasal dysostosis,30415,0,25,39,19,20,58,1,57,0.76,0.04,0.48717948717948717,0.76,0.017241379310344827,0.04
Dysosteosclerosis,31109,0,21,19,3,16,37,0,37,0.14285714285714285,0.0,0.15789473684210525,0.14285714285714285,0.0,0.0
Thakker-Donnai syndrome,31482,0,13,30,12,18,22,0,22,0.9230769230769231,0.0,0.4,0.9230769230769231,0.0,0.0
Dysequilibrium syndrome,31340,4,5,18,5,13,21,4,17,1.0,0.8,0.2777777777777778,1.0,0.19047619047619047,0.8
Retinal degeneration-nanophthalmos-glaucoma syndrome,32163,2,6,19,5,14,28,2,26,0.8333333333333334,0.3333333333333333,0.2631578947368421,0.8333333333333334,0.07142857142857142,0.3333333333333333
Hypotrichosis with juvenile macular degeneration,27196,2,5,21,5,16,32,1,31,1.0,0.2,0.23809523809523808,1.0,0.03125,0.2
Steroid dehydrogenase deficiency-dental anomalies syndrome,32251,8,4,28,3,25,17,0,17,0.75,0.0,0.10714285714285714,0.75,0.0,0.0
Transcobalamin deficiency,32067,7,4,19,0,19,20,0,20,0.0,0.0,0.0,0.0,0.0,0.0
Lipodystrophy due to peptidic growth factors deficiency,31568,3,17,22,11,11,38,2,36,0.6470588235294118,0.11764705882352941,0.5,0.6470588235294118,0.05263157894736842,0.11764705882352941
Prolidase deficiency,31373,2,19,30,11,19,30,1,29,0.5789473684210527,0.05263157894736842,0.36666666666666664,0.5789473684210527,0.03333333333333333,0.05263157894736842
Dermatoleukodystrophy,29383,1,4,16,4,12,31,1,30,1.0,0.25,0.25,1.0,0.03225806451612903,0.25
Dermoodontodysplasia,31728,0,9,17,9,8,19,0,19,1.0,0.0,0.5294117647058824,1.0,0.0,0.0
"Dermatoosteolysis, Kirghizian type",31749,4,19,18,11,7,42,3,39,0.5789473684210527,0.15789473684210525,0.6111111111111112,0.5789473684210527,0.07142857142857142,0.15789473684210525
Absence of fingerprints-congenital milia syndrome,31543,2,4,16,5,11,21,1,20,1.25,0.25,0.3125,1.25,0.047619047619047616,0.25
Dentin dysplasia,27987,6,3,15,2,13,25,2,23,0.6666666666666666,0.6666666666666666,0.13333333333333333,0.6666666666666666,0.08,0.6666666666666666
1p36 deletion syndrome,32015,2,22,18,5,13,29,2,27,0.22727272727272727,0.09090909090909091,0.2777777777777778,0.22727272727272727,0.06896551724137931,0.09090909090909091
Oculocerebrocutaneous syndrome,29016,0,9,5,0,5,18,1,17,0.0,0.1111111111111111,0.0,0.0,0.05555555555555555,0.1111111111111111
Blepharo-cheilo-odontic syndrome,29329,1,4,18,2,16,36,1,35,0.5,0.25,0.1111111111111111,0.5,0.027777777777777776,0.25
Cleft lip-retinopathy syndrome,30251,2,1,19,0,19,21,0,21,0.0,0.0,0.0,0.0,0.0,0.0
Cleft lip/palate-deafness-sacral lipoma syndrome,32551,7,13,23,11,12,31,2,29,0.8461538461538461,0.15384615384615385,0.4782608695652174,0.8461538461538461,0.06451612903225806,0.15384615384615385
Cleft lip/palate-intestinal malrotation-cardiopathy syndrome,28622,1,7,18,3,15,23,1,22,0.42857142857142855,0.14285714285714285,0.16666666666666666,0.42857142857142855,0.043478260869565216,0.14285714285714285
Laryngotracheoesophageal cleft,32550,4,1,17,0,17,30,0,30,0.0,0.0,0.0,0.0,0.0,0.0
Acrocardiofacial syndrome,28065,2,4,17,1,16,33,1,32,0.25,0.25,0.058823529411764705,0.25,0.030303030303030304,0.25
Alar cartilages hypoplasia-coloboma-telecanthus syndrome,31999,2,7,21,5,16,29,1,28,0.7142857142857143,0.14285714285714285,0.23809523809523808,0.7142857142857143,0.034482758620689655,0.14285714285714285
Cleft palate-large ears-small head syndrome,32054,2,5,17,4,13,18,1,17,0.8,0.2,0.23529411764705882,0.8,0.05555555555555555,0.2
Cleft palate-stapes fixation-oligodontia syndrome,30253,4,7,20,8,12,20,1,19,1.1428571428571428,0.14285714285714285,0.4,1.1428571428571428,0.05,0.14285714285714285
Fibrochondrogenesis,29636,0,14,48,13,35,18,0,18,0.9285714285714286,0.0,0.2708333333333333,0.9285714285714286,0.0,0.0
Femur-fibula-ulna complex,32544,0,8,21,5,16,42,0,42,0.625,0.0,0.23809523809523808,0.625,0.0,0.0
Hereditary gingival fibromatosis,32528,16,2,20,2,18,27,2,25,1.0,1.0,0.1,1.0,0.07407407407407407,1.0
Endocardial fibroelastosis,28131,0,11,18,9,9,20,0,20,0.8181818181818182,0.0,0.5,0.8181818181818182,0.0,0.0
Epiphyseal stippling-osteoclastic hyperplasia syndrome,28971,5,10,18,0,18,29,1,28,0.0,0.1,0.0,0.0,0.034482758620689655,0.1
Congenital lethal erythroderma,31253,3,9,13,7,6,30,1,29,0.7777777777777778,0.1111111111111111,0.5384615384615384,0.7777777777777778,0.03333333333333333,0.1111111111111111
Exostoses-anetodermia-brachydactyly type E syndrome,28355,13,5,34,6,28,41,2,39,1.2,0.4,0.17647058823529413,1.2,0.04878048780487805,0.4
Extrasystoles-short stature-hyperpigmentation-microcephaly syndrome,31135,4,7,21,5,16,30,1,29,0.7142857142857143,0.14285714285714285,0.23809523809523808,0.7142857142857143,0.03333333333333333,0.14285714285714285
Flat face-microstomia-ear anomaly syndrome,27433,2,25,31,17,14,25,2,23,0.68,0.08,0.5483870967741935,0.68,0.08,0.08
Facial dysmorphism-anorexia-cachexia-eye and skin anomalies syndrome,33098,2,8,18,7,11,22,3,19,0.875,0.375,0.3888888888888889,0.875,0.13636363636363635,0.375
Facial dysmorphism-macrocephaly-myopia-Dandy-Walker malformation syndrome,29992,3,24,19,10,9,35,5,30,0.4166666666666667,0.20833333333333334,0.5263157894736842,0.4166666666666667,0.14285714285714285,0.20833333333333334
Lethal faciocardiomelic dysplasia,28934,1,14,19,12,7,33,0,33,0.8571428571428571,0.0,0.631578947368421,0.8571428571428571,0.0,0.0
Faciocardiorenal syndrome,28065,0,10,17,1,16,37,0,37,0.1,0.0,0.058823529411764705,0.1,0.0,0.0
Autosomal recessive faciodigitogenital syndrome,31076,3,20,18,4,14,33,0,33,0.2,0.0,0.2222222222222222,0.2,0.0,0.0
Bilateral striopallidodentate calcinosis,33092,4,9,20,8,12,39,1,38,0.8888888888888888,0.1111111111111111,0.4,0.8888888888888888,0.02564102564102564,0.1111111111111111
Femoral-facial syndrome,27536,1,3,25,2,23,37,0,37,0.6666666666666666,0.0,0.08,0.6666666666666666,0.0,0.0
Fetal trimethadione syndrome,33155,0,14,18,12,6,24,0,24,0.8571428571428571,0.0,0.6666666666666666,0.8571428571428571,0.0,0.0
Fetal hydantoin syndrome,33156,1,6,19,3,16,22,1,21,0.5,0.16666666666666666,0.15789473684210525,0.5,0.045454545454545456,0.16666666666666666
Fetal minoxidil syndrome,33130,4,8,20,5,15,29,0,29,0.625,0.0,0.25,0.625,0.0,0.0
Cocaine embryofetopathy,33157,9,2,17,1,16,24,0,24,0.5,0.0,0.058823529411764705,0.5,0.0,0.0
Phenobarbital embryopathy,33129,0,0,18,0,18,39,0,39,0.0,0.0,0.0,0.0,0.0,0.0
Fetal methylmercury syndrome,39044,11,5,27,4,23,39,4,35,0.8,0.8,0.14814814814814814,0.8,0.10256410256410256,0.8
Fetal cytomegalovirus syndrome,32421,9,0,23,0,23,26,0,26,0.0,0.0,0.0,0.0,0.0,0.0
Vitamin K antagonist embryofetopathy,33154,0,5,19,3,16,33,0,33,0.6,0.0,0.15789473684210525,0.6,0.0,0.0
Emery-Nelson syndrome,28832,0,9,19,7,12,31,0,31,0.7777777777777778,0.0,0.3684210526315789,0.7777777777777778,0.0,0.0
Diabetic embryopathy,33136,0,21,17,9,8,16,1,15,0.42857142857142855,0.047619047619047616,0.5294117647058824,0.42857142857142855,0.0625,0.047619047619047616
Methimazole embryofetopathy,33137,0,5,11,0,11,18,0,18,0.0,0.0,0.0,0.0,0.0,0.0
Toluene embryopathy,33139,0,11,20,7,13,15,1,14,0.6363636363636364,0.09090909090909091,0.35,0.6363636363636364,0.06666666666666667,0.09090909090909091
Lowry-Wood syndrome,32128,2,5,18,3,15,34,1,33,0.6,0.2,0.16666666666666666,0.6,0.029411764705882353,0.2
Dysplasia epiphysealis hemimelica,29341,2,10,16,9,7,21,3,18,0.9,0.3,0.5625,0.9,0.14285714285714285,0.3
Eng-Strom syndrome,30490,0,3,34,3,31,19,0,19,1.0,0.0,0.08823529411764706,1.0,0.0,0.0
Hypohidrotic ectodermal dysplasia-hypothyroidism-ciliary dyskinesia syndrome,31544,3,13,17,10,7,31,5,26,0.7692307692307693,0.38461538461538464,0.5882352941176471,0.7692307692307693,0.16129032258064516,0.38461538461538464
Congenital muscular dystrophy-infantile cataract-hypogonadism syndrome,28935,1,7,19,7,12,16,1,15,1.0,0.14285714285714285,0.3684210526315789,1.0,0.0625,0.14285714285714285
Melorheostosis with osteopoikilosis,32937,9,3,23,1,22,28,0,28,0.3333333333333333,0.0,0.043478260869565216,0.3333333333333333,0.0,0.0
Focal facial dermal dysplasia type III,27910,3,9,26,4,22,27,2,25,0.4444444444444444,0.2222222222222222,0.15384615384615385,0.4444444444444444,0.07407407407407407,0.2222222222222222
Intellectual disability-spasticity-ectrodactyly syndrome,31474,4,2,18,2,16,20,2,18,1.0,1.0,0.1111111111111111,1.0,0.1,1.0
Leukomelanoderma-infantilism-intellectual disability-hypodontia-hypotrichosis syndrome,30799,5,16,16,13,3,30,4,26,0.8125,0.25,0.8125,0.8125,0.13333333333333333,0.25
"Ectodermal dysplasia, trichoodontoonychial type",27631,2,8,17,7,10,21,2,19,0.875,0.25,0.4117647058823529,0.875,0.09523809523809523,0.25
EEC syndrome,38130,0,17,30,0,30,21,0,21,0.0,0.0,0.0,0.0,0.0,0.0
EEM syndrome,38130,7,7,35,0,35,31,0,31,0.0,0.0,0.0,0.0,0.0,0.0
Edinburgh malformation syndrome,31660,1,10,26,7,19,21,0,21,0.7,0.0,0.2692307692307692,0.7,0.0,0.0
Indomethacin embryofetopathy,33142,1,4,19,3,16,26,0,26,0.75,0.0,0.15789473684210525,0.75,0.0,0.0
Fetal iodine syndrome,30560,4,4,20,3,17,25,0,25,0.75,0.0,0.15,0.75,0.0,0.0
Fetal valproate spectrum disorder,33147,2,8,21,7,14,26,0,26,0.875,0.0,0.3333333333333333,0.875,0.0,0.0
Aminopterin/methotrexate embryofetopathy,33144,1,12,18,6,12,18,0,18,0.5,0.0,0.3333333333333333,0.5,0.0,0.0
Diaphragmatic defect-limb deficiency-skull defect syndrome,28516,2,15,20,13,7,31,3,28,0.8666666666666667,0.2,0.65,0.8666666666666667,0.0967741935483871,0.2
Donnai-Barrow syndrome,30192,1,13,17,6,11,28,1,27,0.46153846153846156,0.07692307692307693,0.35294117647058826,0.46153846153846156,0.03571428571428571,0.07692307692307693
"Craniosynostosis, Herrmann-Opitz type",33344,2,10,19,8,11,31,1,30,0.8,0.1,0.42105263157894735,0.8,0.03225806451612903,0.1
Nodular neuronal heterotopia,33343,1,3,20,3,17,5,1,4,1.0,0.3333333333333333,0.15,1.0,0.2,0.3333333333333333
Isolated hemihyperplasia,29808,0,3,19,2,17,8,0,8,0.6666666666666666,0.0,0.10526315789473684,0.6666666666666666,0.0,0.0
"46,XX ovotesticular difference of sex development",98421,11,14,35,7,28,43,6,37,0.5,0.42857142857142855,0.2,0.5,0.13953488372093023,0.42857142857142855
Short stature-craniofacial anomalies-genital hypoplasia syndrome,31087,3,13,19,5,14,22,2,20,0.38461538461538464,0.15384615384615385,0.2631578947368421,0.38461538461538464,0.09090909090909091,0.15384615384615385
HEC syndrome,28965,4,6,16,5,11,15,0,15,0.8333333333333334,0.0,0.3125,0.8333333333333334,0.0,0.0
Multifocal infantile hemangioma with extracutenous involvement,33357,4,19,21,13,8,38,3,35,0.6842105263157895,0.15789473684210525,0.6190476190476191,0.6842105263157895,0.07894736842105263,0.15789473684210525
Cystic hamartoma of lung and kidney,33365,10,3,17,3,14,24,1,23,1.0,0.3333333333333333,0.17647058823529413,1.0,0.041666666666666664,0.3333333333333333
"Hip dysplasia, Beukes type",28071,0,8,16,9,7,18,1,17,1.125,0.125,0.5625,1.125,0.05555555555555555,0.125
Harrod syndrome,30996,1,14,19,8,11,35,0,35,0.5714285714285714,0.0,0.42105263157894735,0.5714285714285714,0.0,0.0
Hall-Riggs syndrome,28970,0,9,18,1,17,18,0,18,0.1111111111111111,0.0,0.05555555555555555,0.1111111111111111,0.0,0.0
Dysmorphism-pectus carinatum-joint laxity syndrome,33369,6,11,24,11,13,13,0,13,1.0,0.0,0.4583333333333333,1.0,0.0,0.0
Hallux varus-preaxial polysyndactyly syndrome,28416,9,1,25,1,24,12,0,12,1.0,0.0,0.04,1.0,0.0,0.0
Hallermann-Streiff syndrome,28521,0,14,17,5,12,29,2,27,0.35714285714285715,0.14285714285714285,0.29411764705882354,0.35714285714285715,0.06896551724137931,0.14285714285714285
Greig cephalopolysyndactyly syndrome,30921,1,3,17,2,15,26,0,26,0.6666666666666666,0.0,0.11764705882352941,0.6666666666666666,0.0,0.0
"Acromesomelic dysplasia, Grebe type",27236,6,13,19,2,17,35,2,33,0.15384615384615385,0.15384615384615385,0.10526315789473684,0.15384615384615385,0.05714285714285714,0.15384615384615385
Grubben-de Cock-Borghgraef syndrome,29312,0,15,21,14,7,16,0,16,0.9333333333333333,0.0,0.6666666666666666,0.9333333333333333,0.0,0.0
Gordon syndrome,31704,0,2,36,3,33,24,0,24,1.5,0.0,0.08333333333333333,1.5,0.0,0.0
Focal dermal hypoplasia,30209,1,26,14,1,13,25,3,22,0.038461538461538464,0.11538461538461539,0.07142857142857142,0.038461538461538464,0.12,0.11538461538461539
Grant syndrome,29736,0,10,27,10,17,35,0,35,1.0,0.0,0.37037037037037035,1.0,0.0,0.0
Gorlin-Chaudhry-Moss syndrome,28966,5,19,25,4,21,33,1,32,0.21052631578947367,0.05263157894736842,0.16,0.21052631578947367,0.030303030303030304,0.05263157894736842
Glaucoma-sleep apnea syndrome,33319,18,3,31,3,28,33,1,32,1.0,0.3333333333333333,0.0967741935483871,1.0,0.030303030303030304,0.3333333333333333
Glaucoma-ectopia lentis-microspherophakia-stiff joints-short stature syndrome,29851,3,3,25,2,23,32,3,29,0.6666666666666666,1.0,0.08,0.6666666666666666,0.09375,1.0
Multinodular goiter-cystic kidney-polydactyly syndrome,32166,6,0,18,0,18,34,0,34,0.0,0.0,0.0,0.0,0.0,0.0
GMS syndrome,31863,0,7,20,7,13,25,0,25,1.0,0.0,0.35,1.0,0.0,0.0
Prominent glabella-microcephaly-hypogenitalism syndrome,29828,2,22,33,19,14,27,4,23,0.8636363636363636,0.18181818181818182,0.5757575757575758,0.8636363636363636,0.14814814814814814,0.18181818181818182
German syndrome,29369,0,21,17,10,7,32,0,32,0.47619047619047616,0.0,0.5882352941176471,0.47619047619047616,0.0,0.0
Geroderma osteodysplastica,27611,2,12,30,8,22,33,1,32,0.6666666666666666,0.08333333333333333,0.26666666666666666,0.6666666666666666,0.030303030303030304,0.08333333333333333
Gemignani syndrome,33323,0,10,16,8,8,21,0,21,0.8,0.0,0.5,0.8,0.0,0.0
Genitopalatocardiac syndrome,30694,0,8,17,6,11,43,1,42,0.75,0.125,0.35294117647058826,0.75,0.023255813953488372,0.125
Gastrocutaneous syndrome,31240,0,7,16,4,12,13,0,13,0.5714285714285714,0.0,0.25,0.5714285714285714,0.0,0.0
Galloway-Mowat syndrome,31695,0,7,17,1,16,26,0,26,0.14285714285714285,0.0,0.058823529411764705,0.14285714285714285,0.0,0.0
GAPO syndrome,31188,0,24,70,22,48,17,0,17,0.9166666666666666,0.0,0.3142857142857143,0.9166666666666666,0.0,0.0
Splenogonadal fusion-limb defects-micrognathia syndrome,31220,4,9,28,8,20,27,5,22,0.8888888888888888,0.5555555555555556,0.2857142857142857,0.8888888888888888,0.18518518518518517,0.5555555555555556
Posterior fusion of lumbosacral vertebrae-blepharoptosis syndrome,30969,6,3,27,2,25,19,2,17,0.6666666666666666,0.6666666666666666,0.07407407407407407,0.6666666666666666,0.10526315789473684,0.6666666666666666
Blepharophimosis-ptosis-esotropia-syndactyly-short stature syndrome,31444,3,8,17,6,11,40,5,35,0.75,0.625,0.35294117647058826,0.75,0.125,0.625
Frontofacionasal dysplasia,28884,1,13,38,9,29,31,0,31,0.6923076923076923,0.0,0.23684210526315788,0.6923076923076923,0.0,0.0
Foix-Chavany-Marie syndrome,32510,1,8,16,7,9,30,1,29,0.875,0.125,0.4375,0.875,0.03333333333333333,0.125
Flynn-Aird syndrome,29170,0,3,17,1,16,19,0,19,0.3333333333333333,0.0,0.058823529411764705,0.3333333333333333,0.0,0.0
FLOTCH syndrome,32512,0,7,19,9,10,20,0,20,1.2857142857142858,0.0,0.47368421052631576,1.2857142857142858,0.0,0.0
Paraplegia-intellectual disability-hyperkeratosis syndrome,28093,1,9,17,8,9,41,2,39,0.8888888888888888,0.2222222222222222,0.47058823529411764,0.8888888888888888,0.04878048780487805,0.2222222222222222
Scalp-ear-nipple syndrome,29732,2,10,28,6,22,27,2,25,0.6,0.2,0.21428571428571427,0.6,0.07407407407407407,0.2
Hepatic fibrosis-renal cysts-intellectual disability syndrome,29626,3,3,16,1,15,38,1,37,0.3333333333333333,0.3333333333333333,0.0625,0.3333333333333333,0.02631578947368421,0.3333333333333333
Juvenile hyaline fibromatosis,32527,2,6,16,5,11,41,0,41,0.8333333333333334,0.0,0.3125,0.8333333333333334,0.0,0.0
Gingival fibromatosis-progressive deafness syndrome,28133,5,4,33,4,29,30,1,29,1.0,0.25,0.12121212121212122,1.0,0.03333333333333333,0.25
Gingival fibromatosis-hypertrichosis syndrome,31207,2,3,17,3,14,29,1,28,1.0,0.3333333333333333,0.17647058823529413,1.0,0.034482758620689655,0.3333333333333333
Gingival fibromatosis-facial dysmorphism syndrome,30641,2,12,17,12,5,33,2,31,1.0,0.16666666666666666,0.7058823529411765,1.0,0.06060606060606061,0.16666666666666666
Macrosomia-microphthalmia-cleft palate syndrome,29257,0,7,22,7,15,17,1,16,1.0,0.14285714285714285,0.3181818181818182,1.0,0.058823529411764705,0.14285714285714285
Hypo- and hypermelanotic cutaneous macules-retarded growth-intellectual disability syndrome,33239,8,4,23,4,19,18,1,17,1.0,0.25,0.17391304347826086,1.0,0.05555555555555555,0.25
Ollier disease,28727,1,7,16,5,11,34,0,34,0.7142857142857143,0.0,0.3125,0.7142857142857143,0.0,0.0
Hand-foot-genital syndrome,30965,0,11,32,9,23,20,0,20,0.8181818181818182,0.0,0.28125,0.8181818181818182,0.0,0.0
Isolated split hand-split foot malformation,28928,0,1,24,2,22,16,0,16,2.0,0.0,0.08333333333333333,2.0,0.0,0.0
Familial supernumerary nipples,30638,3,1,8,1,7,11,1,10,1.0,1.0,0.125,1.0,0.09090909090909091,1.0
McDonough syndrome,31525,0,13,33,13,20,14,0,14,1.0,0.0,0.3939393939393939,1.0,0.0,0.0
Laurin-Sandrow syndrome,29707,0,9,32,8,24,15,0,15,0.8888888888888888,0.0,0.25,0.8888888888888888,0.0,0.0
Early-onset parkinsonism-intellectual disability syndrome,28974,4,7,18,8,10,22,2,20,1.1428571428571428,0.2857142857142857,0.4444444444444444,1.1428571428571428,0.09090909090909091,0.2857142857142857
Leukonychia totalis,33008,3,4,22,4,18,4,1,3,1.0,0.25,0.18181818181818182,1.0,0.25,0.25
Lowe-Kohn-Cohen syndrome,33245,14,3,20,2,18,29,0,29,0.6666666666666666,0.0,0.1,0.6666666666666666,0.0,0.0
Dislocation of the hip-dysmorphism syndrome,30455,1,0,22,0,22,13,0,13,0.0,0.0,0.0,0.0,0.0,0.0
Macrocephaly-spastic paraplegia-dysmorphism syndrome,31371,4,5,32,6,26,28,4,24,1.2,0.8,0.1875,1.2,0.14285714285714285,0.8
Kabuki syndrome,31000,2,18,23,5,18,35,2,33,0.2777777777777778,0.1111111111111111,0.21739130434782608,0.2777777777777778,0.05714285714285714,0.1111111111111111
"Diffuse palmoplantar keratoderma, Bothnian type",30262,6,2,8,0,8,11,0,11,0.0,0.0,0.0,0.0,0.0,0.0
Epidermolysis bullosa simplex with anodontia/hypodontia,33042,1,9,17,9,8,8,1,7,1.0,0.1111111111111111,0.5294117647058824,1.0,0.125,0.1111111111111111
Keratoderma hereditarium mutilans,27163,3,5,18,3,15,27,2,25,0.6,0.4,0.16666666666666666,0.6,0.07407407407407407,0.4
"Familial partial lipodystrophy, Dunnigan type",27788,0,10,18,5,13,14,0,14,0.5,0.0,0.2777777777777778,0.5,0.0,0.0
Congenital velopharyngeal incompetence,28838,8,4,23,6,17,30,0,30,1.5,0.0,0.2608695652173913,1.5,0.0,0.0
Isotretinoin syndrome,27758,0,4,19,1,18,7,0,7,0.25,0.0,0.05263157894736842,0.25,0.0,0.0
Absence deformity of leg-cataract syndrome,27847,0,8,19,7,12,10,0,10,0.875,0.0,0.3684210526315789,0.875,0.0,0.0
Johanson-Blizzard syndrome,29262,3,11,17,3,14,50,0,50,0.2727272727272727,0.0,0.17647058823529413,0.2727272727272727,0.0,0.0
Harlequin ichthyosis,27513,0,7,17,2,15,25,1,24,0.2857142857142857,0.14285714285714285,0.11764705882352941,0.2857142857142857,0.04,0.14285714285714285
Fused mandibular incisors,32105,5,2,15,3,12,17,1,16,1.5,0.5,0.2,1.5,0.058823529411764705,0.5
Neuronal intranuclear inclusion disease,29217,5,5,18,3,15,25,4,21,0.6,0.8,0.16666666666666666,0.6,0.16,0.8
Familial isolated hypoparathyroidism,29404,2,7,19,6,13,27,0,27,0.8571428571428571,0.0,0.3157894736842105,0.8571428571428571,0.0,0.0
Megacystis-microcolon-intestinal hypoperistalsis syndrome,29763,2,5,15,4,11,20,3,17,0.8,0.6,0.26666666666666666,0.8,0.15,0.6
Hypodontia-dysplasia of nails syndrome,27360,4,13,19,13,6,15,2,13,1.0,0.15384615384615385,0.6842105263157895,1.0,0.13333333333333333,0.15384615384615385
Dilated cardiomyopathy-hypergonadotropic hypogonadism syndrome,31362,3,7,25,4,21,12,0,12,0.5714285714285714,0.0,0.16,0.5714285714285714,0.0,0.0
Fibulo-ulnar hypoplasia-renal anomalies syndrome,29840,0,14,21,10,11,17,1,16,0.7142857142857143,0.07142857142857142,0.47619047619047616,0.7142857142857143,0.058823529411764705,0.07142857142857142
Primary pulmonary hypoplasia,27835,4,1,18,1,17,32,1,31,1.0,1.0,0.05555555555555555,1.0,0.03125,1.0
Cerebellar hypoplasia-tapetoretinal degeneration syndrome,33517,2,9,22,9,13,12,4,8,1.0,0.4444444444444444,0.4090909090909091,1.0,0.3333333333333333,0.4444444444444444
Radial hypoplasia-triphalangeal thumbs-hypospadias-maxillary diastema syndrome,29311,7,6,21,6,15,31,1,30,1.0,0.16666666666666666,0.2857142857142857,1.0,0.03225806451612903,0.16666666666666666
Primary hypomagnesemia with hypercalciuria and nephrocalcinosis with severe ocular involvement,27583,2,8,18,5,13,29,0,29,0.625,0.0,0.2777777777777778,0.625,0.0,0.0
Hypertrichosis lanuginosa congenita,33530,3,5,16,1,15,16,0,16,0.2,0.0,0.0625,0.2,0.0,0.0
Maternal hyperthermia-induced birth defects,33536,1,5,17,5,12,32,0,32,1.0,0.0,0.29411764705882354,1.0,0.0,0.0
Focal palmoplantar and gingival keratoderma,31528,5,7,13,7,6,12,3,9,1.0,0.42857142857142855,0.5384615384615384,1.0,0.25,0.42857142857142855
Histidinuria-renal tubular defect syndrome,31498,0,14,17,13,4,30,0,30,0.9285714285714286,0.0,0.7647058823529411,0.9285714285714286,0.0,0.0
Holzgreve syndrome,30186,0,7,18,4,14,23,0,23,0.5714285714285714,0.0,0.2222222222222222,0.5714285714285714,0.0,0.0
Holoprosencephaly-postaxial polydactyly syndrome,28950,1,5,26,4,22,31,0,31,0.8,0.0,0.15384615384615385,0.8,0.0,0.0
Holoprosencephaly-caudal dysgenesis syndrome,33338,2,1,23,0,23,29,0,29,0.0,0.0,0.0,0.0,0.0,0.0
Holoprosencephaly-craniosynostosis syndrome,28771,2,21,17,17,0,17,2,15,0.8095238095238095,0.09523809523809523,1.0,0.8095238095238095,0.11764705882352941,0.09523809523809523
Orofaciodigital syndrome type 1,27672,2,9,31,1,30,60,0,60,0.1111111111111111,0.0,0.03225806451612903,0.1111111111111111,0.0,0.0
OSLAM syndrome,30657,0,4,28,3,25,22,0,22,0.75,0.0,0.10714285714285714,0.75,0.0,0.0
Progressive osseous heteroplasia,29358,1,4,18,4,14,23,1,22,1.0,0.25,0.2222222222222222,1.0,0.043478260869565216,0.25
Blount disease,31308,9,1,18,0,18,26,0,26,0.0,0.0,0.0,0.0,0.0,0.0
Olivopontocerebellar atrophy-deafness syndrome,28400,1,5,18,4,14,15,3,12,0.8,0.6,0.2222222222222222,0.8,0.2,0.6
Congenital central hypoventilation syndrome,31618,3,2,19,2,17,21,1,20,1.0,0.5,0.10526315789473684,1.0,0.047619047619047616,0.5
Ophthalmomandibulomelic dysplasia,31552,0,17,19,13,6,38,0,38,0.7647058823529411,0.0,0.6842105263157895,0.7647058823529411,0.0,0.0
"Oculocerebral hypopigmentation syndrome, Preus type",29864,0,14,25,11,14,28,4,24,0.7857142857142857,0.2857142857142857,0.44,0.7857142857142857,0.14285714285714285,0.2857142857142857
Odonto-onycho dysplasia-alopecia syndrome,29598,1,11,21,6,15,48,2,46,0.5454545454545454,0.18181818181818182,0.2857142857142857,0.5454545454545454,0.041666666666666664,0.18181818181818182
Odontomatosis-aortae esophagus stenosis syndrome,30421,1,4,19,4,15,28,0,28,1.0,0.0,0.21052631578947367,1.0,0.0,0.0
Severe oculo-renal-cerebellar syndrome,29536,2,11,17,8,9,25,1,24,0.7272727272727273,0.09090909090909091,0.47058823529411764,0.7272727272727273,0.04,0.09090909090909091
Oculotrichoanal syndrome,29910,1,3,18,2,16,26,0,26,0.6666666666666666,0.0,0.1111111111111111,0.6666666666666666,0.0,0.0
"Oculocerebral hypopigmentation syndrome, Cross type",29864,1,4,26,3,23,26,1,25,0.75,0.25,0.11538461538461539,0.75,0.038461538461538464,0.25
Annular pancreas,30446,11,2,17,1,16,21,0,21,0.5,0.0,0.058823529411764705,0.5,0.0,0.0
Pachygyria-intellectual disability-epilepsy syndrome,31861,7,3,19,3,16,24,0,24,1.0,0.0,0.15789473684210525,1.0,0.0,0.0
Papillon-Lefèvre syndrome,31186,2,11,16,9,7,22,3,19,0.8181818181818182,0.2727272727272727,0.5625,0.8181818181818182,0.13636363636363635,0.2727272727272727
Papilloma of choroid plexus,30230,6,3,18,3,15,17,2,15,1.0,0.6666666666666666,0.16666666666666666,1.0,0.11764705882352941,0.6666666666666666
Otofaciocervical syndrome,28403,0,18,36,16,20,20,0,20,0.8888888888888888,0.0,0.4444444444444444,0.8888888888888888,0.0,0.0
"Endosteal hyperostosis, Worth type",31190,0,7,26,0,26,13,0,13,0.0,0.0,0.0,0.0,0.0,0.0
Pachydermoperiostosis,29236,2,7,25,1,24,36,2,34,0.14285714285714285,0.2857142857142857,0.04,0.14285714285714285,0.05555555555555555,0.2857142857142857
Otoonychoperoneal syndrome,30165,0,11,19,8,11,12,0,12,0.7272727272727273,0.0,0.42105263157894735,0.7272727272727273,0.0,0.0
Osteopathia striata-pigmentary dermopathy-white forelock syndrome,32370,2,7,21,5,16,34,1,33,0.7142857142857143,0.14285714285714285,0.23809523809523808,0.7142857142857143,0.029411764705882353,0.14285714285714285
Multicentric carpo-tarsal osteolysis with or without nephropathy,28040,3,14,25,15,10,20,4,16,1.0714285714285714,0.2857142857142857,0.6,1.0714285714285714,0.2,0.2857142857142857
Nasu-Hakola disease,32371,0,17,17,10,7,18,0,18,0.5882352941176471,0.0,0.5882352941176471,0.5882352941176471,0.0,0.0
Osteomesopyknosis,28316,0,1,11,1,10,32,1,31,1.0,1.0,0.09090909090909091,1.0,0.03125,1.0
Autosomal recessive distal osteolysis syndrome,27419,1,9,17,7,10,31,2,29,0.7777777777777778,0.2222222222222222,0.4117647058823529,0.7777777777777778,0.06451612903225806,0.2222222222222222
Short stature-valvular heart disease-characteristic facies syndrome,30765,2,13,16,9,7,32,1,31,0.6923076923076923,0.07692307692307693,0.5625,0.6923076923076923,0.03125,0.07692307692307693
Phakomatosis pigmentovascularis,32602,1,7,18,6,12,31,0,31,0.8571428571428571,0.0,0.3333333333333333,0.8571428571428571,0.0,0.0
Short stature-wormian bones-dextrocardia syndrome,32606,4,25,21,21,0,33,4,29,0.84,0.16,1.0,0.84,0.12121212121212122,0.16
Short stature-deafness-neutrophil dysfunction-dysmorphism syndrome,32605,8,0,30,0,30,27,0,27,0.0,0.0,0.0,0.0,0.0,0.0
Alopecia-intellectual disability syndrome,30393,2,9,17,4,13,19,2,17,0.4444444444444444,0.2222222222222222,0.23529411764705882,0.4444444444444444,0.10526315789473684,0.2222222222222222
Pelvic dysplasia-arthrogryposis of lower limbs syndrome,31333,5,6,21,6,15,46,1,45,1.0,0.16666666666666666,0.2857142857142857,1.0,0.021739130434782608,0.16666666666666666
Penoscrotal transposition,32416,3,15,17,11,6,11,3,8,0.7333333333333333,0.2,0.6470588235294118,0.7333333333333333,0.2727272727272727,0.2
PEHO syndrome,31464,1,27,59,26,33,38,1,37,0.9629629629629629,0.037037037037037035,0.4406779661016949,0.9629629629629629,0.02631578947368421,0.037037037037037035
Stiff skin syndrome,27904,2,3,15,3,12,20,1,19,1.0,0.3333333333333333,0.2,1.0,0.05,0.3333333333333333
Pectus excavatum-macrocephaly-dysplastic nails syndrome,27564,1,2,16,2,14,3,0,3,1.0,0.0,0.125,1.0,0.0,0.0
Spastic paraparesis-deafness syndrome,31889,2,6,19,4,15,20,1,19,0.6666666666666666,0.16666666666666666,0.21052631578947367,0.6666666666666666,0.05,0.16666666666666666
Laryngeal abductor paralysis,28645,8,1,20,1,19,24,0,24,1.0,0.0,0.05,1.0,0.0,0.0
Parana hard skin syndrome,30260,0,4,16,5,11,9,0,9,1.25,0.0,0.3125,1.25,0.0,0.0
"Renal agenesis, bilateral",99177,8,8,23,1,22,19,0,19,0.125,0.0,0.043478260869565216,0.125,0.0,0.0
Porencephaly,28067,1,4,17,3,14,13,1,12,0.75,0.25,0.17647058823529413,0.75,0.07692307692307693,0.25
Crossed polysyndactyly,28302,1,2,18,2,16,27,2,25,1.0,1.0,0.1111111111111111,1.0,0.07407407407407407,1.0
Cronkhite-Canada syndrome,29668,0,12,42,13,29,14,1,13,1.0833333333333333,0.08333333333333333,0.30952380952380953,1.0833333333333333,0.07142857142857142,0.08333333333333333
Polyneuropathy-intellectual disability-acromicria-premature menopause syndrome,33274,3,10,17,8,9,37,2,35,0.8,0.2,0.47058823529411764,0.8,0.05405405405405406,0.2
Isolated polycystic liver disease,27247,3,3,16,2,14,17,1,16,0.6666666666666666,0.3333333333333333,0.125,0.6666666666666666,0.058823529411764705,0.3333333333333333
Postaxial polydactyly-dental and vertebral anomalies syndrome,31601,1,9,27,6,21,35,1,34,0.6666666666666666,0.1111111111111111,0.2222222222222222,0.6666666666666666,0.02857142857142857,0.1111111111111111
Poland syndrome,30463,4,5,49,5,44,23,0,23,1.0,0.0,0.10204081632653061,1.0,0.0,0.0
Hereditary acrokeratotic poikiloderma,38421,16,16,32,3,29,23,2,21,0.1875,0.125,0.09375,0.1875,0.08695652173913043,0.125
Pili torti-developmental delay-neurological abnormalities syndrome,30006,2,8,23,8,15,17,1,16,1.0,0.125,0.34782608695652173,1.0,0.058823529411764705,0.125
Pili torti,28034,3,2,16,2,14,16,1,15,1.0,0.5,0.125,1.0,0.0625,0.5
Piebald trait-neurologic defects syndrome,31849,3,4,16,4,12,26,1,25,1.0,0.25,0.25,1.0,0.038461538461538464,0.25
Piebaldism,30388,6,3,17,2,15,31,2,29,0.6666666666666666,0.6666666666666666,0.11764705882352941,0.6666666666666666,0.06451612903225806,0.6666666666666666
"Phocomelia, Schinzel type",28522,2,12,25,2,23,26,0,26,0.16666666666666666,0.0,0.08,0.16666666666666666,0.0,0.0
Lower limb malformation-hypospadias syndrome,33217,3,2,18,0,18,15,1,14,0.0,0.5,0.0,0.0,0.06666666666666667,0.5
Upper limb defect-eye and ear abnormalities syndrome,30812,5,9,21,9,12,32,2,30,1.0,0.2222222222222222,0.42857142857142855,1.0,0.0625,0.2222222222222222
Müllerian duct anomalies-limb anomalies syndrome,31835,5,0,16,0,16,24,0,24,0.0,0.0,0.0,0.0,0.0,0.0
"Upper limb mesomelic dysplasia, type Fryns",27318,0,3,20,3,17,25,0,25,1.0,0.0,0.15,1.0,0.0,0.0
Acrogeria,32773,2,9,19,10,9,20,4,16,1.1111111111111112,0.4444444444444444,0.5263157894736842,1.1111111111111112,0.2,0.4444444444444444
McKusick-Kaufman syndrome,30059,0,1,18,0,18,10,0,10,0.0,0.0,0.0,0.0,0.0,0.0
White forelock with malformations,31091,1,14,23,13,10,26,1,25,0.9285714285714286,0.07142857142857142,0.5652173913043478,0.9285714285714286,0.038461538461538464,0.07142857142857142
Dysraphism-cleft lip/palate-limb reduction defects syndrome,33221,8,9,32,6,26,57,1,56,0.6666666666666666,0.1111111111111111,0.1875,0.6666666666666666,0.017543859649122806,0.1111111111111111
Megalencephaly,28361,5,12,16,2,14,10,2,8,0.16666666666666666,0.16666666666666666,0.125,0.16666666666666666,0.2,0.16666666666666666
Megalocornea-intellectual disability syndrome,27212,4,8,21,5,16,24,2,22,0.625,0.25,0.23809523809523808,0.625,0.08333333333333333,0.25
Neurocutaneous melanocytosis,28180,2,9,17,4,13,38,4,34,0.4444444444444444,0.4444444444444444,0.23529411764705882,0.4444444444444444,0.10526315789473684,0.4444444444444444
Melkersson-Rosenthal syndrome,30833,2,7,17,8,9,24,1,23,1.1428571428571428,0.14285714285714285,0.47058823529411764,1.1428571428571428,0.041666666666666664,0.14285714285714285
Microcephaly-deafness-intellectual disability syndrome,31460,3,11,17,9,8,31,2,29,0.8181818181818182,0.18181818181818182,0.5294117647058824,0.8181818181818182,0.06451612903225806,0.18181818181818182
Oculoauriculovertebral spectrum with radial defects,30140,0,7,28,5,23,22,0,22,0.7142857142857143,0.0,0.17857142857142858,0.7142857142857143,0.0,0.0
Microcornea-glaucoma-absent frontal sinuses syndrome,31470,1,6,15,4,11,37,0,37,0.6666666666666666,0.0,0.26666666666666666,0.6666666666666666,0.0,0.0
Spastic ataxia-corneal dystrophy syndrome,29469,5,5,16,4,12,23,3,20,0.8,0.6,0.25,0.8,0.13043478260869565,0.6
Lethal intrauterine growth restriction-cortical malformation-congenital contractures syndrome,30844,5,6,19,0,19,37,1,36,0.0,0.16666666666666666,0.0,0.0,0.02702702702702703,0.16666666666666666
Moynahan syndrome,30362,5,2,20,2,18,22,0,22,1.0,0.0,0.1,1.0,0.0,0.0
Moyamoya disease,29366,4,1,18,1,17,41,0,41,1.0,0.0,0.05555555555555555,1.0,0.0,0.0
Corpus callosum agenesis-abnormal genitalia syndrome,31429,1,7,17,1,16,29,0,29,0.14285714285714285,0.0,0.058823529411764705,0.14285714285714285,0.0,0.0
Multiple benign circumferential skin creases on limbs,27906,3,3,26,1,25,16,4,12,0.3333333333333333,1.3333333333333333,0.038461538461538464,0.3333333333333333,0.25,1.3333333333333333
Autosomal dominant primary microcephaly,27182,1,3,94,2,92,10,1,9,0.6666666666666666,0.3333333333333333,0.02127659574468085,0.6666666666666666,0.1,0.3333333333333333
Micro syndrome,32037,0,22,18,3,15,25,0,25,0.13636363636363635,0.0,0.16666666666666666,0.13636363636363635,0.0,0.0
Microcephaly-cervical spine fusion anomalies syndrome,28141,3,17,20,10,10,29,3,26,0.5882352941176471,0.17647058823529413,0.5,0.5882352941176471,0.10344827586206896,0.17647058823529413
Autosomal recessive chorioretinopathy-microcephaly syndrome,30010,6,2,24,1,23,24,1,23,0.5,0.5,0.041666666666666664,0.5,0.041666666666666664,0.5
"Microcephaly-microcornea syndrome, Seemanova type",32766,4,15,26,12,14,21,4,17,0.8,0.26666666666666666,0.46153846153846156,0.8,0.19047619047619047,0.26666666666666666
Langer mesomelic dysplasia,27632,1,13,22,12,10,37,2,35,0.9230769230769231,0.15384615384615385,0.5454545454545454,0.9230769230769231,0.05405405405405406,0.15384615384615385
"Mesomelic dysplasia, Nievergelt type",38211,9,14,32,1,31,37,3,34,0.07142857142857142,0.21428571428571427,0.03125,0.07142857142857142,0.08108108108108109,0.21428571428571427
"Microcephalic primordial dwarfism, Montreal type",30346,2,30,45,5,40,26,4,22,0.16666666666666666,0.13333333333333333,0.1111111111111111,0.16666666666666666,0.15384615384615385,0.13333333333333333
Mesomelic dwarfism-cleft palate-camptodactyly syndrome,30137,2,8,22,9,13,31,2,29,1.125,0.25,0.4090909090909091,1.125,0.06451612903225806,0.25
"Microcephalic primordial dwarfism, Toriello type",30346,1,13,38,10,28,12,2,10,0.7692307692307693,0.15384615384615385,0.2631578947368421,0.7692307692307693,0.16666666666666666,0.15384615384615385
Osteoglosphonic dysplasia,27306,3,6,24,2,22,43,0,43,0.3333333333333333,0.0,0.08333333333333333,0.3333333333333333,0.0,0.0
"Mesomelic dwarfism, Reinhardt-Pfeiffer type",27612,0,10,15,10,5,33,2,31,1.0,0.2,0.6666666666666666,1.0,0.06060606060606061,0.2
Mayer-Rokitansky-Küster-Hauser syndrome type 2,30327,0,9,22,0,22,35,2,33,0.0,0.2222222222222222,0.0,0.0,0.05714285714285714,0.2222222222222222
Muckle-Wells syndrome,29681,4,11,19,3,16,31,3,28,0.2727272727272727,0.2727272727272727,0.15789473684210525,0.2727272727272727,0.0967741935483871,0.2727272727272727
Mulibrey nanism,27480,3,7,18,5,13,25,1,24,0.7142857142857143,0.14285714285714285,0.2777777777777778,0.7142857142857143,0.04,0.14285714285714285
3M syndrome,27584,0,20,17,4,13,6,0,6,0.2,0.0,0.23529411764705882,0.2,0.0,0.0
Ataxia-pancytopenia syndrome,31519,5,5,27,7,20,16,4,12,1.4,0.8,0.25925925925925924,1.4,0.25,0.8
Noonan syndrome-like disorder with loose anagen hair,29750,6,7,63,6,57,30,3,27,0.8571428571428571,0.42857142857142855,0.09523809523809523,0.8571428571428571,0.1,0.42857142857142855
Knuckle pads-leukonychia-sensorineural deafness-palmoplantar hyperkeratosis syndrome,29543,9,3,20,2,18,33,1,32,0.6666666666666666,0.3333333333333333,0.1,0.6666666666666666,0.030303030303030304,0.3333333333333333
Bifid nose,31368,4,1,17,0,17,11,0,11,0.0,0.0,0.0,0.0,0.0,0.0
Neutropenia-monocytopenia-deafness syndrome,32876,11,3,26,3,23,38,2,36,1.0,0.6666666666666666,0.11538461538461539,1.0,0.05263157894736842,0.6666666666666666
Oculofaciocardiodental syndrome,28065,1,7,17,0,17,26,1,25,0.0,0.14285714285714285,0.0,0.0,0.038461538461538464,0.14285714285714285
Oculodentodigital dysplasia,27953,2,14,37,3,34,35,1,34,0.21428571428571427,0.07142857142857142,0.08108108108108109,0.21428571428571427,0.02857142857142857,0.07142857142857142
Urofacial syndrome,31625,0,1,19,1,18,11,0,11,1.0,0.0,0.05263157894736842,1.0,0.0,0.0
Nephropathy-deafness-hyperparathyroidism syndrome,27435,7,1,23,0,23,27,0,27,0.0,0.0,0.0,0.0,0.0,0.0
Nathalie syndrome,29787,0,4,23,3,20,32,0,32,0.75,0.0,0.13043478260869565,0.75,0.0,0.0
Keipert syndrome,28646,0,11,43,9,34,26,0,26,0.8181818181818182,0.0,0.20930232558139536,0.8181818181818182,0.0,0.0
Neurofaciodigitorenal syndrome,27267,2,16,24,10,14,41,2,39,0.625,0.125,0.4166666666666667,0.625,0.04878048780487805,0.125
Renal coloboma syndrome,32095,1,2,17,1,16,33,0,33,0.5,0.0,0.058823529411764705,0.5,0.0,0.0
Tetraamelia-multiple malformations syndrome,32572,0,8,18,3,15,39,0,39,0.375,0.0,0.16666666666666666,0.375,0.0,0.0
Thalidomide embryopathy,32567,0,0,16,0,16,29,0,29,0.0,0.0,0.0,0.0,0.0,0.0
Radioulnar synostosis-microcephaly-scoliosis syndrome,32302,2,19,16,15,1,37,6,31,0.7894736842105263,0.3157894736842105,0.9375,0.7894736842105263,0.16216216216216217,0.3157894736842105
Radioulnar synostosis-developmental delay-hypotonia syndrome,32091,1,17,20,14,6,41,5,36,0.8235294117647058,0.29411764705882354,0.7,0.8235294117647058,0.12195121951219512,0.29411764705882354
Weismann-Netter syndrome,31816,0,7,23,7,16,23,0,23,1.0,0.0,0.30434782608695654,1.0,0.0,0.0
Trichodermodysplasia-dental alterations syndrome,32530,0,8,17,8,9,20,0,20,1.0,0.0,0.47058823529411764,1.0,0.0,0.0
Thomas syndrome,32564,4,6,21,3,18,20,0,20,0.5,0.0,0.14285714285714285,0.5,0.0,0.0
"Thiemann disease, familial form",31503,3,2,24,2,22,36,0,36,1.0,0.0,0.08333333333333333,1.0,0.0,0.0
Tibial aplasia-ectrodactyly syndrome,32560,2,1,15,0,15,20,0,20,0.0,0.0,0.0,0.0,0.0,0.0
Hoyeraal-Hreidarsson syndrome,32562,0,10,17,7,10,24,0,24,0.7,0.0,0.4117647058823529,0.7,0.0,0.0
Trismus-pseudocamptodactyly syndrome,30181,1,4,18,4,14,18,0,18,1.0,0.0,0.2222222222222222,1.0,0.0,0.0
Urban-Rogers-Meyer syndrome,29639,0,9,18,6,12,28,0,28,0.6666666666666666,0.0,0.3333333333333333,0.6666666666666666,0.0,0.0
Hyperostosis corticalis generalisata,29653,2,6,15,5,10,35,2,33,0.8333333333333334,0.3333333333333333,0.3333333333333333,0.8333333333333334,0.05714285714285714,0.3333333333333333
Trichodysplasia-xeroderma syndrome,31096,1,8,27,6,21,27,0,27,0.75,0.0,0.2222222222222222,0.75,0.0,0.0
Non-syndromic metopic craniosynostosis,27344,4,2,22,0,22,42,0,42,0.0,0.0,0.0,0.0,0.0,0.0
Autoimmune polyendocrinopathy type 1,27834,2,13,17,6,11,35,0,35,0.46153846153846156,0.0,0.35294117647058826,0.46153846153846156,0.0,0.0
Wieacker-Wolff syndrome,38849,0,10,30,0,30,18,0,18,0.0,0.0,0.0,0.0,0.0,0.0
Wildervanck syndrome,31224,1,4,16,4,12,25,0,25,1.0,0.0,0.25,1.0,0.0,0.0
Worster-Drought syndrome,28437,1,2,19,1,18,23,0,23,0.5,0.0,0.05263157894736842,0.5,0.0,0.0
Velo-facial-skeletal syndrome,27369,1,7,18,5,13,22,0,22,0.7142857142857143,0.0,0.2777777777777778,0.7142857142857143,0.0,0.0
Verloove Vanhorick-Brubakk syndrome,31791,0,16,17,11,6,47,0,47,0.6875,0.0,0.6470588235294118,0.6875,0.0,0.0
MMEP syndrome,28919,0,7,21,4,17,14,0,14,0.5714285714285714,0.0,0.19047619047619047,0.5714285714285714,0.0,0.0
Weill-Marchesani syndrome,28146,2,6,25,5,20,31,1,30,0.8333333333333334,0.16666666666666666,0.2,0.8333333333333334,0.03225806451612903,0.16666666666666666
Thoraco-abdominal enteric duplication,33415,7,12,21,9,12,19,0,19,0.75,0.0,0.42857142857142855,0.75,0.0,0.0
Symbrachydactyly of hands and feet,98322,5,2,5,0,5,7,0,7,0.0,0.0,0.0,0.0,0.0,0.0
Acromelic frontonasal dysplasia,31586,0,19,17,8,9,28,0,28,0.42105263157894735,0.0,0.47058823529411764,0.42105263157894735,0.0,0.0
Congenital amegakaryocytic thrombocytopenia,30222,2,2,14,3,11,31,1,30,1.5,0.5,0.21428571428571427,1.5,0.03225806451612903,0.5
Young syndrome,31400,0,4,18,0,18,43,0,43,0.0,0.0,0.0,0.0,0.0,0.0
Hirschsprung disease-ganglioneuroblastoma syndrome,29014,5,8,20,7,13,18,0,18,0.875,0.0,0.35,0.875,0.0,0.0
Intellectual disability-short stature-hypertelorism syndrome,32813,11,5,24,5,19,38,1,37,1.0,0.2,0.20833333333333334,1.0,0.02631578947368421,0.2
Facial dysmorphism-shawl scrotum-joint laxity syndrome,33556,0,14,19,11,8,17,0,17,0.7857142857142857,0.0,0.5789473684210527,0.7857142857142857,0.0,0.0
Microphthalmia-microtia-fetal akinesia syndrome,32755,1,8,21,7,14,24,3,21,0.875,0.375,0.3333333333333333,0.875,0.125,0.375
Brachydactyly-mesomelia-intellectual disability-heart defects syndrome,32720,3,11,19,9,10,29,1,28,0.8181818181818182,0.09090909090909091,0.47368421052631576,0.8181818181818182,0.034482758620689655,0.09090909090909091
Fryns-Smeets-Thiry syndrome,32502,2,19,17,17,0,33,4,29,0.8947368421052632,0.21052631578947367,1.0,0.8947368421052632,0.12121212121212122,0.21052631578947367
Atherosclerosis-deafness-diabetes-epilepsy-nephropathy syndrome,28576,1,9,17,4,13,20,0,20,0.4444444444444444,0.0,0.23529411764705882,0.4444444444444444,0.0,0.0
Muscular pseudohypertrophy-hypothyroidism syndrome,33034,5,15,18,12,6,20,1,19,0.8,0.06666666666666667,0.6666666666666666,0.8,0.05,0.06666666666666667
Myalgia-eosinophilia syndrome associated with tryptophan,32733,2,3,19,3,16,18,0,18,1.0,0.0,0.15789473684210525,1.0,0.0,0.0
"Dysplastic cortical hyperostosis, Kozlowski-Tsuruta type",33537,2,14,17,11,6,32,3,29,0.7857142857142857,0.21428571428571427,0.6470588235294118,0.7857142857142857,0.09375,0.21428571428571427
"Progeroid syndrome, Petty type",31991,3,28,112,29,83,33,1,32,1.0357142857142858,0.03571428571428571,0.25892857142857145,1.0357142857142858,0.030303030303030304,0.03571428571428571
White matter hypoplasia-corpus callosum agenesis-intellectual disability syndrome,32343,8,12,23,9,14,23,3,20,0.75,0.25,0.391304347826087,0.75,0.13043478260869565,0.25
Autosomal dominant prognathism,28627,8,2,23,2,21,13,0,13,1.0,0.0,0.08695652173913043,1.0,0.0,0.0
Acrodysplasia scoliosis,29310,1,2,18,0,18,46,1,45,0.0,0.5,0.0,0.0,0.021739130434782608,0.5
Proteus-like syndrome,33263,1,12,17,7,10,46,1,45,0.5833333333333334,0.08333333333333333,0.4117647058823529,0.5833333333333334,0.021739130434782608,0.08333333333333333
"46,XX difference of sex development-anorectal anomalies syndrome",33260,8,3,20,3,17,48,2,46,1.0,0.6666666666666666,0.15,1.0,0.041666666666666664,0.6666666666666666
Non-eruption of teeth-maxillary hypoplasia-genu valgum syndrome,30911,2,7,13,8,5,21,2,19,1.1428571428571428,0.2857142857142857,0.6153846153846154,1.1428571428571428,0.09523809523809523,0.2857142857142857
Familial pterygium of the conjunctiva,30225,6,2,20,3,17,24,1,23,1.5,0.5,0.15,1.5,0.041666666666666664,0.5
Chronic intestinal pseudoobstruction,97922,14,1,16,1,15,18,1,17,1.0,1.0,0.0625,1.0,0.05555555555555555,1.0
Mirror polydactyly-vertebral segmentation-limbs defects syndrome,32706,5,5,26,3,23,23,1,22,0.6,0.2,0.11538461538461539,0.6,0.043478260869565216,0.2
Autosomal recessive multiple pterygium syndrome,38697,14,11,27,0,27,37,0,37,0.0,0.0,0.0,0.0,0.0,0.0
Ramon syndrome,28032,0,7,17,5,12,27,0,27,0.7142857142857143,0.0,0.29411764705882354,0.7142857142857143,0.0,0.0
External auditory canal atresia-vertical talus-hypertelorism syndrome,28323,4,1,18,1,17,29,0,29,1.0,0.0,0.05555555555555555,1.0,0.0,0.0
Delayed membranous cranial ossification,31603,3,6,18,6,12,26,1,25,1.0,0.16666666666666666,0.3333333333333333,1.0,0.038461538461538464,0.16666666666666666
Renal tubular dysgenesis,32831,5,8,36,5,31,13,0,13,0.625,0.0,0.1388888888888889,0.625,0.0,0.0
Growth delay-hydrocephaly-lung hypoplasia syndrome,28695,1,10,18,9,9,28,0,28,0.9,0.0,0.5,0.9,0.0,0.0
Delayed speech-facial asymmetry-strabismus-ear lobe creases syndrome,32152,3,9,15,8,7,30,3,27,0.8888888888888888,0.3333333333333333,0.5333333333333333,0.8888888888888888,0.1,0.3333333333333333
Intellectual disability-cataracts-calcified pinnae-myopathy syndrome,29991,2,21,19,9,10,24,1,23,0.42857142857142855,0.047619047619047616,0.47368421052631576,0.42857142857142855,0.041666666666666664,0.047619047619047616
X-linked intellectual disability-hypogonadism-ichthyosis-obesity-short stature syndrome,32821,5,13,20,11,9,27,3,24,0.8461538461538461,0.23076923076923078,0.55,0.8461538461538461,0.1111111111111111,0.23076923076923078
Monoamine oxidase A deficiency,28961,5,2,22,1,21,22,1,21,0.5,0.5,0.045454545454545456,0.5,0.045454545454545456,0.5
Intellectual disability-myopathy-short stature-endocrine defect syndrome,29725,2,19,25,13,12,27,2,25,0.6842105263157895,0.10526315789473684,0.52,0.6842105263157895,0.07407407407407407,0.10526315789473684
"Intellectual disability, Wolff type",30904,0,16,22,11,11,21,0,21,0.6875,0.0,0.5,0.6875,0.0,0.0
"Rhizomelic syndrome, Urbach type",29571,0,23,12,11,1,38,1,37,0.4782608695652174,0.043478260869565216,0.9166666666666666,0.4782608695652174,0.02631578947368421,0.043478260869565216
Robin sequence-oligodactyly syndrome,30699,2,4,20,3,17,37,1,36,0.75,0.25,0.15,0.75,0.02702702702702703,0.25
Mayer-Rokitansky-Küster-Hauser syndrome,30327,14,3,51,2,49,24,3,21,0.6666666666666666,1.0,0.0392156862745098,0.6666666666666666,0.125,1.0
Schneckenbecken dysplasia,29679,0,17,31,16,15,26,0,26,0.9411764705882353,0.0,0.5161290322580645,0.9411764705882353,0.0,0.0
Autoimmune polyendocrinopathy type 2,38555,11,6,18,0,18,27,1,26,0.0,0.16666666666666666,0.0,0.0,0.037037037037037035,0.16666666666666666
Satoyoshi syndrome,30048,1,24,16,8,8,29,0,29,0.3333333333333333,0.0,0.5,0.3333333333333333,0.0,0.0
Ruvalcaba syndrome,28803,0,18,8,1,7,39,0,39,0.05555555555555555,0.0,0.125,0.05555555555555555,0.0,0.0
Senior-Loken syndrome,27417,1,8,17,5,12,30,1,29,0.625,0.125,0.29411764705882354,0.625,0.03333333333333333,0.125
Nijmegen breakage syndrome,27380,4,31,17,4,13,26,3,23,0.12903225806451613,0.0967741935483871,0.23529411764705882,0.12903225806451613,0.11538461538461539,0.0967741935483871
Arginine vasopressin resistance-intracranial calcification-short stature-facial dysmorphism syndrome,29832,1,13,16,2,14,27,3,24,0.15384615384615385,0.23076923076923078,0.125,0.15384615384615385,0.1111111111111111,0.23076923076923078
Autosomal dominant spondylocostal dysostosis,29480,2,4,46,4,42,27,1,26,1.0,0.25,0.08695652173913043,1.0,0.037037037037037035,0.25
Spondylocamptodactyly syndrome,38339,8,3,26,1,25,58,2,56,0.3333333333333333,0.6666666666666666,0.038461538461538464,0.3333333333333333,0.034482758620689655,0.6666666666666666
"Omphalocele syndrome, Shprintzen-Goldberg type",31954,0,9,17,4,13,24,0,24,0.4444444444444444,0.0,0.23529411764705882,0.4444444444444444,0.0,0.0
Septo-optic dysplasia spectrum,30549,4,3,29,2,27,26,2,24,0.6666666666666666,0.6666666666666666,0.06896551724137931,0.6666666666666666,0.07692307692307693,0.6666666666666666
Subaortic stenosis-short stature syndrome,30548,2,7,45,8,37,39,2,37,1.1428571428571428,0.2857142857142857,0.17777777777777778,1.1428571428571428,0.05128205128205128,0.2857142857142857
Holoprosencephaly-radial heart renal anomalies syndrome,31894,2,5,24,3,21,28,1,27,0.6,0.2,0.125,0.6,0.03571428571428571,0.2
Sprengel deformity,28692,4,5,15,3,12,17,2,15,0.6,0.4,0.2,0.6,0.11764705882352941,0.4
Conductive deafness-malformed external ear syndrome,30226,2,3,18,3,15,16,0,16,1.0,0.0,0.16666666666666666,1.0,0.0,0.0
Deafness-epiphyseal dysplasia-short stature syndrome,28062,3,3,18,3,15,27,2,25,1.0,0.6666666666666666,0.16666666666666666,1.0,0.07407407407407407,0.6666666666666666
Supravalvular aortic stenosis,28231,18,2,29,2,27,23,1,22,1.0,0.5,0.06896551724137931,1.0,0.043478260869565216,0.5
Hearing loss-familial salivary gland insensitivity to aldosterone syndrome,32334,11,3,25,2,23,29,1,28,0.6666666666666666,0.3333333333333333,0.08,0.6666666666666666,0.034482758620689655,0.3333333333333333
Deafness-oligodontia syndrome,31584,5,2,23,2,21,33,1,32,1.0,0.5,0.08695652173913043,1.0,0.030303030303030304,0.5
Fountain syndrome,29331,0,8,18,3,15,18,0,18,0.375,0.0,0.16666666666666666,0.375,0.0,0.0
Conductive deafness-ptosis-skeletal anomalies syndrome,31565,2,13,16,10,6,29,3,26,0.7692307692307693,0.23076923076923078,0.625,0.7692307692307693,0.10344827586206896,0.23076923076923078
Deafness-craniofacial syndrome,27898,3,9,18,8,10,30,4,26,0.8888888888888888,0.4444444444444444,0.4444444444444444,0.8888888888888888,0.13333333333333333,0.4444444444444444
Cochleosaccular degeneration-cataract syndrome,29004,6,3,21,3,18,24,0,24,1.0,0.0,0.14285714285714285,1.0,0.0,0.0
Isolated humero-radial synostosis,29031,2,2,13,2,11,41,1,40,1.0,0.5,0.15384615384615385,1.0,0.024390243902439025,0.5
Proximal symphalangism,27357,0,4,18,3,15,14,0,14,0.75,0.0,0.16666666666666666,0.75,0.0,0.0
Cleft lip/palate-ectodermal dysplasia syndrome,27507,7,6,17,1,16,49,0,49,0.16666666666666666,0.0,0.058823529411764705,0.16666666666666666,0.0,0.0
Autosomal recessive hypohidrotic ectodermal dysplasia,32453,4,7,23,2,21,32,1,31,0.2857142857142857,0.14285714285714285,0.08695652173913043,0.2857142857142857,0.03125,0.14285714285714285
Erythrokeratodermia variabilis,38275,5,10,35,4,31,17,3,14,0.4,0.3,0.11428571428571428,0.4,0.17647058823529413,0.3
SAPHO syndrome,32951,5,11,25,11,14,29,4,25,1.0,0.36363636363636365,0.44,1.0,0.13793103448275862,0.36363636363636365
Lymphedema with yellow nails,29797,1,8,22,11,11,23,1,22,1.375,0.125,0.5,1.375,0.043478260869565216,0.125
Macrophagic myofasciitis,33273,9,5,20,4,16,22,2,20,0.8,0.4,0.2,0.8,0.09090909090909091,0.4
"46,XX testicular difference of sex development",38749,15,4,24,1,23,42,1,41,0.25,0.25,0.041666666666666664,0.25,0.023809523809523808,0.25
Autosomal dominant hypocalcemia,28238,4,11,38,9,29,32,4,28,0.8181818181818182,0.36363636363636365,0.23684210526315788,0.8181818181818182,0.125,0.36363636363636365
Adult-onset Still disease,32993,6,14,16,8,8,27,7,20,0.5714285714285714,0.5,0.5,0.5714285714285714,0.25925925925925924,0.5
Dracunculiasis,32442,2,8,17,7,10,28,3,25,0.875,0.375,0.4117647058823529,0.875,0.10714285714285714,0.375
Isolated anencephaly/exencephaly,29207,2,2,28,2,26,34,1,33,1.0,0.5,0.07142857142857142,1.0,0.029411764705882353,0.5
TMEM70-related mitochondrial encephalo-cardio-myopathy,38859,15,10,22,0,22,26,1,25,0.0,0.1,0.0,0.0,0.038461538461538464,0.1
Best vitelliform macular dystrophy,27619,3,3,18,4,14,30,1,29,1.3333333333333333,0.3333333333333333,0.2222222222222222,1.3333333333333333,0.03333333333333333,0.3333333333333333
Miller-Dieker syndrome,29453,3,10,44,10,34,29,0,29,1.0,0.0,0.22727272727272727,1.0,0.0,0.0
X-linked lissencephaly with abnormal genitalia,31402,3,9,33,9,24,42,2,40,1.0,0.2222222222222222,0.2727272727272727,1.0,0.047619047619047616,0.2222222222222222
Kyphoscoliotic Ehlers-Danlos syndrome due to lysyl hydroxylase 1 deficiency,33340,4,11,25,5,20,30,1,29,0.45454545454545453,0.09090909090909091,0.2,0.45454545454545453,0.03333333333333333,0.09090909090909091
"Congenital nephrotic syndrome, Finnish type",30172,1,5,17,4,13,18,2,16,0.8,0.4,0.23529411764705882,0.8,0.1111111111111111,0.4
Hypermobile Ehlers-Danlos syndrome,27533,3,14,20,6,14,23,2,21,0.42857142857142855,0.14285714285714285,0.3,0.42857142857142855,0.08695652173913043,0.14285714285714285
Vascular Ehlers-Danlos syndrome,94823,14,35,31,4,27,31,2,29,0.11428571428571428,0.05714285714285714,0.12903225806451613,0.11428571428571428,0.06451612903225806,0.05714285714285714
Hyperprolinemia type 1,28903,2,0,16,0,16,11,0,11,0.0,0.0,0.0,0.0,0.0,0.0
Pseudohypoaldosteronism type 2,28487,3,2,17,1,16,32,2,30,0.5,1.0,0.058823529411764705,0.5,0.0625,1.0
Pseudoxanthoma elasticum,30537,0,10,16,2,14,37,0,37,0.2,0.0,0.125,0.2,0.0,0.0
Isolated Klippel-Feil syndrome,39098,14,8,25,3,22,32,3,29,0.375,0.375,0.12,0.375,0.09375,0.375
Larsen syndrome,31684,1,12,15,0,15,21,0,21,0.0,0.0,0.0,0.0,0.0,0.0
Cutaneous small vessel vasculitis,84265,12,10,26,5,21,26,4,22,0.5,0.4,0.19230769230769232,0.5,0.15384615384615385,0.4
Kindler epidermolysis bullosa,29328,1,7,19,3,16,16,2,14,0.42857142857142855,0.2857142857142857,0.15789473684210525,0.42857142857142855,0.125,0.2857142857142857
Reynolds syndrome,29955,4,7,19,3,16,27,2,25,0.42857142857142855,0.2857142857142857,0.15789473684210525,0.42857142857142855,0.07407407407407407,0.2857142857142857
Criss-cross heart,32358,4,2,22,2,20,40,0,40,1.0,0.0,0.09090909090909091,1.0,0.0,0.0
Antisynthetase syndrome,32317,2,9,17,5,12,26,5,21,0.5555555555555556,0.5555555555555556,0.29411764705882354,0.5555555555555556,0.19230769230769232,0.5555555555555556
Pyomyositis,32985,8,5,21,5,16,23,1,22,1.0,0.2,0.23809523809523808,1.0,0.043478260869565216,0.2
Alopecia totalis,38135,5,2,18,2,16,10,2,8,1.0,1.0,0.1111111111111111,1.0,0.2,1.0
Syringocystadenoma papilliferum,33005,1,3,10,3,7,23,0,23,1.0,0.0,0.3,1.0,0.0,0.0
Pili bifurcati,33209,5,2,19,2,17,36,1,35,1.0,0.5,0.10526315789473684,1.0,0.027777777777777776,0.5
Proliferating trichilemmal cyst,33442,3,2,24,2,22,19,1,18,1.0,0.5,0.08333333333333333,1.0,0.05263157894736842,0.5
Kerion celsi,29549,4,3,22,4,18,19,1,18,1.3333333333333333,0.3333333333333333,0.18181818181818182,1.3333333333333333,0.05263157894736842,0.3333333333333333
Lichen planopilaris,32619,9,4,26,2,24,19,2,17,0.5,0.5,0.07692307692307693,0.5,0.10526315789473684,0.5
Erosive pustular dermatosis of the scalp,32445,8,3,21,2,19,24,1,23,0.6666666666666666,0.3333333333333333,0.09523809523809523,0.6666666666666666,0.041666666666666664,0.3333333333333333
Quinquaud folliculitis decalvans,32199,6,6,21,5,16,16,3,13,0.8333333333333334,0.5,0.23809523809523808,0.8333333333333334,0.1875,0.5
Marie Unna hereditary hypotrichosis,33470,9,5,20,5,15,30,2,28,1.0,0.4,0.25,1.0,0.06666666666666667,0.4
Loose anagen syndrome,27850,6,2,25,1,24,26,0,26,0.5,0.0,0.04,0.5,0.0,0.0
Ringed hair disease,30642,4,2,11,3,8,26,0,26,1.5,0.0,0.2727272727272727,1.5,0.0,0.0
Woolly hair,38788,8,4,9,3,6,12,4,8,0.75,1.0,0.3333333333333333,0.75,0.3333333333333333,1.0
Crandall syndrome,32479,1,6,18,5,13,18,0,18,0.8333333333333334,0.0,0.2777777777777778,0.8333333333333334,0.0,0.0
Babesiosis,32638,4,3,17,3,14,23,3,20,1.0,1.0,0.17647058823529413,1.0,0.13043478260869565,1.0
Roch-Leri mesosomatous lipomatosis,33326,7,1,25,1,24,32,0,32,1.0,0.0,0.04,1.0,0.0,0.0
Pseudopelade of Brocq,32645,6,4,18,3,15,23,1,22,0.75,0.25,0.16666666666666666,0.75,0.043478260869565216,0.25
Dissecting cellulitis of the scalp,28699,1,7,21,5,16,22,2,20,0.7142857142857143,0.2857142857142857,0.23809523809523808,0.7142857142857143,0.09090909090909091,0.2857142857142857
Vogt-Koyanagi-Harada disease,33368,7,10,20,8,12,30,2,28,0.8,0.2,0.4,0.8,0.06666666666666667,0.2
Inherited epidermodysplasia verruciformis,28815,6,7,19,2,17,25,2,23,0.2857142857142857,0.2857142857142857,0.10526315789473684,0.2857142857142857,0.08,0.2857142857142857
CINCA syndrome,30483,1,20,17,4,13,25,3,22,0.2,0.15,0.23529411764705882,0.2,0.12,0.15
Lymphangioleiomyomatosis,29275,2,6,20,3,17,21,2,19,0.5,0.3333333333333333,0.15,0.5,0.09523809523809523,0.3333333333333333
Severe hereditary thrombophilia due to congenital protein C deficiency,31567,5,0,21,0,21,17,0,17,0.0,0.0,0.0,0.0,0.0,0.0
Sézary syndrome,32282,1,10,17,3,14,29,3,26,0.3,0.3,0.17647058823529413,0.3,0.10344827586206896,0.3
Classic mycosis fungoides,30990,2,9,17,4,13,21,5,16,0.4444444444444444,0.5555555555555556,0.23529411764705882,0.4444444444444444,0.23809523809523808,0.5555555555555556
3-methylcrotonyl-CoA carboxylase deficiency,29803,3,4,16,3,13,30,2,28,0.75,0.5,0.1875,0.75,0.06666666666666667,0.5
Hyperimmunoglobulinemia D with periodic fever,29059,6,9,17,5,12,26,2,24,0.5555555555555556,0.2222222222222222,0.29411764705882354,0.5555555555555556,0.07692307692307693,0.2222222222222222
Severe hereditary thrombophilia due to congenital protein S deficiency,30555,5,1,13,0,13,26,0,26,0.0,0.0,0.0,0.0,0.0,0.0
Vitamin B12-responsive methylmalonic acidemia,38693,19,7,21,0,21,23,1,22,0.0,0.14285714285714285,0.0,0.0,0.043478260869565216,0.14285714285714285
Paris-Trousseau thrombocytopenia,30294,2,0,24,0,24,22,0,22,0.0,0.0,0.0,0.0,0.0,0.0
Homocystinuria without methylmalonic aciduria,33171,2,2,20,1,19,18,0,18,0.5,0.0,0.05,0.5,0.0,0.0
Sneddon syndrome,28715,1,12,17,5,12,31,1,30,0.4166666666666667,0.08333333333333333,0.29411764705882354,0.4166666666666667,0.03225806451612903,0.08333333333333333
Bardet-Biedl syndrome,27886,2,5,17,0,17,25,2,23,0.0,0.4,0.0,0.0,0.08,0.4
Stüve-Wiedemann syndrome,27231,4,17,86,18,68,29,1,28,1.0588235294117647,0.058823529411764705,0.20930232558139536,1.0588235294117647,0.034482758620689655,0.058823529411764705
Leber congenital amaurosis,28852,7,3,52,4,48,27,0,27,1.3333333333333333,0.0,0.07692307692307693,1.3333333333333333,0.0,0.0
Xeroderma pigmentosum,31055,12,20,24,1,23,35,3,32,0.05,0.15,0.041666666666666664,0.05,0.08571428571428572,0.15
Kallmann syndrome,31593,0,11,16,2,14,8,4,4,0.18181818181818182,0.36363636363636365,0.125,0.18181818181818182,0.5,0.36363636363636365
Aplasia cutis congenita,28732,1,5,14,4,10,30,0,30,0.8,0.0,0.2857142857142857,0.8,0.0,0.0
Hydrocephaly-low insertion umbilicus syndrome,28443,0,7,21,0,21,22,1,21,0.0,0.14285714285714285,0.0,0.0,0.045454545454545456,0.14285714285714285
"Rhizomelic dysplasia, Patterson-Lowry type",31126,3,17,22,16,6,42,1,41,0.9411764705882353,0.058823529411764705,0.7272727272727273,0.9411764705882353,0.023809523809523808,0.058823529411764705
Hypomyelination neuropathy-arthrogryposis syndrome,32883,12,5,22,4,18,25,1,24,0.8,0.2,0.18181818181818182,0.8,0.04,0.2
Medullary sponge kidney,32929,4,1,24,1,23,19,0,19,1.0,0.0,0.041666666666666664,1.0,0.0,0.0
Hailey-Hailey disease,32154,2,5,12,6,6,3,1,2,1.2,0.2,0.5,1.2,0.3333333333333333,0.2
Mixed connective tissue disease,38353,16,12,21,3,18,24,2,22,0.25,0.16666666666666666,0.14285714285714285,0.25,0.08333333333333333,0.16666666666666666
Linear verrucous nevus syndrome,98638,4,6,7,0,7,28,2,26,0.0,0.3333333333333333,0.0,0.0,0.07142857142857142,0.3333333333333333
Early-onset generalized limb-onset dystonia,31302,1,4,17,5,12,18,2,16,1.25,0.5,0.29411764705882354,1.25,0.1111111111111111,0.5
Narcolepsy type 1,32306,10,5,21,4,17,28,3,25,0.8,0.6,0.19047619047619047,0.8,0.10714285714285714,0.6
Familial melanoma,33176,2,2,20,1,19,27,0,27,0.5,0.0,0.05,0.5,0.0,0.0
Propionic acidemia,29070,12,5,38,4,34,47,2,45,0.8,0.4,0.10526315789473684,0.8,0.0425531914893617,0.4
Rhizomelic chondrodysplasia punctata,38558,15,15,21,2,19,40,4,36,0.13333333333333333,0.26666666666666666,0.09523809523809523,0.13333333333333333,0.1,0.26666666666666666
Cartilage-hair hypoplasia,31860,1,43,94,46,48,37,2,35,1.069767441860465,0.046511627906976744,0.48936170212765956,1.069767441860465,0.05405405405405406,0.046511627906976744
Essential thrombocythemia,28536,1,15,18,11,7,18,4,14,0.7333333333333333,0.26666666666666666,0.6111111111111112,0.7333333333333333,0.2222222222222222,0.26666666666666666
Smith-Lemli-Opitz syndrome,29631,1,16,18,4,14,30,5,25,0.25,0.3125,0.2222222222222222,0.25,0.16666666666666666,0.3125
Von Willebrand disease,39535,14,4,17,0,17,25,0,25,0.0,0.0,0.0,0.0,0.0,0.0
His bundle tachycardia,32495,11,2,19,3,16,26,2,24,1.5,1.0,0.15789473684210525,1.5,0.07692307692307693,1.0
Catecholaminergic polymorphic ventricular tachycardia,27503,4,1,16,1,15,20,1,19,1.0,1.0,0.0625,1.0,0.05,1.0
Infantile myofibromatosis,29362,11,7,29,1,28,36,0,36,0.14285714285714285,0.0,0.034482758620689655,0.14285714285714285,0.0,0.0
Nephronophthisis,98711,17,0,24,0,24,20,0,20,0.0,0.0,0.0,0.0,0.0,0.0
Congenital pulmonary valvar stenosis,84083,14,1,20,0,20,23,0,23,0.0,0.0,0.0,0.0,0.0,0.0
Common variable immunodeficiency,27188,8,10,39,8,31,28,3,25,0.8,0.3,0.20512820512820512,0.8,0.10714285714285714,0.3
Intellectual disability-polydactyly-uncombable hair syndrome,32810,1,34,28,25,3,26,3,23,0.7352941176470589,0.08823529411764706,0.8928571428571429,0.7352941176470589,0.11538461538461539,0.08823529411764706
Axenfeld-Rieger syndrome,28350,3,3,44,5,39,17,3,14,1.6666666666666667,1.0,0.11363636363636363,1.6666666666666667,0.17647058823529413,1.0
Tyrosinemia type 1,37602,14,1,27,0,27,28,0,28,0.0,0.0,0.0,0.0,0.0,0.0
Cerebral arteriovenous malformation,38143,7,3,18,0,18,27,0,27,0.0,0.0,0.0,0.0,0.0,0.0
Familial cold urticaria,28698,13,9,31,4,27,33,3,30,0.4444444444444444,0.3333333333333333,0.12903225806451613,0.4444444444444444,0.09090909090909091,0.3333333333333333
Hereditary persistence of fetal hemoglobin-beta-thalassemia syndrome,32198,8,4,30,3,27,38,4,34,0.75,1.0,0.1,0.75,0.10526315789473684,1.0
Char syndrome,29956,0,11,34,9,25,29,0,29,0.8181818181818182,0.0,0.2647058823529412,0.8181818181818182,0.0,0.0
Linear IgA dermatosis,32380,5,3,25,3,22,24,1,23,1.0,0.3333333333333333,0.12,1.0,0.041666666666666664,0.3333333333333333
Mucous membrane pemphigoid,32381,6,2,19,2,17,25,1,24,1.0,0.5,0.10526315789473684,1.0,0.04,0.5
Epidermolysis bullosa acquisita,31133,4,2,12,1,11,13,1,12,0.5,0.5,0.08333333333333333,0.5,0.07692307692307693,0.5
Primary effusion lymphoma,33071,10,7,22,7,15,22,2,20,1.0,0.2857142857142857,0.3181818181818182,1.0,0.09090909090909091,0.2857142857142857
Aceruloplasminemia,27772,1,6,34,3,31,26,0,26,0.5,0.0,0.08823529411764706,0.5,0.0,0.0
Congenital cataracts-facial dysmorphism-neuropathy syndrome,30433,1,19,16,3,13,21,1,20,0.15789473684210525,0.05263157894736842,0.1875,0.15789473684210525,0.047619047619047616,0.05263157894736842
Phelan-McDermid syndrome,30547,2,7,23,2,21,23,0,23,0.2857142857142857,0.0,0.08695652173913043,0.2857142857142857,0.0,0.0
Nodular regenerative hyperplasia of the liver,32521,5,1,23,2,21,21,1,20,2.0,1.0,0.08695652173913043,2.0,0.047619047619047616,1.0
Subcorneal pustular dermatosis,32522,4,3,19,1,18,21,3,18,0.3333333333333333,1.0,0.05263157894736842,0.3333333333333333,0.14285714285714285,1.0
Felty syndrome,30061,5,12,17,11,6,25,2,23,0.9166666666666666,0.16666666666666666,0.6470588235294118,0.9166666666666666,0.08,0.16666666666666666
Pyoderma gangrenosum,33494,5,6,16,6,10,24,4,20,1.0,0.6666666666666666,0.375,1.0,0.16666666666666666,0.6666666666666666
Stevens-Johnson syndrome,32746,7,9,17,6,11,35,7,28,0.6666666666666666,0.7777777777777778,0.35294117647058826,0.6666666666666666,0.2,0.7777777777777778
Hypocomplementemic urticarial vasculitis,32737,4,4,18,0,18,25,1,24,0.0,0.25,0.0,0.0,0.04,0.25
Adiposis dolorosa,29641,1,7,17,4,13,25,1,24,0.5714285714285714,0.14285714285714285,0.23529411764705882,0.5714285714285714,0.04,0.14285714285714285
Bullous impetigo,32392,7,4,21,5,16,30,2,28,1.25,0.5,0.23809523809523808,1.25,0.06666666666666667,0.5
Morning glory disc anomaly,33417,1,3,25,3,22,6,0,6,1.0,0.0,0.12,1.0,0.0,0.0
3-hydroxy-3-methylglutaryl-CoA synthase deficiency,31378,7,3,28,3,25,25,2,23,1.0,0.6666666666666666,0.10714285714285714,1.0,0.08,0.6666666666666666
Paroxysmal extreme pain disorder,29403,5,1,19,1,18,22,0,22,1.0,0.0,0.05263157894736842,1.0,0.0,0.0
Gastrointestinal stromal tumor,29194,2,3,17,2,15,25,0,25,0.6666666666666666,0.0,0.11764705882352941,0.6666666666666666,0.0,0.0
PHACE syndrome,29548,1,1,20,1,19,35,0,35,1.0,0.0,0.05,1.0,0.0,0.0
PFAPA syndrome,33134,2,10,16,6,10,27,3,24,0.6,0.3,0.375,0.6,0.1111111111111111,0.3
Omenn syndrome,29973,4,8,31,7,24,30,2,28,0.875,0.25,0.22580645161290322,0.875,0.06666666666666667,0.25
MALT lymphoma,31676,4,8,17,7,10,20,4,16,0.875,0.5,0.4117647058823529,0.875,0.2,0.5
Branchiootic syndrome,29196,1,2,26,2,24,8,0,8,1.0,0.0,0.07692307692307693,1.0,0.0,0.0
X-linked creatine transporter deficiency,30717,1,5,18,3,15,25,1,24,0.6,0.2,0.16666666666666666,0.6,0.04,0.2
Muenke syndrome,27500,1,0,39,0,39,31,0,31,0.0,0.0,0.0,0.0,0.0,0.0
Corpus callosum agenesis-intellectual disability-coloboma-micrognathia syndrome,30625,3,16,17,11,6,29,2,27,0.6875,0.125,0.6470588235294118,0.6875,0.06896551724137931,0.125
Ulnar/fibula ray defect-brachydactyly syndrome,27244,2,1,18,2,16,24,0,24,2.0,0.0,0.1111111111111111,2.0,0.0,0.0
Mantle cell lymphoma,32531,9,2,21,2,19,31,0,31,1.0,0.0,0.09523809523809523,1.0,0.0,0.0
Wyburn-Mason syndrome,32508,1,6,17,1,16,20,0,20,0.16666666666666666,0.0,0.058823529411764705,0.16666666666666666,0.0,0.0
Spinal arteriovenous metameric syndrome,32557,0,12,17,10,7,23,1,22,0.8333333333333334,0.08333333333333333,0.5882352941176471,0.8333333333333334,0.043478260869565216,0.08333333333333333
Hypotrichosis simplex,27278,5,5,22,4,18,19,1,18,0.8,0.2,0.18181818181818182,0.8,0.05263157894736842,0.2
Familial cutaneous collagenoma,30088,1,2,19,2,17,15,2,13,1.0,1.0,0.10526315789473684,1.0,0.13333333333333333,1.0
Gnathodiaphyseal dysplasia,28298,2,3,17,3,14,7,0,7,1.0,0.0,0.17647058823529413,1.0,0.0,0.0
Familial tumoral calcinosis,32506,2,4,18,5,13,25,2,23,1.25,0.5,0.2777777777777778,1.25,0.08,0.5
Lipodystrophy-intellectual disability-deafness syndrome,30883,1,13,16,8,8,30,1,29,0.6153846153846154,0.07692307692307693,0.5,0.6153846153846154,0.03333333333333333,0.07692307692307693
Microlissencephaly-micromelia syndrome,32892,3,21,16,11,5,18,1,17,0.5238095238095238,0.047619047619047616,0.6875,0.5238095238095238,0.05555555555555555,0.047619047619047616
Craniolenticulosutural dysplasia,27877,0,26,18,1,17,16,0,16,0.038461538461538464,0.0,0.05555555555555555,0.038461538461538464,0.0,0.0
Zellweger-like syndrome without peroxisomal anomalies,32874,0,15,17,2,15,16,0,16,0.13333333333333333,0.0,0.11764705882352941,0.13333333333333333,0.0,0.0
Lichen amyloidosis,32648,3,2,14,2,12,12,1,11,1.0,0.5,0.14285714285714285,1.0,0.08333333333333333,0.5
Focal myositis,33270,10,1,17,1,16,27,0,27,1.0,0.0,0.058823529411764705,1.0,0.0,0.0
Talo-patello-scaphoid osteolysis,27572,1,6,19,5,14,28,0,28,0.8333333333333334,0.0,0.2631578947368421,0.8333333333333334,0.0,0.0
Thiamine-responsive megaloblastic anemia syndrome,28236,1,9,16,4,12,25,3,22,0.4444444444444444,0.3333333333333333,0.25,0.4444444444444444,0.12,0.3333333333333333
Blomstrand lethal chondrodysplasia,30248,0,28,18,2,16,46,0,46,0.07142857142857142,0.0,0.1111111111111111,0.07142857142857142,0.0,0.0
Braddock syndrome,31182,0,10,17,6,11,19,0,19,0.6,0.0,0.35294117647058826,0.6,0.0,0.0
Potocki-Shaffer syndrome,29123,3,10,17,7,10,32,1,31,0.7,0.1,0.4117647058823529,0.7,0.03125,0.1
Branchiogenic deafness syndrome,32168,0,18,18,14,4,32,0,32,0.7777777777777778,0.0,0.7777777777777778,0.7777777777777778,0.0,0.0
Keratolytic winter erythema,30620,5,1,18,1,17,19,2,17,1.0,2.0,0.05555555555555555,1.0,0.10526315789473684,2.0
Striate palmoplantar keratoderma,28842,5,1,13,1,12,9,1,8,1.0,1.0,0.07692307692307693,1.0,0.1111111111111111,1.0
Sebocystomatosis,29397,3,2,23,0,23,14,0,14,0.0,0.0,0.0,0.0,0.0,0.0
Lipoid proteinosis,31566,1,12,19,9,10,27,2,25,0.75,0.16666666666666666,0.47368421052631576,0.75,0.07407407407407407,0.16666666666666666
Porokeratosis of Mibelli,32975,9,3,19,3,16,17,3,14,1.0,1.0,0.15789473684210525,1.0,0.17647058823529413,1.0
Familial multiple trichoepithelioma,28726,4,2,13,2,11,36,0,36,1.0,0.0,0.15384615384615385,1.0,0.0,0.0
Bullous pemphigoid,33194,8,9,17,5,12,35,3,32,0.5555555555555556,0.3333333333333333,0.29411764705882354,0.5555555555555556,0.08571428571428572,0.3333333333333333
Relapsing polychondritis,33203,1,5,17,1,16,39,1,38,0.2,0.2,0.058823529411764705,0.2,0.02564102564102564,0.2
Hypoplasminogenemia,28591,0,3,21,3,18,19,0,19,1.0,0.0,0.14285714285714285,1.0,0.0,0.0
Desmoid tumor,30659,3,5,18,3,15,29,0,29,0.6,0.0,0.16666666666666666,0.6,0.0,0.0
Muscle-eye-brain disease,33277,1,13,16,7,9,18,1,17,0.5384615384615384,0.07692307692307693,0.4375,0.5384615384615384,0.05555555555555555,0.07692307692307693
"Distal myopathy, Welander type",27805,4,6,18,7,11,29,1,28,1.1666666666666667,0.16666666666666666,0.3888888888888889,1.1666666666666667,0.034482758620689655,0.16666666666666666
Congenital primary megaureter,98139,2,3,5,1,4,25,3,22,0.3333333333333333,1.0,0.2,0.3333333333333333,0.12,1.0
"Congenital muscular dystrophy, Fukuyama type",28595,3,13,24,4,20,24,1,23,0.3076923076923077,0.07692307692307693,0.16666666666666666,0.3076923076923077,0.041666666666666664,0.07692307692307693
Acrokeratoelastoidosis of Costa,38117,5,4,16,0,16,10,2,8,0.0,0.5,0.0,0.0,0.2,0.5
Dyschromatosis universalis hereditaria,29842,0,4,16,5,11,24,0,24,1.25,0.0,0.3125,1.25,0.0,0.0
Familial cylindromatosis,29866,0,2,11,2,9,34,0,34,1.0,0.0,0.18181818181818182,1.0,0.0,0.0
Dyschromatosis symmetrica hereditaria,29842,1,3,16,4,12,33,0,33,1.3333333333333333,0.0,0.25,1.3333333333333333,0.0,0.0
Acquired ichthyosis,39370,6,3,22,1,21,14,1,13,0.3333333333333333,0.3333333333333333,0.045454545454545456,0.3333333333333333,0.07142857142857142,0.3333333333333333
Hyperkeratosis lenticularis perstans,28179,1,2,13,1,12,26,1,25,0.5,0.5,0.07692307692307693,0.5,0.038461538461538464,0.5
Progressive symmetric erythrokeratodermia,38275,6,3,26,1,25,15,3,12,0.3333333333333333,1.0,0.038461538461538464,0.3333333333333333,0.2,1.0
Hereditary leiomyomatosis and renal cell cancer,30295,0,3,17,3,14,19,0,19,1.0,0.0,0.17647058823529413,1.0,0.0,0.0
Erythroderma desquamativum,38275,9,4,27,0,27,13,0,13,0.0,0.0,0.0,0.0,0.0,0.0
Familial keratoacanthoma,33441,2,5,19,6,13,9,0,9,1.2,0.0,0.3157894736842105,1.2,0.0,0.0
Jessner lymphocytic infiltration of the skin,32420,1,3,21,3,18,6,3,3,1.0,1.0,0.14285714285714285,1.0,0.5,1.0
Bullous lichen planus,32619,8,4,26,4,22,29,1,28,1.0,0.25,0.15384615384615385,1.0,0.034482758620689655,0.25
Glutamate-cysteine ligase deficiency,95085,13,5,25,0,25,31,0,31,0.0,0.0,0.0,0.0,0.0,0.0
Nodular non-suppurative panniculitis,32789,6,11,17,11,6,33,6,27,1.0,0.5454545454545454,0.6470588235294118,1.0,0.18181818181818182,0.5454545454545454
Naxos disease,28931,3,7,22,6,16,25,4,21,0.8571428571428571,0.5714285714285714,0.2727272727272727,0.8571428571428571,0.16,0.5714285714285714
Non-syndromic sagittal craniosynostosis,38233,10,1,32,0,32,28,1,27,0.0,1.0,0.0,0.0,0.03571428571428571,1.0
Non-syndromic bicoronal craniosynostosis,27344,5,2,31,1,30,35,0,35,0.5,0.0,0.03225806451612903,0.5,0.0,0.0
Nanophthalmos,29133,14,5,21,2,19,20,2,18,0.4,0.4,0.09523809523809523,0.4,0.1,0.4
ALDH18A1-related De Barsy syndrome,31539,2,5,17,2,15,27,1,26,0.4,0.2,0.11764705882352941,0.4,0.037037037037037035,0.2
Erdheim-Chester disease,33533,2,16,18,6,12,23,3,20,0.375,0.1875,0.3333333333333333,0.375,0.13043478260869565,0.1875
Polycythemia vera,29118,4,16,19,6,13,19,4,15,0.375,0.25,0.3157894736842105,0.375,0.21052631578947367,0.25
Idiopathic acute eosinophilic pneumonia,33206,8,5,18,5,13,21,2,19,1.0,0.4,0.2777777777777778,1.0,0.09523809523809523,0.4
Pseudomyxoma peritonei,33551,8,3,16,3,13,17,1,16,1.0,0.3333333333333333,0.1875,1.0,0.058823529411764705,0.3333333333333333
Follicular lymphoma,30514,17,5,19,2,17,31,2,29,0.4,0.4,0.10526315789473684,0.4,0.06451612903225806,0.4
Spontaneous periodic hypothermia,33550,4,7,16,7,9,22,4,18,1.0,0.5714285714285714,0.4375,1.0,0.18181818181818182,0.5714285714285714
Reactive arthritis,32464,4,15,17,8,9,25,4,21,0.5333333333333333,0.26666666666666666,0.47058823529411764,0.5333333333333333,0.16,0.26666666666666666
Dermatofibrosarcoma protuberans,33089,9,5,15,5,10,23,2,21,1.0,0.4,0.3333333333333333,1.0,0.08695652173913043,0.4
Hereditary arginine vasopressin deficiency,29832,1,2,16,0,16,38,1,37,0.0,0.5,0.0,0.0,0.02631578947368421,0.5
Tumor necrosis factor receptor 1 associated periodic syndrome,30937,1,10,18,4,14,26,1,25,0.4,0.1,0.2222222222222222,0.4,0.038461538461538464,0.1
Autosomal agammaglobulinemia,27170,1,13,19,3,16,26,4,22,0.23076923076923078,0.3076923076923077,0.15789473684210525,0.23076923076923078,0.15384615384615385,0.3076923076923077
Lymphedema-distichiasis syndrome,30797,2,5,26,3,23,34,1,33,0.6,0.2,0.11538461538461539,0.6,0.029411764705882353,0.2
Waldenström macroglobulinemia,28306,0,3,14,2,12,29,0,29,0.6666666666666666,0.0,0.14285714285714285,0.6666666666666666,0.0,0.0
Idiopathic hypersomnia,32201,9,3,20,2,18,15,1,14,0.6666666666666666,0.3333333333333333,0.1,0.6666666666666666,0.06666666666666667,0.3333333333333333
Autosomal erythropoietic protoporphyria,33555,7,4,25,4,21,42,2,40,1.0,0.5,0.16,1.0,0.047619047619047616,0.5
Alpha-N-acetylgalactosaminidase deficiency type 1,30022,0,12,20,7,13,2,0,2,0.5833333333333334,0.0,0.35,0.5833333333333334,0.0,0.0
Acute intermittent porphyria,30961,8,5,25,2,23,19,1,18,0.4,0.2,0.08,0.4,0.05263157894736842,0.2
Galactose epimerase deficiency,98355,12,13,32,4,28,19,1,18,0.3076923076923077,0.07692307692307693,0.125,0.3076923076923077,0.05263157894736842,0.07692307692307693
Crigler-Najjar syndrome type 1,27412,2,7,17,4,13,24,0,24,0.5714285714285714,0.0,0.23529411764705882,0.5714285714285714,0.0,0.0
Crigler-Najjar syndrome type 2,27412,2,3,17,1,16,26,0,26,0.3333333333333333,0.0,0.058823529411764705,0.3333333333333333,0.0,0.0
Holocarboxylase synthetase deficiency,28786,1,9,17,8,9,26,2,24,0.8888888888888888,0.2222222222222222,0.47058823529411764,0.8888888888888888,0.07692307692307693,0.2222222222222222
Classic phenylketonuria,31918,1,7,26,4,22,30,0,30,0.5714285714285714,0.0,0.15384615384615385,0.5714285714285714,0.0,0.0
Biotinidase deficiency,28555,2,3,43,2,41,26,0,26,0.6666666666666666,0.0,0.046511627906976744,0.6666666666666666,0.0,0.0
L-2-hydroxyglutaric aciduria,30308,1,4,17,1,16,39,0,39,0.25,0.0,0.058823529411764705,0.25,0.0,0.0
Vitamin B12-unresponsive methylmalonic acidemia type mut-,33189,0,7,17,3,14,20,0,20,0.42857142857142855,0.0,0.17647058823529413,0.42857142857142855,0.0,0.0
ALG3-CDG,31949,3,7,20,1,19,20,1,19,0.14285714285714285,0.14285714285714285,0.05,0.14285714285714285,0.05,0.14285714285714285
"Methylmalonic acidemia with homocystinuria, type cblD",33171,7,12,18,6,12,30,2,28,0.5,0.16666666666666666,0.3333333333333333,0.5,0.06666666666666667,0.16666666666666666
Alpha-N-acetylgalactosaminidase deficiency type 3,30022,0,6,17,2,15,5,0,5,0.3333333333333333,0.0,0.11764705882352941,0.3333333333333333,0.0,0.0
Alpha-N-acetylgalactosaminidase deficiency type 2,28665,0,9,23,0,23,3,0,3,0.0,0.0,0.0,0.0,0.0,0.0
Congenital bile acid synthesis defect type 1,28517,4,7,33,7,26,19,4,15,1.0,0.5714285714285714,0.21212121212121213,1.0,0.21052631578947367,0.5714285714285714
Fish-eye disease,30458,0,2,17,3,14,26,0,26,1.5,0.0,0.17647058823529413,1.5,0.0,0.0
Trichorhinophalangeal syndrome type 1,27224,0,18,18,3,15,17,0,17,0.16666666666666666,0.0,0.16666666666666666,0.16666666666666666,0.0,0.0
Gaucher disease type 1,28772,5,13,110,12,98,29,5,24,0.9230769230769231,0.38461538461538464,0.10909090909090909,0.9230769230769231,0.1724137931034483,0.38461538461538464
Gaucher disease type 2,28772,1,9,28,2,26,17,1,16,0.2222222222222222,0.1111111111111111,0.07142857142857142,0.2222222222222222,0.058823529411764705,0.1111111111111111
Gaucher disease type 3,28772,0,9,33,4,29,13,3,10,0.4444444444444444,0.3333333333333333,0.12121212121212122,0.4444444444444444,0.23076923076923078,0.3333333333333333
Majeed syndrome,28357,0,13,39,13,26,17,0,17,1.0,0.0,0.3333333333333333,1.0,0.0,0.0
Anophthalmia/microphthalmia-esophageal atresia syndrome,30389,4,4,31,2,29,30,5,25,0.5,1.25,0.06451612903225806,0.5,0.16666666666666666,1.25
Monosomy 9q22.3 syndrome,33183,1,31,17,8,9,30,2,28,0.25806451612903225,0.06451612903225806,0.47058823529411764,0.25806451612903225,0.06666666666666667,0.06451612903225806
Bradyopsia,27501,17,2,26,3,23,28,2,26,1.5,1.0,0.11538461538461539,1.5,0.07142857142857142,1.0
Oligocone trichromacy,32826,16,1,26,1,25,32,0,32,1.0,0.0,0.038461538461538464,1.0,0.0,0.0
Brain malformation-congenital heart disease-postaxial polydactyly syndrome,32786,2,13,18,10,8,40,3,37,0.7692307692307693,0.23076923076923078,0.5555555555555556,0.7692307692307693,0.075,0.23076923076923078
Periodontal Ehlers-Danlos syndrome,32781,12,4,28,4,24,29,1,28,1.0,0.25,0.14285714285714285,1.0,0.034482758620689655,0.25
B4GALT7-related spondylodysplastic Ehlers-Danlos syndrome,31142,1,21,33,5,28,23,0,23,0.23809523809523808,0.0,0.15151515151515152,0.23809523809523808,0.0,0.0
X-linked Ehlers-Danlos syndrome,32968,8,10,24,7,17,27,0,27,0.7,0.0,0.2916666666666667,0.7,0.0,0.0
X-linked sideroblastic anemia,29390,2,5,20,1,19,34,2,32,0.2,0.4,0.05,0.2,0.058823529411764705,0.4
Focal facial dermal dysplasia type I,27910,2,11,22,5,17,37,0,37,0.45454545454545453,0.0,0.22727272727272727,0.45454545454545453,0.0,0.0
Hereditary painful callosities,29966,6,2,18,2,16,19,1,18,1.0,0.5,0.1111111111111111,1.0,0.05263157894736842,0.5
Seizures-intellectual disability due to hydroxylysinuria syndrome,27998,13,3,25,3,22,33,1,32,1.0,0.3333333333333333,0.12,1.0,0.030303030303030304,0.3333333333333333
Disseminated superficial actinic porokeratosis,28427,6,1,24,0,24,20,0,20,0.0,0.0,0.0,0.0,0.0,0.0
HJV or HAMP-related hemochromatosis,28176,2,4,17,0,17,21,0,21,0.0,0.0,0.0,0.0,0.0,0.0
Acquired partial lipodystrophy,31864,3,1,18,1,17,39,1,38,1.0,1.0,0.05555555555555555,1.0,0.02564102564102564,1.0
"Familial partial lipodystrophy, Köbberling type",27788,2,5,17,3,14,39,3,36,0.6,0.6,0.17647058823529413,0.6,0.07692307692307693,0.6
Grange syndrome,31322,0,4,16,6,10,17,0,17,1.5,0.0,0.375,1.5,0.0,0.0
Developmental malformations-deafness-dystonia syndrome,29667,18,19,31,1,30,27,1,26,0.05263157894736842,0.05263157894736842,0.03225806451612903,0.05263157894736842,0.037037037037037035,0.05263157894736842
Trichodysplasia-amelogenesis imperfecta syndrome,33379,2,3,10,3,7,23,0,23,1.0,0.0,0.3,1.0,0.0,0.0
Mandibulofacial dysostosis-microcephaly syndrome,30391,2,20,31,4,27,14,1,13,0.2,0.05,0.12903225806451613,0.2,0.07142857142857142,0.05
Hypotrichosis-lymphedema-telangiectasia-renal defect syndrome,30021,2,9,20,2,18,28,0,28,0.2222222222222222,0.0,0.1,0.2222222222222222,0.0,0.0
Rhabdoid tumor,33519,0,0,17,0,17,34,0,34,0.0,0.0,0.0,0.0,0.0,0.0
Liposarcoma,33520,8,2,19,2,17,34,0,34,1.0,0.0,0.10526315789473684,1.0,0.0,0.0
Idiopathic steroid-sensitive nephrotic syndrome,33491,15,2,19,0,19,23,0,23,0.0,0.0,0.0,0.0,0.0,0.0
Congenital membranous nephropathy due to fetomaternal anti-neutral endopeptidase alloimmunization,33493,14,4,26,1,25,20,1,19,0.25,0.25,0.038461538461538464,0.25,0.05,0.25
3-methylglutaconic aciduria type 4,28809,5,7,17,3,14,27,2,25,0.42857142857142855,0.2857142857142857,0.17647058823529413,0.42857142857142855,0.07407407407407407,0.2857142857142857
3-methylglutaconic aciduria type 1,28809,6,2,17,0,17,29,0,29,0.0,0.0,0.0,0.0,0.0,0.0
3-methylglutaconic aciduria type 3,28809,3,3,17,2,15,32,0,32,0.6666666666666666,0.0,0.11764705882352941,0.6666666666666666,0.0,0.0
Mast cell sarcoma,33168,8,2,20,2,18,24,0,24,1.0,0.0,0.1,1.0,0.0,0.0
Diaphanospondylodysostosis,31125,0,10,18,4,14,34,0,34,0.4,0.0,0.2222222222222222,0.4,0.0,0.0
Progressive bifocal chorioretinal atrophy,30685,9,6,18,5,13,27,2,25,0.8333333333333334,0.3333333333333333,0.2777777777777778,0.8333333333333334,0.07407407407407407,0.3333333333333333
Cholesteryl ester storage disease,32691,8,1,24,1,23,25,1,24,1.0,1.0,0.041666666666666664,1.0,0.04,1.0
Wolman disease,32119,13,7,38,0,38,40,1,39,0.0,0.14285714285714285,0.0,0.0,0.025,0.14285714285714285
Growth delay due to insulin-like growth factor I resistance,29297,1,4,32,5,27,27,2,25,1.25,0.5,0.15625,1.25,0.07407407407407407,0.5
Visceral neuropathy-brain anomalies-facial dysmorphism-developmental delay syndrome,32245,1,12,21,11,10,39,0,39,0.9166666666666666,0.0,0.5238095238095238,0.9166666666666666,0.0,0.0
Psychogenic movement disorders,32586,6,1,28,2,26,24,1,23,2.0,1.0,0.07142857142857142,2.0,0.041666666666666664,1.0
Familial thrombocytosis,32293,1,4,16,2,14,27,2,25,0.5,0.5,0.125,0.5,0.07407407407407407,0.5
Radio-ulnar synostosis-amegakaryocytic thrombocytopenia syndrome,27384,2,2,17,1,16,26,1,25,0.5,0.5,0.058823529411764705,0.5,0.038461538461538464,0.5
Silent sinus syndrome,33371,11,1,26,0,26,22,0,22,0.0,0.0,0.0,0.0,0.0,0.0
Dentinogenesis imperfecta-short stature-hearing loss-intellectual disability syndrome,33367,8,11,22,8,14,26,3,23,0.7272727272727273,0.2727272727272727,0.36363636363636365,0.7272727272727273,0.11538461538461539,0.2727272727272727
Transient predisposition to invasive pyogenic bacterial infection,30848,1,5,19,2,17,32,1,31,0.4,0.2,0.10526315789473684,0.4,0.03125,0.2
Cholangiocarcinoma,33045,11,3,14,2,12,20,3,17,0.6666666666666666,1.0,0.14285714285714285,0.6666666666666666,0.15,1.0
Angel-shaped phalango-epiphyseal dysplasia,28746,0,4,15,5,10,28,0,28,1.25,0.0,0.3333333333333333,1.25,0.0,0.0
Acrocapitofemoral dysplasia,27442,2,8,19,6,13,25,5,20,0.75,0.625,0.3157894736842105,0.75,0.2,0.625
Paraneoplastic pemphigus,32966,2,4,17,4,13,33,1,32,1.0,0.25,0.23529411764705882,1.0,0.030303030303030304,0.25
Iniencephaly,94630,8,2,28,0,28,29,0,29,0.0,0.0,0.0,0.0,0.0,0.0
Craniorachischisis,32690,5,4,23,3,20,13,1,12,0.75,0.25,0.13043478260869565,0.75,0.07692307692307693,0.25
Pemphigoid gestationis,32669,4,4,11,4,7,22,3,19,1.0,0.75,0.36363636363636365,1.0,0.13636363636363635,0.75
Rhombencephalosynapsis,33065,1,12,24,10,14,8,0,8,0.8333333333333334,0.0,0.4166666666666667,0.8333333333333334,0.0,0.0
Loeys-Dietz syndrome,31164,3,9,39,7,32,20,4,16,0.7777777777777778,0.4444444444444444,0.1794871794871795,0.7777777777777778,0.2,0.4444444444444444
Megalencephaly-capillary malformation-polymicrogyria syndrome,31062,1,12,39,9,30,1,1,0,0.75,0.08333333333333333,0.23076923076923078,0.75,1.0,0.08333333333333333
Cold agglutinin disease,33080,9,6,17,6,11,29,4,25,1.0,0.6666666666666666,0.35294117647058826,1.0,0.13793103448275862,0.6666666666666666
Mazabraud syndrome,33123,9,1,19,1,18,29,0,29,1.0,0.0,0.05263157894736842,1.0,0.0,0.0
Neonatal ichthyosis-sclerosing cholangitis syndrome,29850,4,10,24,9,15,21,3,18,0.9,0.3,0.375,0.9,0.14285714285714285,0.3
Congenital pseudoarthrosis of the clavicle,30585,3,3,10,2,8,25,1,24,0.6666666666666666,0.3333333333333333,0.2,0.6666666666666666,0.04,0.3333333333333333
Goldberg-Shprintzen megacolon syndrome,30475,0,6,24,4,20,21,0,21,0.6666666666666666,0.0,0.16666666666666666,0.6666666666666666,0.0,0.0
Sensorineural hearing loss-early graying-essential tremor syndrome,33181,7,2,18,2,16,24,1,23,1.0,0.5,0.1111111111111111,1.0,0.041666666666666664,0.5
Benign recurrent intrahepatic cholestasis,31033,7,8,17,8,9,24,4,20,1.0,0.5,0.47058823529411764,1.0,0.16666666666666666,0.5
Permanent neonatal diabetes mellitus-pancreatic and cerebellar agenesis syndrome,31103,2,6,24,6,18,21,0,21,1.0,0.0,0.25,1.0,0.0,0.0
Monomelic amyotrophy,28519,0,4,17,6,11,12,1,11,1.5,0.25,0.35294117647058826,1.5,0.08333333333333333,0.25
3q29 microdeletion syndrome,33028,2,2,17,1,16,32,1,31,0.5,0.5,0.058823529411764705,0.5,0.03125,0.5
Lhermitte-Duclos disease,32948,2,13,17,12,5,26,2,24,0.9230769230769231,0.15384615384615385,0.7058823529411765,0.9230769230769231,0.07692307692307693,0.15384615384615385
Pulmonary blastoma,33030,8,5,18,4,14,17,4,13,0.8,0.8,0.2222222222222222,0.8,0.23529411764705882,0.8
Schisis association,32295,0,6,25,5,20,19,0,19,0.8333333333333334,0.0,0.2,0.8333333333333334,0.0,0.0
Becker nevus syndrome,29934,0,6,15,3,12,29,0,29,0.5,0.0,0.2,0.5,0.0,0.0
Nevus comedonicus syndrome,31358,0,2,15,1,14,10,0,10,0.5,0.0,0.06666666666666667,0.5,0.0,0.0
X-linked spinocerebellar ataxia type 3,29145,2,6,18,4,14,3,1,2,0.6666666666666666,0.16666666666666666,0.2222222222222222,0.6666666666666666,0.3333333333333333,0.16666666666666666
"HSD10 disease, atypical type",32958,3,3,51,2,49,33,0,33,0.6666666666666666,0.0,0.0392156862745098,0.6666666666666666,0.0,0.0
X-linked epilepsy-learning disabilities-behavior disorders syndrome,31029,10,4,22,5,17,18,0,18,1.25,0.0,0.22727272727272727,1.25,0.0,0.0
"X-linked intellectual disability, Cabezas type",27603,5,20,54,1,53,28,0,28,0.05,0.0,0.018518518518518517,0.05,0.0,0.0
"Deafness-intellectual disability syndrome, Martin-Probst type",29667,8,14,26,0,26,17,0,17,0.0,0.0,0.0,0.0,0.0,0.0
X-linked intellectual disability-macrocephaly-macroorchidism syndrome,32561,12,3,20,2,18,31,2,29,0.6666666666666666,0.6666666666666666,0.1,0.6666666666666666,0.06451612903225806,0.6666666666666666
X-linked intellectual disability-hypogammaglobulinemia-progressive neurological deterioration syndrome,32559,4,9,17,7,10,16,2,14,0.7777777777777778,0.2222222222222222,0.4117647058823529,0.7777777777777778,0.125,0.2222222222222222
X-linked intellectual disability-hypotonia-facial dysmorphism-aggressive behavior syndrome,32547,0,16,17,14,3,21,0,21,0.875,0.0,0.8235294117647058,0.875,0.0,0.0
"X-linked intellectual disability, Stevenson type",38443,17,14,25,0,25,27,1,26,0.0,0.07142857142857142,0.0,0.0,0.037037037037037035,0.07142857142857142
"X-linked intellectual disability, Shrimpton type",28944,3,5,18,1,17,26,0,26,0.2,0.0,0.05555555555555555,0.2,0.0,0.0
"X-linked intellectual disability, Pai type",28944,5,4,21,2,19,29,0,29,0.5,0.0,0.09523809523809523,0.5,0.0,0.0
"X-linked neurodegenerative syndrome, Bertini type",32534,4,10,17,10,7,18,1,17,1.0,0.1,0.5882352941176471,1.0,0.05555555555555555,0.1
X-linked intellectual disability-retinitis pigmentosa syndrome,28653,8,2,25,2,23,25,1,24,1.0,0.5,0.08,1.0,0.04,0.5
X-linked intellectual disability-ataxia-apraxia syndrome,32533,9,3,22,2,20,17,2,15,0.6666666666666666,0.6666666666666666,0.09090909090909091,0.6666666666666666,0.11764705882352941,0.6666666666666666
Fried syndrome,32536,0,7,17,5,12,33,0,33,0.7142857142857143,0.0,0.29411764705882354,0.7142857142857143,0.0,0.0
"X-linked neurodegenerative syndrome, Hamel type",32532,2,6,23,6,17,12,0,12,1.0,0.0,0.2608695652173913,1.0,0.0,0.0
Systemic-onset juvenile idiopathic arthritis,98688,17,9,25,3,22,29,3,26,0.3333333333333333,0.3333333333333333,0.12,0.3333333333333333,0.10344827586206896,0.3333333333333333
Rheumatoid factor-positive polyarticular juvenile idiopathic arthritis,32726,8,4,19,4,15,30,3,27,1.0,0.75,0.21052631578947367,1.0,0.1,0.75
X-linked severe congenital neutropenia,27468,12,3,16,3,13,33,2,31,1.0,0.6666666666666666,0.1875,1.0,0.06060606060606061,0.6666666666666666
Benign adult familial myoclonic epilepsy,29656,2,3,16,3,13,23,0,23,1.0,0.0,0.1875,1.0,0.0,0.0
Diffuse palmoplantar keratoderma-acrocyanosis syndrome,33067,6,2,17,1,16,6,0,6,0.5,0.0,0.058823529411764705,0.5,0.0,0.0
Alport syndrome-intellectual disability-midface hypoplasia-elliptocytosis syndrome,28039,1,9,17,3,14,32,0,32,0.3333333333333333,0.0,0.17647058823529413,0.3333333333333333,0.0,0.0
Nodular lymphocyte predominant Hodgkin lymphoma,32866,4,3,16,3,13,20,1,19,1.0,0.3333333333333333,0.1875,1.0,0.05,0.3333333333333333
Craniofacial conodysplasia,33477,7,5,24,6,18,28,4,24,1.2,0.8,0.25,1.2,0.14285714285714285,0.8
"Mesomelic dysplasia, Savarirayan type",38211,25,13,41,3,38,38,2,36,0.23076923076923078,0.15384615384615385,0.07317073170731707,0.23076923076923078,0.05263157894736842,0.15384615384615385
Familial digital arthropathy-brachydactyly,27205,1,6,16,7,9,28,0,28,1.1666666666666667,0.0,0.4375,1.1666666666666667,0.0,0.0
"Microcephalic osteodysplastic dysplasia, Saul-Wilson type",29899,2,16,33,14,19,22,1,21,0.875,0.0625,0.42424242424242425,0.875,0.045454545454545456,0.0625
Astley-Kendall dysplasia,33478,0,4,7,4,3,19,0,19,1.0,0.0,0.5714285714285714,1.0,0.0,0.0
Pseudodiastrophic dysplasia,29738,0,7,17,4,13,27,0,27,0.5714285714285714,0.0,0.23529411764705882,0.5714285714285714,0.0,0.0
Spondylo-ocular syndrome,27340,1,11,25,8,17,29,1,28,0.7272727272727273,0.09090909090909091,0.32,0.7272727272727273,0.034482758620689655,0.09090909090909091
Idiopathic juvenile osteoporosis,27458,8,3,20,3,17,26,2,24,1.0,0.6666666666666666,0.15,1.0,0.07692307692307693,0.6666666666666666
Dysspondyloenchondromatosis,38339,18,13,28,0,28,22,0,22,0.0,0.0,0.0,0.0,0.0,0.0
Genochondromatosis type 1,30693,0,3,14,2,12,17,0,17,0.6666666666666666,0.0,0.14285714285714285,0.6666666666666666,0.0,0.0
Genitopatellar syndrome,30118,1,19,46,15,31,18,1,17,0.7894736842105263,0.05263157894736842,0.32608695652173914,0.7894736842105263,0.05555555555555555,0.05263157894736842
Craniosynostosis-anal anomalies-porokeratosis syndrome,29126,3,24,42,19,23,41,3,38,0.7916666666666666,0.125,0.4523809523809524,0.7916666666666666,0.07317073170731707,0.125
Acropectoral syndrome,30936,0,3,19,3,16,18,0,18,1.0,0.0,0.15789473684210525,1.0,0.0,0.0
Keutel syndrome,31666,0,8,19,3,16,6,0,6,0.375,0.0,0.15789473684210525,0.375,0.0,0.0
Fetal Gaucher disease,30366,2,8,17,2,15,25,1,24,0.25,0.125,0.11764705882352941,0.25,0.04,0.125
"X-linked intellectual disability, Abidi type",28944,6,5,29,3,26,30,3,27,0.6,0.6,0.10344827586206896,0.6,0.1,0.6
Syndromic X-linked intellectual disability 7,38443,12,5,27,1,26,33,1,32,0.2,0.2,0.037037037037037035,0.2,0.030303030303030304,0.2
Microphthalmia-ankyloblepharon-intellectual disability syndrome,32291,13,4,29,4,25,24,2,22,1.0,0.5,0.13793103448275862,1.0,0.08333333333333333,0.5
"X-linked intellectual disability, Armfield type",29211,1,11,16,4,12,23,0,23,0.36363636363636365,0.0,0.25,0.36363636363636365,0.0,0.0
"X-linked intellectual disability, Cantagrel type",28944,3,11,24,3,21,24,1,23,0.2727272727272727,0.09090909090909091,0.125,0.2727272727272727,0.041666666666666664,0.09090909090909091
Christianson syndrome,31574,0,13,58,12,46,21,0,21,0.9230769230769231,0.0,0.20689655172413793,0.9230769230769231,0.0,0.0
KDM5C-related syndromic X-linked intellectual disability,38443,13,5,28,0,28,31,1,30,0.0,0.2,0.0,0.0,0.03225806451612903,0.2
X-linked intellectual disability-cubitus valgus-dysmorphism syndrome,32093,2,8,15,7,8,36,1,35,0.875,0.125,0.4666666666666667,0.875,0.027777777777777776,0.125
MEHMO syndrome,31400,0,14,18,0,18,16,0,16,0.0,0.0,0.0,0.0,0.0,0.0
"X-linked intellectual disability, Miles-Carpenter type",28944,4,2,20,0,20,31,0,31,0.0,0.0,0.0,0.0,0.0,0.0
BRESEK syndrome,32285,0,13,20,10,10,12,0,12,0.7692307692307693,0.0,0.5,0.7692307692307693,0.0,0.0
"X-linked intellectual disability, Shashi type",28944,5,11,21,0,21,32,0,32,0.0,0.0,0.0,0.0,0.0,0.0
"X-linked intellectual disability, Siderius type",38443,9,6,22,0,22,23,0,23,0.0,0.0,0.0,0.0,0.0,0.0
Oculocutaneous albinism type 4,84278,11,4,25,3,22,31,3,28,0.75,0.75,0.12,0.75,0.0967741935483871,0.75
Oculocutaneous albinism type 1B,84278,7,7,30,2,28,33,1,32,0.2857142857142857,0.14285714285714285,0.06666666666666667,0.2857142857142857,0.030303030303030304,0.14285714285714285
Ichthyosis hystrix of Curth-Macklin,31739,9,4,21,2,19,17,2,15,0.5,0.5,0.09523809523809523,0.5,0.11764705882352941,0.5
Griscelli syndrome type 3,27582,3,1,58,1,57,26,0,26,1.0,0.0,0.017241379310344827,1.0,0.0,0.0
Griscelli syndrome type 2,27582,3,8,58,9,49,31,0,31,1.125,0.0,0.15517241379310345,1.125,0.0,0.0
Griscelli syndrome type 1,27582,4,12,58,12,46,34,0,34,1.0,0.0,0.20689655172413793,1.0,0.0,0.0
Macrostomia-preauricular tags-external ophthalmoplegia syndrome,32745,9,0,25,0,25,28,0,28,0.0,0.0,0.0,0.0,0.0,0.0
LUMBAR syndrome,32086,4,1,36,0,36,21,0,21,0.0,0.0,0.0,0.0,0.0,0.0
Desmoplastic small round cell tumor,32307,4,5,16,6,10,25,2,23,1.2,0.4,0.375,1.2,0.08,0.4
Megalencephaly-polymicrogyria-postaxial polydactyly-hydrocephalus syndrome,32294,3,5,13,4,9,27,4,23,0.8,0.8,0.3076923076923077,0.8,0.14814814814814814,0.8
Congenital primary aphakia,30592,0,4,10,3,7,23,0,23,0.75,0.0,0.3,0.75,0.0,0.0
Narcolepsy type 2,32306,10,4,25,3,22,22,2,20,0.75,0.5,0.12,0.75,0.09090909090909091,0.5
Scrub typhus,33542,5,7,16,4,12,24,3,21,0.5714285714285714,0.42857142857142855,0.25,0.5714285714285714,0.125,0.42857142857142855
Severe achondroplasia-developmental delay-acanthosis nigricans syndrome,28545,0,9,34,6,28,19,1,18,0.6666666666666666,0.1111111111111111,0.17647058823529413,0.6666666666666666,0.05263157894736842,0.1111111111111111
"Platyspondylic dysplasia, Torrance type",28113,0,15,19,6,13,9,0,9,0.4,0.0,0.3157894736842105,0.4,0.0,0.0
Hypomyelination-congenital cataract syndrome,29918,1,6,24,2,22,27,0,27,0.3333333333333333,0.0,0.08333333333333333,0.3333333333333333,0.0,0.0
Camptodactyly-tall stature-scoliosis-hearing loss syndrome,30270,2,4,17,4,13,24,3,21,1.0,0.75,0.23529411764705882,1.0,0.125,0.75
Palmoplantar keratoderma-XX sex reversal-predisposition to squamous cell carcinoma syndrome,31372,3,3,17,3,14,14,3,11,1.0,1.0,0.17647058823529413,1.0,0.21428571428571427,1.0
Facial onset sensory and motor neuronopathy,33480,10,7,22,7,15,39,8,31,1.0,1.1428571428571428,0.3181818181818182,1.0,0.20512820512820512,1.1428571428571428
Hinman syndrome,30947,1,0,26,0,26,15,0,15,0.0,0.0,0.0,0.0,0.0,0.0
Fibronectin glomerulopathy,32489,7,9,17,8,9,30,4,26,0.8888888888888888,0.4444444444444444,0.47058823529411764,0.8888888888888888,0.13333333333333333,0.4444444444444444
ALG8-CDG,31949,4,3,20,0,20,22,0,22,0.0,0.0,0.0,0.0,0.0,0.0
Congenital ichthyosiform erythroderma,31218,3,5,18,2,16,26,3,23,0.4,0.6,0.1111111111111111,0.4,0.11538461538461539,0.6
"Autosomal dominant generalized epidermolysis bullosa simplex, severe form",27434,4,6,28,5,23,32,3,29,0.8333333333333334,0.5,0.17857142857142858,0.8333333333333334,0.09375,0.5
Intermediate generalized junctional epidermolysis bullosa,27638,4,8,26,4,22,19,2,17,0.5,0.25,0.15384615384615385,0.5,0.10526315789473684,0.25
Junctional epidermolysis bullosa with pyloric atresia,28150,3,6,24,6,18,26,2,24,1.0,0.3333333333333333,0.25,1.0,0.07692307692307693,0.3333333333333333
Junctional epidermolysis bullosa inversa,27638,3,3,3,2,1,35,3,32,0.6666666666666666,1.0,0.6666666666666666,0.6666666666666666,0.08571428571428572,1.0
Epidermolysis bullosa simplex with mottled pigmentation,29359,2,6,20,7,13,17,2,15,1.1666666666666667,0.3333333333333333,0.35,1.1666666666666667,0.11764705882352941,0.3333333333333333
Localized epidermolysis bullosa simplex,27434,1,7,30,3,27,6,1,5,0.42857142857142855,0.14285714285714285,0.1,0.42857142857142855,0.16666666666666666,0.14285714285714285
PLEC-related intermediate epidermolysis bullosa simplex without extracutaneous involvement,29474,1,0,17,0,17,18,0,18,0.0,0.0,0.0,0.0,0.0,0.0
Hermansky-Pudlak syndrome,27618,1,7,21,4,17,23,0,23,0.5714285714285714,0.0,0.19047619047619047,0.5714285714285714,0.0,0.0
Oculocutaneous albinism type 1A,84278,16,8,35,6,29,30,4,26,0.75,0.5,0.17142857142857143,0.75,0.13333333333333333,0.5
Oculocutaneous albinism type 2,84278,5,0,24,0,24,24,0,24,0.0,0.0,0.0,0.0,0.0,0.0
Late-onset junctional epidermolysis bullosa,27639,4,0,15,0,15,16,0,16,0.0,0.0,0.0,0.0,0.0,0.0
Severe intellectual disability-epilepsy-anal anomalies-distal phalangeal hypoplasia,33467,5,8,19,6,13,31,1,30,0.75,0.125,0.3157894736842105,0.75,0.03225806451612903,0.125
Pituitary stalk interruption syndrome,32331,1,4,16,4,12,27,0,27,1.0,0.0,0.25,1.0,0.0,0.0
Angioma serpiginosum,30271,4,3,13,0,13,42,2,40,0.0,0.6666666666666666,0.0,0.0,0.047619047619047616,0.6666666666666666
Acquired arginine vasopressin deficiency,29832,0,3,16,0,16,22,1,21,0.0,0.3333333333333333,0.0,0.0,0.045454545454545456,0.3333333333333333
Isolated epispadias,32630,2,2,11,1,10,4,0,4,0.5,0.0,0.09090909090909091,0.5,0.0,0.0
Hamel cerebro-palato-cardiac syndrome,32624,0,14,19,13,6,18,0,18,0.9285714285714286,0.0,0.6842105263157895,0.9285714285714286,0.0,0.0
Bladder exstrophy,31847,1,7,17,3,14,17,0,17,0.42857142857142855,0.0,0.17647058823529413,0.42857142857142855,0.0,0.0
12q14 microdeletion syndrome,32466,1,8,18,2,16,33,2,31,0.25,0.25,0.1111111111111111,0.25,0.06060606060606061,0.25
"X-linked intellectual disability, Golabi-Ito-Hall type",32625,3,11,18,12,6,41,4,37,1.0909090909090908,0.36363636363636365,0.6666666666666666,1.0909090909090908,0.0975609756097561,0.36363636363636365
Deafness-infertility syndrome,28163,10,3,21,3,18,34,3,31,1.0,1.0,0.14285714285714285,1.0,0.08823529411764706,1.0
Syndactyly type 3,27398,2,1,20,2,18,31,1,30,2.0,1.0,0.1,2.0,0.03225806451612903,1.0
Syndactyly type 4,29488,1,3,18,0,18,25,0,25,0.0,0.0,0.0,0.0,0.0,0.0
Syndactyly type 5,27398,0,4,20,1,19,31,0,31,0.25,0.0,0.05,0.25,0.0,0.0
"Brachydactyly-syndactyly, Zhao type",29488,1,5,18,5,13,11,1,10,1.0,0.2,0.2777777777777778,1.0,0.09090909090909091,0.2
Hurler-Scheie syndrome,27894,2,12,16,9,7,18,4,14,0.75,0.3333333333333333,0.5625,0.75,0.2222222222222222,0.3333333333333333
Juvenile dermatomyositis,28745,2,15,18,4,14,31,5,26,0.26666666666666666,0.3333333333333333,0.2222222222222222,0.26666666666666666,0.16129032258064516,0.3333333333333333
Brachydactyly type E,29635,4,2,30,2,28,5,0,5,1.0,0.0,0.06666666666666667,1.0,0.0,0.0
Brachydactyly type A1,29635,0,5,10,1,9,12,3,9,0.2,0.6,0.1,0.2,0.25,0.6
Brachydactyly type A4,29488,2,3,16,2,14,15,0,15,0.6666666666666666,0.0,0.125,0.6666666666666666,0.0,0.0
Syndactyly type 1,38464,11,3,19,1,18,27,1,26,0.3333333333333333,0.3333333333333333,0.05263157894736842,0.3333333333333333,0.037037037037037035,0.3333333333333333
Syndactyly type 2,38464,6,2,35,0,35,20,0,20,0.0,0.0,0.0,0.0,0.0,0.0
"Spondyloepimetaphyseal dysplasia, Irapa type",38339,4,20,24,0,24,35,7,28,0.0,0.35,0.0,0.0,0.2,0.35
Autosomal dominant omodysplasia,28843,0,5,18,4,14,33,0,33,0.8,0.0,0.2222222222222222,0.8,0.0,0.0
"Spondylometaphyseal dysplasia, Sedaghatian type",38339,17,15,35,3,32,33,3,30,0.2,0.2,0.08571428571428572,0.2,0.09090909090909091,0.2
"Brachyolmia, Maroteaux type",29676,0,5,24,5,19,22,0,22,1.0,0.0,0.20833333333333334,1.0,0.0,0.0
Achondrogenesis type 1B,27350,1,19,30,11,19,39,1,38,0.5789473684210527,0.05263157894736842,0.36666666666666664,0.5789473684210527,0.02564102564102564,0.05263157894736842
Achondrogenesis type 1A,27350,2,18,32,9,23,33,0,33,0.5,0.0,0.28125,0.5,0.0,0.0
Autosomal dominant brachyolmia,38181,12,5,42,1,41,22,0,22,0.2,0.0,0.023809523809523808,0.2,0.0,0.0
Cloverleaf skull-multiple congenital anomalies syndrome,32998,1,19,17,12,5,35,2,33,0.631578947368421,0.10526315789473684,0.7058823529411765,0.631578947368421,0.05714285714285714,0.10526315789473684
"Short rib-polydactyly syndrome, Verma-Naumoff type",32996,1,12,39,10,29,34,1,33,0.8333333333333334,0.08333333333333333,0.2564102564102564,0.8333333333333334,0.029411764705882353,0.08333333333333333
Crouzon syndrome-acanthosis nigricans syndrome,31353,2,3,18,0,18,27,1,26,0.0,0.3333333333333333,0.0,0.0,0.037037037037037035,0.3333333333333333
Thanatophoric dysplasia type 2,30963,5,18,26,4,22,27,3,24,0.2222222222222222,0.16666666666666666,0.15384615384615385,0.2222222222222222,0.1111111111111111,0.16666666666666666
"Spondyloepiphyseal dysplasia, Kimberley type",31270,2,7,39,1,38,39,2,37,0.14285714285714285,0.2857142857142857,0.02564102564102564,0.14285714285714285,0.05128205128205128,0.2857142857142857
Fragile X-associated tremor/ataxia syndrome,30858,4,10,46,12,34,9,5,4,1.2,0.5,0.2608695652173913,1.2,0.5555555555555556,0.5
Hypocalcemic vitamin D-resistant rickets,38752,18,11,23,2,21,33,2,31,0.18181818181818182,0.18181818181818182,0.08695652173913043,0.18181818181818182,0.06060606060606061,0.18181818181818182
HNF1B-related autosomal dominant tubulointerstitial kidney disease,38907,18,2,26,2,24,30,2,28,1.0,1.0,0.07692307692307693,1.0,0.06666666666666667,1.0
Lyme disease,32950,4,0,17,0,17,20,0,20,0.0,0.0,0.0,0.0,0.0,0.0
Ichthyosis-hypotrichosis syndrome,39370,18,2,26,0,26,34,0,34,0.0,0.0,0.0,0.0,0.0,0.0
Cryoglobulinemic vasculitis,30342,4,10,22,5,17,20,4,16,0.5,0.4,0.22727272727272727,0.5,0.2,0.4
Otopalatodigital syndrome type 1,31500,3,14,111,13,98,29,3,26,0.9285714285714286,0.21428571428571427,0.11711711711711711,0.9285714285714286,0.10344827586206896,0.21428571428571427
Otopalatodigital syndrome type 2,31500,0,21,21,5,16,20,0,20,0.23809523809523808,0.0,0.23809523809523808,0.23809523809523808,0.0,0.0
Brittle cornea syndrome,95503,4,6,19,2,17,21,2,19,0.3333333333333333,0.3333333333333333,0.10526315789473684,0.3333333333333333,0.09523809523809523,0.3333333333333333
Blau syndrome,35826,8,13,37,2,35,28,0,28,0.15384615384615385,0.0,0.05405405405405406,0.15384615384615385,0.0,0.0
Xeroderma pigmentosum variant,31055,9,5,23,0,23,33,2,31,0.0,0.4,0.0,0.0,0.06060606060606061,0.4
Autosomal dominant cutis laxa,27841,2,6,23,6,17,33,2,31,1.0,0.3333333333333333,0.2608695652173913,1.0,0.06060606060606061,0.3333333333333333
Klippel-Trénaunay syndrome,98429,7,5,18,3,15,37,3,34,0.6,0.6,0.16666666666666666,0.6,0.08108108108108109,0.6
Mandibuloacral dysplasia with type B lipodystrophy,28779,0,11,47,11,36,26,0,26,1.0,0.0,0.23404255319148937,1.0,0.0,0.0
Mandibuloacral dysplasia with type A lipodystrophy,28779,1,14,42,14,28,37,1,36,1.0,0.07142857142857142,0.3333333333333333,1.0,0.02702702702702703,0.07142857142857142
Hereditary folate malabsorption,38628,20,12,31,3,28,30,3,27,0.25,0.25,0.0967741935483871,0.25,0.1,0.25
Primary familial polycythemia,38273,16,8,32,3,29,19,3,16,0.375,0.375,0.09375,0.375,0.15789473684210525,0.375
Drug-induced autoimmune hemolytic anemia,32885,5,6,18,6,12,21,2,19,1.0,0.3333333333333333,0.3333333333333333,1.0,0.09523809523809523,0.3333333333333333
Mixed-type autoimmune hemolytic anemia,32890,6,6,19,7,12,25,2,23,1.1666666666666667,0.3333333333333333,0.3684210526315789,1.1666666666666667,0.08,0.3333333333333333
Paroxysmal cold hemoglobinuria,27950,1,9,16,3,13,24,1,23,0.3333333333333333,0.1111111111111111,0.1875,0.3333333333333333,0.041666666666666664,0.1111111111111111
"Autoimmune hemolytic anemia, warm type",31723,5,6,17,3,14,25,2,23,0.5,0.3333333333333333,0.17647058823529413,0.5,0.08,0.3333333333333333
"Deafness with labyrinthine aplasia, microtia, and microdontia",30306,3,8,21,6,15,37,7,30,0.75,0.875,0.2857142857142857,0.75,0.1891891891891892,0.875
Primary immunodeficiency syndrome due to P14/LAMTOR2 deficiency,30023,1,7,21,7,14,16,0,16,1.0,0.0,0.3333333333333333,1.0,0.0,0.0
Erythema elevatum diutinum,32639,11,3,21,4,17,24,1,23,1.3333333333333333,0.3333333333333333,0.19047619047619047,1.3333333333333333,0.041666666666666664,0.3333333333333333
Autosomal dominant hypophosphatemic rickets,27800,3,2,21,2,19,30,1,29,1.0,0.5,0.09523809523809523,1.0,0.03333333333333333,0.5
Hypomyelination-hypogonadotropic hypogonadism-hypodontia syndrome,32806,12,4,30,4,26,22,1,21,1.0,0.25,0.13333333333333333,1.0,0.045454545454545456,0.25
Neurodegeneration due to 3-hydroxyisobutyryl-CoA hydrolase deficiency,29231,1,5,21,2,19,28,2,26,0.4,0.4,0.09523809523809523,0.4,0.07142857142857142,0.4
Ichthyosis-prematurity syndrome,32812,8,5,30,5,25,19,0,19,1.0,0.0,0.16666666666666666,1.0,0.0,0.0
Vacuolar myopathy with sarcoplasmic reticulum protein aggregates,30771,0,2,15,0,15,31,0,31,0.0,0.0,0.0,0.0,0.0,0.0
Sialidosis type 2,33195,0,19,33,8,25,5,0,5,0.42105263157894735,0.0,0.24242424242424243,0.42105263157894735,0.0,0.0
Keratosis palmaris et plantaris-clinodactyly syndrome,28701,8,2,19,1,18,15,0,15,0.5,0.0,0.05263157894736842,0.5,0.0,0.0
"Hereditary palmoplantar keratoderma, Gamborg-Nielsen type",28989,7,2,17,1,16,10,0,10,0.5,0.0,0.058823529411764705,0.5,0.0,0.0
"Palmoplantar keratoderma, Nagashima type",30262,5,2,9,0,9,6,0,6,0.0,0.0,0.0,0.0,0.0,0.0
Mesoaxial synostotic syndactyly with phalangeal reduction,31328,0,11,19,13,6,31,0,31,1.1818181818181819,0.0,0.6842105263157895,1.1818181818181819,0.0,0.0
SLC39A13-related spondylodysplastic Ehlers-Danlos syndrome,38339,20,8,32,1,31,37,2,35,0.125,0.25,0.03125,0.125,0.05405405405405406,0.25
Congenital muscular dystrophy due to LMNA mutation,31690,0,2,17,0,17,28,0,28,0.0,0.0,0.0,0.0,0.0,0.0
Generalized eruptive histiocytosis,27749,6,3,21,3,18,18,2,16,1.0,0.6666666666666666,0.14285714285714285,1.0,0.1111111111111111,0.6666666666666666
Benign cephalic histiocytosis,32952,0,3,12,2,10,20,0,20,0.6666666666666666,0.0,0.16666666666666666,0.6666666666666666,0.0,0.0
Juvenile xanthogranuloma,33509,3,0,22,0,22,42,0,42,0.0,0.0,0.0,0.0,0.0,0.0
Xanthoma disseminatum,33508,2,1,13,1,12,17,0,17,1.0,0.0,0.07692307692307693,1.0,0.0,0.0
Rosaï-Dorfman disease,33528,5,4,16,2,14,29,4,25,0.5,1.0,0.125,0.5,0.13793103448275862,1.0
Progressive nodular histiocytosis,33521,14,2,29,2,27,30,1,29,1.0,0.5,0.06896551724137931,1.0,0.03333333333333333,0.5
Hereditary progressive mucinous histiocytosis,27837,2,3,10,3,7,26,0,26,1.0,0.0,0.3,1.0,0.0,0.0
Segmental outgrowth-lipomatosis-arteriovenous malformation-epidermal nevus syndrome,32832,0,9,16,7,9,34,2,32,0.7777777777777778,0.2222222222222222,0.4375,0.7777777777777778,0.058823529411764705,0.2222222222222222
Arachnoiditis,28332,2,10,21,9,12,32,3,29,0.9,0.3,0.42857142857142855,0.9,0.09375,0.3
Drug reaction with eosinophilia and systemic symptoms,32742,2,12,21,8,13,21,5,16,0.6666666666666666,0.4166666666666667,0.38095238095238093,0.6666666666666666,0.23809523809523808,0.4166666666666667
X-linked intellectual disability-cerebellar hypoplasia syndrome,33433,4,3,55,3,52,25,2,23,1.0,0.6666666666666666,0.05454545454545454,1.0,0.08,0.6666666666666666
Carney triad,32735,3,8,17,5,12,25,1,24,0.625,0.125,0.29411764705882354,0.625,0.04,0.125
Encephalopathy due to prosaposin deficiency,29504,2,10,19,9,10,38,3,35,0.9,0.3,0.47368421052631576,0.9,0.07894736842105263,0.3
Microtia-eye coloboma-imperforation of the nasolacrimal duct syndrome,29526,18,2,29,2,27,23,1,22,1.0,0.5,0.06896551724137931,1.0,0.043478260869565216,0.5
Multicentric reticulohistiocytosis,32748,11,3,19,3,16,20,1,19,1.0,0.3333333333333333,0.15789473684210525,1.0,0.05,0.3333333333333333
17q11.2 microduplication syndrome,32869,1,0,19,0,19,25,0,25,0.0,0.0,0.0,0.0,0.0,0.0
Microphthalmia with brain and digit anomalies,31093,2,2,64,1,63,17,3,14,0.5,1.5,0.015625,0.5,0.17647058823529413,1.5
Syndactyly-telecanthus-anogenital and renal malformations syndrome,29630,1,5,36,5,31,32,0,32,1.0,0.0,0.1388888888888889,1.0,0.0,0.0
"ABeta amyloidosis, Dutch type",33133,1,6,16,6,10,31,0,31,1.0,0.0,0.375,1.0,0.0,0.0
ACys amyloidosis,31817,4,3,22,2,20,23,0,23,0.6666666666666666,0.0,0.09090909090909091,0.6666666666666666,0.0,0.0
Squamous cell carcinoma of the esophagus,96953,20,3,33,1,32,25,1,24,0.3333333333333333,0.3333333333333333,0.030303030303030304,0.3333333333333333,0.04,0.3333333333333333
Klatskin tumor,32542,7,3,17,3,14,19,1,18,1.0,0.3333333333333333,0.17647058823529413,1.0,0.05263157894736842,0.3333333333333333
Neurogenic thoracic outlet syndrome,33124,3,5,20,5,15,24,0,24,1.0,0.0,0.25,1.0,0.0,0.0
Bathing suit ichthyosis,27791,2,4,15,3,12,20,1,19,0.75,0.25,0.2,0.75,0.05,0.25
Familial hypofibrinogenemia,31856,7,4,20,1,19,21,3,18,0.25,0.75,0.05,0.25,0.14285714285714285,0.75
X-linked Charcot-Marie-Tooth disease type 4,27530,4,7,22,2,20,18,0,18,0.2857142857142857,0.0,0.09090909090909091,0.2857142857142857,0.0,0.0
X-linked Charcot-Marie-Tooth disease type 1,27530,3,6,26,1,25,18,1,17,0.16666666666666666,0.16666666666666666,0.038461538461538464,0.16666666666666666,0.05555555555555555,0.16666666666666666
Invasive mole,37906,12,2,27,0,27,31,0,31,0.0,0.0,0.0,0.0,0.0,0.0
Cushing syndrome due to ectopic ACTH secretion,32234,3,6,18,0,18,35,1,34,0.0,0.16666666666666666,0.0,0.0,0.02857142857142857,0.16666666666666666
Atypical teratoid rhabdoid tumor,33519,0,4,17,1,16,23,0,23,0.25,0.0,0.058823529411764705,0.25,0.0,0.0
O'Sullivan-McLeod syndrome,27695,3,4,17,4,13,28,0,28,1.0,0.0,0.23529411764705882,1.0,0.0,0.0
Placental site trophoblastic tumor,32514,7,4,26,3,23,18,0,18,0.75,0.0,0.11538461538461539,0.75,0.0,0.0
Hydatidiform mole,95138,15,6,29,3,26,35,3,32,0.5,0.5,0.10344827586206896,0.5,0.08571428571428572,0.5
Adenocarcinoma of the esophagus,32545,10,6,18,6,12,28,1,27,1.0,0.16666666666666666,0.3333333333333333,1.0,0.03571428571428571,0.16666666666666666
Well-differentiated liposarcoma,32546,6,1,21,1,20,30,0,30,1.0,0.0,0.047619047619047616,1.0,0.0,0.0
Pleomorphic liposarcoma,32555,10,2,23,2,21,26,0,26,1.0,0.0,0.08695652173913043,1.0,0.0,0.0
Myxoid/round cell liposarcoma,32553,8,1,20,1,19,27,0,27,1.0,0.0,0.05,1.0,0.0,0.0
Lassa fever,37859,18,6,25,1,24,27,1,26,0.16666666666666666,0.16666666666666666,0.04,0.16666666666666666,0.037037037037037035,0.16666666666666666
Nipah virus disease,32352,4,7,16,7,9,19,3,16,1.0,0.42857142857142855,0.4375,1.0,0.15789473684210525,0.42857142857142855
Haddad syndrome,28239,0,8,29,0,29,39,0,39,0.0,0.0,0.0,0.0,0.0,0.0
LIG4 syndrome,30146,0,6,17,1,16,23,0,23,0.16666666666666666,0.0,0.058823529411764705,0.16666666666666666,0.0,0.0
Thymic carcinoma,32257,7,2,18,2,16,22,0,22,1.0,0.0,0.1111111111111111,1.0,0.0,0.0
Dengue fever,95170,17,2,18,2,16,27,2,25,1.0,1.0,0.1111111111111111,1.0,0.07407407407407407,1.0
X-linked Charcot-Marie-Tooth disease type 5,30728,0,9,17,6,11,18,0,18,0.6666666666666666,0.0,0.35294117647058826,0.6666666666666666,0.0,0.0
Adult-onset foveomacular vitelliform dystrophy,32189,8,4,18,4,14,29,2,27,1.0,0.5,0.2222222222222222,1.0,0.06896551724137931,0.5
Spastic paraplegia type 2,30156,1,5,23,3,20,20,0,20,0.6,0.0,0.13043478260869565,0.6,0.0,0.0
Familial afibrinogenemia,32216,15,6,23,4,19,28,1,27,0.6666666666666666,0.16666666666666666,0.17391304347826086,0.6666666666666666,0.03571428571428571,0.16666666666666666
Familial dysfibrinogenemia,32216,18,4,26,6,20,29,3,26,1.5,0.75,0.23076923076923078,1.5,0.10344827586206896,0.75
Typhoid,33474,3,5,17,3,14,19,4,15,0.6,0.8,0.17647058823529413,0.6,0.21052631578947367,0.8
Mosaic trisomy 9 syndrome,33458,2,5,17,2,15,33,1,32,0.4,0.2,0.11764705882352941,0.4,0.030303030303030304,0.2
Pontiac fever,33473,14,3,17,3,14,16,3,13,1.0,1.0,0.17647058823529413,1.0,0.1875,1.0
Acetazolamide-responsive myotonia,33515,5,3,17,3,14,16,0,16,1.0,0.0,0.17647058823529413,1.0,0.0,0.0
Kienbock disease,32480,9,6,16,7,9,18,3,15,1.1666666666666667,0.5,0.4375,1.1666666666666667,0.16666666666666666,0.5
Bohring-Opitz syndrome,31594,5,2,78,3,75,25,1,24,1.5,0.5,0.038461538461538464,1.5,0.04,0.5
Thoracic outlet syndrome,98466,12,1,27,0,27,23,1,22,0.0,1.0,0.0,0.0,0.043478260869565216,1.0
Riboflavin transporter deficiency,32236,1,4,21,3,18,30,0,30,0.75,0.0,0.14285714285714285,0.75,0.0,0.0
Carney-Stratakis syndrome,28724,6,2,19,1,18,25,0,25,0.5,0.0,0.05263157894736842,0.5,0.0,0.0
Alpha-thalassemia-intellectual disability syndrome linked to chromosome 16,27529,2,5,17,1,16,32,2,30,0.2,0.4,0.058823529411764705,0.2,0.0625,0.4
Thyroid hypoplasia,32888,3,12,20,11,9,28,5,23,0.9166666666666666,0.4166666666666667,0.55,0.9166666666666666,0.17857142857142858,0.4166666666666667
Thyroid hemiagenesis,32898,1,15,20,11,9,8,1,7,0.7333333333333333,0.06666666666666667,0.55,0.7333333333333333,0.125,0.06666666666666667
Athyreosis,32897,2,14,15,11,4,21,3,18,0.7857142857142857,0.21428571428571427,0.7333333333333333,0.7857142857142857,0.14285714285714285,0.21428571428571427
Thyroid ectopia,32901,3,16,15,11,4,21,5,16,0.6875,0.3125,0.7333333333333333,0.6875,0.23809523809523808,0.3125
"48,XXXY syndrome",32804,5,7,45,6,39,39,2,37,0.8571428571428571,0.2857142857142857,0.13333333333333333,0.8571428571428571,0.05128205128205128,0.2857142857142857
Koolen-De Vries syndrome,32595,3,20,99,15,84,37,4,33,0.75,0.2,0.15151515151515152,0.75,0.10810810810810811,0.2
Recombinant 8 syndrome,30425,0,14,17,5,12,19,0,19,0.35714285714285715,0.0,0.29411764705882354,0.35714285714285715,0.0,0.0
Distal deletion 19p syndrome,39043,13,23,27,2,25,35,3,32,0.08695652173913043,0.13043478260869565,0.07407407407407407,0.08695652173913043,0.08571428571428572,0.13043478260869565
Distal deletion 6p syndrome,30573,3,6,54,4,50,33,1,32,0.6666666666666666,0.16666666666666666,0.07407407407407407,0.6666666666666666,0.030303030303030304,0.16666666666666666
Mosaic trisomy 8 syndrome,32491,2,1,17,0,17,24,0,24,0.0,0.0,0.0,0.0,0.0,0.0
20p12.3 microdeletion syndrome,39278,19,2,29,0,29,21,0,21,0.0,0.0,0.0,0.0,0.0,0.0
Paternal 20q13.2q13.3 microdeletion syndrome,32465,4,22,19,5,14,27,2,25,0.22727272727272727,0.09090909090909091,0.2631578947368421,0.22727272727272727,0.07407407407407407,0.09090909090909091
Trisomy 20p syndrome,39312,18,17,30,2,28,36,3,33,0.11764705882352941,0.17647058823529413,0.06666666666666667,0.11764705882352941,0.08333333333333333,0.17647058823529413
Distal 22q11.2 microdeletion syndrome,30708,4,7,17,2,15,39,3,36,0.2857142857142857,0.42857142857142855,0.11764705882352941,0.2857142857142857,0.07692307692307693,0.42857142857142855
Distal 22q11.2 microduplication syndrome,32995,1,0,17,0,17,27,0,27,0.0,0.0,0.0,0.0,0.0,0.0
Trisomy 1q syndrome,32991,1,3,35,3,32,28,0,28,1.0,0.0,0.08571428571428572,1.0,0.0,0.0
2p15p16.1 microdeletion syndrome,39278,13,18,29,1,28,29,0,29,0.05555555555555555,0.0,0.034482758620689655,0.05555555555555555,0.0,0.0
16p11.2p12.2 microdeletion syndrome,33186,3,7,17,0,17,31,0,31,0.0,0.0,0.0,0.0,0.0,0.0
16p13.11 microdeletion syndrome,33186,3,4,16,1,15,33,1,32,0.25,0.25,0.0625,0.25,0.030303030303030304,0.25
16p13.11 microduplication syndrome,33180,3,0,18,0,18,32,0,32,0.0,0.0,0.0,0.0,0.0,0.0
16q24.3 microdeletion syndrome,32429,5,3,105,1,104,26,0,26,0.3333333333333333,0.0,0.009523809523809525,0.3333333333333333,0.0,0.0
17q12 microdeletion syndrome,32429,5,1,102,0,102,33,0,33,0.0,0.0,0.0,0.0,0.0,0.0
17q12 microduplication syndrome,32869,1,0,19,0,19,33,0,33,0.0,0.0,0.0,0.0,0.0,0.0
17q23.1q23.2 microdeletion syndrome,32429,4,5,100,2,98,24,1,23,0.4,0.2,0.02,0.4,0.041666666666666664,0.2
Trisomy 17p syndrome,33149,4,9,17,5,12,29,4,25,0.5555555555555556,0.4444444444444444,0.29411764705882354,0.5555555555555556,0.13793103448275862,0.4444444444444444
Distal 7q11.23 microduplication syndrome,33336,10,3,19,1,18,28,1,27,0.3333333333333333,0.3333333333333333,0.05263157894736842,0.3333333333333333,0.03571428571428571,0.3333333333333333
Iatrogenic botulism,32473,8,10,20,7,13,27,2,25,0.7,0.2,0.35,0.7,0.07407407407407407,0.2
14q11.2 microdeletion syndrome,32466,1,9,22,0,22,27,0,27,0.0,0.0,0.0,0.0,0.0,0.0
Monosomy 9p syndrome,31535,4,23,66,22,44,38,2,36,0.9565217391304348,0.08695652173913043,0.3333333333333333,0.9565217391304348,0.05263157894736842,0.08695652173913043
Cleft palate-congenital heart defect-intellectual disability syndrome due to 15q14 microdeletion,28633,3,5,17,5,12,21,3,18,1.0,0.6,0.29411764705882354,1.0,0.14285714285714285,0.6
FOXG1 syndrome due to 14q12 microdeletion,39034,19,15,27,2,25,30,2,28,0.13333333333333333,0.13333333333333333,0.07407407407407407,0.13333333333333333,0.06666666666666667,0.13333333333333333
16p11.2p12.2 microduplication syndrome,33199,11,1,17,0,17,23,0,23,0.0,0.0,0.0,0.0,0.0,0.0
8p11.2 deletion syndrome,33099,2,11,25,8,17,30,2,28,0.7272727272727273,0.18181818181818182,0.32,0.7272727272727273,0.06666666666666667,0.18181818181818182
6q25.2q25.3 microdeletion syndrome,32429,5,4,99,1,98,24,0,24,0.25,0.0,0.010101010101010102,0.25,0.0,0.0
8p23.1 duplication syndrome,33096,6,0,21,0,21,34,0,34,0.0,0.0,0.0,0.0,0.0,0.0
8p23.1 microdeletion syndrome,33094,2,3,45,3,42,21,0,21,1.0,0.0,0.06666666666666667,1.0,0.0,0.0
19p13.12 microdeletion syndrome,32429,5,2,101,2,99,25,1,24,1.0,0.5,0.019801980198019802,1.0,0.04,0.5
"46,XY partial gonadal dysgenesis",38781,17,31,21,7,14,32,8,24,0.22580645161290322,0.25806451612903225,0.3333333333333333,0.22580645161290322,0.25,0.25806451612903225
Inhalational botulism,32484,6,10,19,9,10,31,3,28,0.9,0.3,0.47368421052631576,0.9,0.0967741935483871,0.3
Distal 7q11.23 microdeletion syndrome,32429,3,0,99,0,99,28,0,28,0.0,0.0,0.0,0.0,0.0,0.0
Mendelian susceptibility to mycobacterial diseases due to partial IRF8 deficiency,30105,6,3,22,4,18,29,2,27,1.3333333333333333,0.6666666666666666,0.18181818181818182,1.3333333333333333,0.06896551724137931,0.6666666666666666
ABetaL34V amyloidosis,33159,2,8,16,6,10,28,0,28,0.75,0.0,0.375,0.75,0.0,0.0
Ebola hemorrhagic fever,32858,3,5,16,0,16,19,2,17,0.0,0.4,0.0,0.0,0.10526315789473684,0.4
"ABeta amyloidosis, Arctic type",33133,0,2,16,0,16,17,0,17,0.0,0.0,0.0,0.0,0.0,0.0
Chronic nonbacterial osteomyelitis/Chronic recurrent multifocal osteomyelitis,29265,3,3,19,1,18,21,1,20,0.3333333333333333,0.3333333333333333,0.05263157894736842,0.3333333333333333,0.047619047619047616,0.3333333333333333
"ABeta amyloidosis, Iowa type",33133,1,9,16,6,10,23,1,22,0.6666666666666666,0.1111111111111111,0.375,0.6666666666666666,0.043478260869565216,0.1111111111111111
"ABeta amyloidosis, Italian type",33133,1,3,17,2,15,16,0,16,0.6666666666666666,0.0,0.11764705882352941,0.6666666666666666,0.0,0.0
Vitamin B12-unresponsive methylmalonic acidemia type mut0,27479,0,4,19,2,17,20,0,20,0.5,0.0,0.10526315789473684,0.5,0.0,0.0
Infantile-onset ascending hereditary spastic paralysis,28074,2,9,17,5,12,27,1,26,0.5555555555555556,0.1111111111111111,0.29411764705882354,0.5555555555555556,0.037037037037037035,0.1111111111111111
Lujo hemorrhagic fever,32850,4,10,17,4,13,23,4,19,0.4,0.4,0.23529411764705882,0.4,0.17391304347826086,0.4
Acral self-healing collodion baby,33143,3,6,21,6,15,16,2,14,1.0,0.3333333333333333,0.2857142857142857,1.0,0.125,0.3333333333333333
Syndromic recessive X-linked ichthyosis,29420,1,3,17,1,16,18,2,16,0.3333333333333333,0.6666666666666666,0.058823529411764705,0.3333333333333333,0.1111111111111111,0.6666666666666666
Pseudoxanthomatous diffuse cutaneous mastocytosis,33261,4,2,11,1,10,16,0,16,0.5,0.0,0.09090909090909091,0.5,0.0,0.0
8q21.11 microdeletion syndrome,32429,6,11,100,5,95,24,3,21,0.45454545454545453,0.2727272727272727,0.05,0.45454545454545453,0.125,0.2727272727272727
Keratosis linearis-ichthyosis congenita-sclerosing keratoderma syndrome,29644,10,2,22,3,19,26,1,25,1.5,0.5,0.13636363636363635,1.5,0.038461538461538464,0.5
10q22.3q23.3 microdeletion syndrome,32429,2,4,16,0,16,26,2,24,0.0,0.5,0.0,0.0,0.07692307692307693,0.5
L1 syndrome,33504,1,12,21,11,10,14,0,14,0.9166666666666666,0.0,0.5238095238095238,0.9166666666666666,0.0,0.0
Mycophenolate mofetil embryopathy,33285,0,3,20,3,17,15,0,15,1.0,0.0,0.15,1.0,0.0,0.0
14q22q23 microdeletion syndrome,32429,2,19,16,2,14,25,2,23,0.10526315789473684,0.10526315789473684,0.125,0.10526315789473684,0.08,0.10526315789473684
Bullous diffuse cutaneous mastocytosis,32208,2,6,14,4,10,19,2,17,0.6666666666666666,0.3333333333333333,0.2857142857142857,0.6666666666666666,0.10526315789473684,0.3333333333333333
Spasmus nutans,33399,6,3,22,3,19,32,2,30,1.0,0.6666666666666666,0.13636363636363635,1.0,0.0625,0.6666666666666666
Symptomatic form of Coffin-Lowry syndrome in female carriers,33213,2,2,18,2,16,34,0,34,1.0,0.0,0.1111111111111111,1.0,0.0,0.0
10q22.3q23.3 microduplication syndrome,32869,1,1,19,0,19,30,0,30,0.0,0.0,0.0,0.0,0.0,0.0
"48,XYYY syndrome",32804,3,31,45,9,36,17,1,16,0.2903225806451613,0.03225806451612903,0.2,0.2903225806451613,0.058823529411764705,0.03225806451612903
Leydig cell hypoplasia,98776,14,20,28,3,25,25,4,21,0.15,0.2,0.10714285714285714,0.15,0.16,0.2
Familial thoracic aortic aneurysm and aortic dissection,32443,1,3,18,2,16,23,0,23,0.6666666666666666,0.0,0.1111111111111111,0.6666666666666666,0.0,0.0
Non-functioning pituitary adenoma,31063,12,1,27,1,26,30,0,30,1.0,0.0,0.037037037037037035,1.0,0.0,0.0
Ring chromosome Y syndrome,32722,0,6,16,7,9,20,0,20,1.1666666666666667,0.0,0.4375,1.1666666666666667,0.0,0.0
Wolfram-like syndrome,31066,2,7,16,4,12,29,1,28,0.5714285714285714,0.14285714285714285,0.25,0.5714285714285714,0.034482758620689655,0.14285714285714285
Müllerian aplasia and hyperandrogenism,27165,4,10,23,8,15,17,3,14,0.8,0.3,0.34782608695652173,0.8,0.17647058823529413,0.3
"46,XY gonadal dysgenesis-motor and sensory neuropathy syndrome",30775,1,23,17,14,3,27,1,26,0.6086956521739131,0.043478260869565216,0.8235294117647058,0.6086956521739131,0.037037037037037035,0.043478260869565216
Penile agenesis,32342,2,18,27,13,14,16,0,16,0.7222222222222222,0.0,0.48148148148148145,0.7222222222222222,0.0,0.0
"46,XY ovotesticular difference of sex development",39476,17,14,40,2,38,40,2,38,0.14285714285714285,0.14285714285714285,0.05,0.14285714285714285,0.05,0.14285714285714285
"46,XY difference of sex development due to isolated 17,20-lyase deficiency",32410,3,24,18,15,3,29,8,21,0.625,0.3333333333333333,0.8333333333333334,0.625,0.27586206896551724,0.3333333333333333
Diethylstilbestrol syndrome,33132,1,15,16,14,2,23,1,22,0.9333333333333333,0.06666666666666667,0.875,0.9333333333333333,0.043478260869565216,0.06666666666666667
Testicular agenesis,99886,17,7,21,0,21,31,1,30,0.0,0.14285714285714285,0.0,0.0,0.03225806451612903,0.14285714285714285
Hypokalemic periodic paralysis,27428,2,8,17,9,8,22,1,21,1.125,0.125,0.5294117647058824,1.125,0.045454545454545456,0.125
STAT1-related autoimmune enteropathy and endocrinopathy-susceptibility to chronic infections syndrome,27745,1,7,17,6,11,26,0,26,0.8571428571428571,0.0,0.35294117647058826,0.8571428571428571,0.0,0.0
Normosmic congenital hypogonadotropic hypogonadism,28407,7,21,43,19,24,20,3,17,0.9047619047619048,0.14285714285714285,0.4418604651162791,0.9047619047619048,0.15,0.14285714285714285
Thyroid lymphoma,32265,5,3,17,2,15,29,0,29,0.6666666666666666,0.0,0.11764705882352941,0.6666666666666666,0.0,0.0
Parathyroid carcinoma,38953,6,7,6,0,6,22,2,20,0.0,0.2857142857142857,0.0,0.0,0.09090909090909091,0.2857142857142857
Medullary thyroid carcinoma,32909,8,3,18,1,17,21,0,21,0.3333333333333333,0.0,0.05555555555555555,0.3333333333333333,0.0,0.0
Anaplastic thyroid carcinoma,30749,5,5,19,0,19,33,1,32,0.0,0.2,0.0,0.0,0.030303030303030304,0.2
Pituitary carcinoma,96147,10,7,20,1,19,20,1,19,0.14285714285714285,0.14285714285714285,0.05,0.14285714285714285,0.05,0.14285714285714285
Aorta coarctation,27670,0,2,17,2,15,19,0,19,1.0,0.0,0.11764705882352941,1.0,0.0,0.0
Familial hypocalciuric hypercalcemia,27830,5,4,26,3,23,25,1,24,0.75,0.25,0.11538461538461539,0.75,0.04,0.25
Oral submucous fibrosis,32191,9,4,23,4,19,24,1,23,1.0,0.25,0.17391304347826086,1.0,0.041666666666666664,0.25
Attenuated Chédiak-Higashi syndrome,33060,1,11,16,10,6,20,1,19,0.9090909090909091,0.09090909090909091,0.625,0.9090909090909091,0.05,0.09090909090909091
Neonatal Marfan syndrome,38220,11,30,31,4,27,33,5,28,0.13333333333333333,0.16666666666666666,0.12903225806451613,0.13333333333333333,0.15151515151515152,0.16666666666666666
Xp22.13p22.2 duplication syndrome,33039,2,24,17,10,7,19,3,16,0.4166666666666667,0.125,0.5882352941176471,0.4166666666666667,0.15789473684210525,0.125
6q terminal deletion syndrome,32311,1,23,43,22,21,35,2,33,0.9565217391304348,0.08695652173913043,0.5116279069767442,0.9565217391304348,0.05714285714285714,0.08695652173913043
Xp21 deletion syndrome,32830,2,15,17,11,6,21,3,18,0.7333333333333333,0.2,0.6470588235294118,0.7333333333333333,0.14285714285714285,0.2
Atypical Werner syndrome,32590,3,72,75,65,10,21,6,15,0.9027777777777778,0.08333333333333333,0.8666666666666667,0.9027777777777778,0.2857142857142857,0.08333333333333333
8p inverted duplication/deletion syndrome,39341,15,18,25,2,23,27,2,25,0.1111111111111111,0.1111111111111111,0.08,0.1111111111111111,0.07407407407407407,0.1111111111111111
Tetragametic chimerism syndrome,27635,2,16,16,16,0,35,2,33,1.0,0.125,1.0,1.0,0.05714285714285714,0.125
1q41q42 microdeletion syndrome,32429,5,9,99,7,92,24,4,20,0.7777777777777778,0.4444444444444444,0.0707070707070707,0.7777777777777778,0.16666666666666666,0.4444444444444444
Hypogonadotropic hypogonadism-severe microcephaly-sensorineural hearing loss-dysmorphism syndrome,33082,2,35,38,28,10,18,5,13,0.8,0.14285714285714285,0.7368421052631579,0.8,0.2777777777777778,0.14285714285714285
Chromosome Y microdeletion syndrome,33259,3,4,17,5,12,31,1,30,1.25,0.25,0.29411764705882354,1.25,0.03225806451612903,0.25
Xq12-q13.3 duplication syndrome,32931,3,35,17,13,4,28,5,23,0.37142857142857144,0.14285714285714285,0.7647058823529411,0.37142857142857144,0.17857142857142858,0.14285714285714285
"46,XY difference of sex development-adrenal insufficiency due to CYP11A1 deficiency",28226,2,44,19,16,3,35,8,27,0.36363636363636365,0.18181818181818182,0.8421052631578947,0.36363636363636365,0.22857142857142856,0.18181818181818182
Inherited isolated adrenal insufficiency due to partial CYP11A1 deficiency,32584,2,44,30,27,3,27,7,20,0.6136363636363636,0.1590909090909091,0.9,0.6136363636363636,0.25925925925925924,0.1590909090909091
Congenital adrenal hyperplasia due to 3-beta-hydroxysteroid dehydrogenase deficiency,31078,6,1,57,1,56,28,0,28,1.0,0.0,0.017543859649122806,1.0,0.0,0.0
H syndrome,30947,0,6,24,0,24,21,0,21,0.0,0.0,0.0,0.0,0.0,0.0
Male infertility with azoospermia or oligozoospermia due to single gene mutation,32388,11,6,20,8,12,22,3,19,1.3333333333333333,0.5,0.4,1.3333333333333333,0.13636363636363635,0.5
Isochromosomy Yq syndrome,32655,1,4,19,4,15,35,0,35,1.0,0.0,0.21052631578947367,1.0,0.0,0.0
Isochromosomy Yp syndrome,39578,18,4,41,0,41,40,1,39,0.0,0.25,0.0,0.0,0.025,0.25
Maternal uniparental disomy of chromosome X syndrome,39314,15,23,27,3,24,32,4,28,0.13043478260869565,0.17391304347826086,0.1111111111111111,0.13043478260869565,0.125,0.17391304347826086
"47,XYY syndrome",38781,26,5,60,3,57,43,3,40,0.6,0.6,0.05,0.6,0.06976744186046512,0.6
"45,X/46,XY mixed gonadal dysgenesis",33553,5,4,31,2,29,35,2,33,0.5,0.5,0.06451612903225806,0.5,0.05714285714285714,0.5
"X-linked intellectual disability, Van Esch type",27603,2,17,116,3,113,31,2,29,0.17647058823529413,0.11764705882352941,0.02586206896551724,0.17647058823529413,0.06451612903225806,0.11764705882352941
"X-linked intellectual disability, Cilliers type",32718,2,20,17,13,4,30,1,29,0.65,0.05,0.7647058823529411,0.65,0.03333333333333333,0.05
TSH-secreting pituitary adenoma,32906,4,5,21,0,21,22,0,22,0.0,0.0,0.0,0.0,0.0,0.0
Prolactinoma,28409,16,14,27,10,17,30,7,23,0.7142857142857143,0.5,0.37037037037037035,0.7142857142857143,0.23333333333333334,0.5
"Multiple epiphyseal dysplasia, Lowry type",32128,4,18,18,3,15,32,3,29,0.16666666666666666,0.16666666666666666,0.16666666666666666,0.16666666666666666,0.09375,0.16666666666666666
Autosomal dominant otospondylomegaepiphyseal dysplasia,38104,6,5,30,1,29,26,1,25,0.2,0.2,0.03333333333333333,0.2,0.038461538461538464,0.2
Multiple epiphyseal dysplasia-macrocephaly-facial dysmorphism syndrome,31724,1,15,17,5,12,36,2,34,0.3333333333333333,0.13333333333333333,0.29411764705882354,0.3333333333333333,0.05555555555555555,0.13333333333333333
Wormian bone-multiple fractures-dentinogenesis imperfecta-skeletal dysplasia,28264,2,2,19,0,19,26,1,25,0.0,0.5,0.0,0.0,0.038461538461538464,0.5
"Spondylometaphyseal dysplasia, A4 type",38339,11,5,26,0,26,43,1,42,0.0,0.2,0.0,0.0,0.023255813953488372,0.2
Malignant peritoneal mesothelioma,32612,10,5,19,5,14,26,4,22,1.0,0.8,0.2631578947368421,1.0,0.15384615384615385,0.8
"Familial scaphocephaly syndrome, McGillivray type",31231,2,3,18,2,16,20,0,20,0.6666666666666666,0.0,0.1111111111111111,0.6666666666666666,0.0,0.0
Primary peritoneal carcinoma,37975,22,6,23,4,19,26,5,21,0.6666666666666666,0.8333333333333334,0.17391304347826086,0.6666666666666666,0.19230769230769232,0.8333333333333334
Peritoneal inclusion cyst,37937,7,5,8,2,6,20,2,18,0.4,0.4,0.25,0.4,0.1,0.4
Sea-blue histiocytosis,29651,2,10,16,9,7,20,2,18,0.9,0.2,0.5625,0.9,0.1,0.2
"Localized dystrophic epidermolysis bullosa, nails only",27640,4,3,20,5,15,20,4,16,1.6666666666666667,1.3333333333333333,0.25,1.6666666666666667,0.2,1.3333333333333333
Lethal acantholytic erosive disorder,30194,7,0,29,0,29,27,0,27,0.0,0.0,0.0,0.0,0.0,0.0
Hb Bart's hydrops fetalis,33272,12,5,23,4,19,27,2,25,0.8,0.4,0.17391304347826086,0.8,0.07407407407407407,0.4
Maffucci syndrome,29322,1,4,18,3,15,22,0,22,0.75,0.0,0.16666666666666666,0.75,0.0,0.0
Hypotonia-cystinuria syndrome,38935,14,10,22,0,22,29,1,28,0.0,0.1,0.0,0.0,0.034482758620689655,0.1
2p21 microdeletion syndrome,39278,15,14,31,2,29,28,2,26,0.14285714285714285,0.14285714285714285,0.06451612903225806,0.14285714285714285,0.07142857142857142,0.14285714285714285
Febrile infection-related epilepsy syndrome,33026,9,4,21,4,17,23,2,21,1.0,0.5,0.19047619047619047,1.0,0.08695652173913043,0.5
Peripheral demyelinating neuropathy-central dysmyelinating leukodystrophy-Waardenburg syndrome-Hirschsprung disease,31030,2,16,32,13,19,25,4,21,0.8125,0.25,0.40625,0.8125,0.16,0.25
"X-linked intellectual disability, Najm type",28944,3,5,24,0,24,28,0,28,0.0,0.0,0.0,0.0,0.0,0.0
"X-linked dominant chondrodysplasia, Chassaing-Lacombe type",30983,2,14,22,9,13,33,1,32,0.6428571428571429,0.07142857142857142,0.4090909090909091,0.6428571428571429,0.030303030303030304,0.07142857142857142
Adult intestinal botulism,32290,8,6,18,4,14,26,3,23,0.6666666666666666,0.5,0.2222222222222222,0.6666666666666666,0.11538461538461539,0.5
Intestinal botulism,32290,7,7,15,6,9,24,2,22,0.8571428571428571,0.2857142857142857,0.4,0.8571428571428571,0.08333333333333333,0.2857142857142857
Infantile LAD-like disease due to RAC2 deficiency,31219,8,4,26,0,26,24,0,24,0.0,0.0,0.0,0.0,0.0,0.0
15q13.3 microdeletion syndrome,32429,2,0,16,0,16,19,0,19,0.0,0.0,0.0,0.0,0.0,0.0
Ledderhose disease,32471,0,3,21,3,18,12,0,12,1.0,0.0,0.14285714285714285,1.0,0.0,0.0
19q13.11 microdeletion syndrome,32429,6,11,102,5,97,29,4,25,0.45454545454545453,0.36363636363636365,0.049019607843137254,0.45454545454545453,0.13793103448275862,0.36363636363636365
17q21.31 microduplication syndrome,32869,1,4,19,2,17,30,1,29,0.5,0.25,0.10526315789473684,0.5,0.03333333333333333,0.25
Congenital alveolar capillary dysplasia,32012,2,2,18,2,16,34,2,32,1.0,1.0,0.1111111111111111,1.0,0.058823529411764705,1.0
Adult polyglucosan body disease,32026,5,10,30,1,29,35,3,32,0.1,0.3,0.03333333333333333,0.1,0.08571428571428572,0.3
Combined immunodeficiency due to CRAC channel dysfunction,33069,3,16,16,12,4,25,2,23,0.75,0.125,0.75,0.75,0.08,0.125
Severe combined immunodeficiency due to FOXN1 deficiency,27595,8,5,20,1,19,32,0,32,0.2,0.0,0.05,0.2,0.0,0.0
CLAPO syndrome,27679,0,6,17,7,10,9,0,9,1.1666666666666667,0.0,0.4117647058823529,1.1666666666666667,0.0,0.0
6q16 microdeletion syndrome,32429,5,4,103,3,100,35,2,33,0.75,0.5,0.02912621359223301,0.75,0.05714285714285714,0.5
Good syndrome,32839,1,3,15,2,13,23,0,23,0.6666666666666666,0.0,0.13333333333333333,0.6666666666666666,0.0,0.0
Cutis laxa-Marfanoid syndrome,31499,5,7,22,7,15,34,1,33,1.0,0.14285714285714285,0.3181818181818182,1.0,0.029411764705882353,0.14285714285714285
8q22.1 microdeletion syndrome,32429,4,17,102,3,99,25,0,25,0.17647058823529413,0.0,0.029411764705882353,0.17647058823529413,0.0,0.0
Craniosynostosis-hydrocephalus-Arnold-Chiari malformation type I-radioulnar synostosis syndrome,32286,5,28,17,11,6,24,4,20,0.39285714285714285,0.14285714285714285,0.6470588235294118,0.39285714285714285,0.16666666666666666,0.14285714285714285
Arginine vasopressin deficiency,29832,1,7,16,0,16,23,3,20,0.0,0.42857142857142855,0.0,0.0,0.13043478260869565,0.42857142857142855
Wound botulism,32283,3,10,18,7,11,24,2,22,0.7,0.2,0.3888888888888889,0.7,0.08333333333333333,0.2
Infant botulism,32284,1,17,17,8,9,20,2,18,0.47058823529411764,0.11764705882352941,0.47058823529411764,0.47058823529411764,0.1,0.11764705882352941
Osteosclerosis-developmental delay-craniosynostosis syndrome,32488,1,8,15,7,8,20,0,20,0.875,0.0,0.4666666666666667,0.875,0.0,0.0
5q14.3 microdeletion syndrome,32429,4,7,100,6,94,28,2,26,0.8571428571428571,0.2857142857142857,0.06,0.8571428571428571,0.07142857142857142,0.2857142857142857
Foodborne botulism,32228,5,14,16,11,5,28,6,22,0.7857142857142857,0.42857142857142855,0.6875,0.7857142857142857,0.21428571428571427,0.42857142857142855
Autosomal dominant striatal neurodegeneration,27342,4,5,17,5,12,25,2,23,1.0,0.4,0.29411764705882354,1.0,0.08,0.4
Hughes-Stovin syndrome,32663,4,11,17,10,7,25,2,23,0.9090909090909091,0.18181818181818182,0.5882352941176471,0.9090909090909091,0.08,0.18181818181818182
5q35 microduplication syndrome,33496,11,5,22,5,17,33,4,29,1.0,0.8,0.22727272727272727,1.0,0.12121212121212122,0.8
Cardiac anomalies-short stature-joint hypermobility-facial dysmorphism syndrome,28531,2,4,18,1,17,35,2,33,0.25,0.5,0.05555555555555555,0.25,0.05714285714285714,0.5
Toxin-mediated infectious botulism,33347,13,7,20,6,14,20,3,17,0.8571428571428571,0.42857142857142855,0.3,0.8571428571428571,0.15,0.42857142857142855
Isolated agammaglobulinemia,27170,2,13,19,6,13,29,4,25,0.46153846153846156,0.3076923076923077,0.3157894736842105,0.46153846153846156,0.13793103448275862,0.3076923076923077
Ptosis-upper ocular movement limitation-absence of lacrimal punctum syndrome,32212,0,12,16,11,5,23,2,21,0.9166666666666666,0.16666666666666666,0.6875,0.9166666666666666,0.08695652173913043,0.16666666666666666
Frontonasal dysplasia-alopecia-genital anomalies syndrome,30695,1,19,20,7,13,26,1,25,0.3684210526315789,0.05263157894736842,0.35,0.3684210526315789,0.038461538461538464,0.05263157894736842
2q23.1 microdeletion syndrome,32429,5,4,99,3,96,24,0,24,0.75,0.0,0.030303030303030304,0.75,0.0,0.0
8q12 microduplication syndrome,32869,1,6,19,1,18,25,1,24,0.16666666666666666,0.16666666666666666,0.05263157894736842,0.16666666666666666,0.04,0.16666666666666666
Diffuse cutaneous systemic sclerosis,32398,3,7,18,4,14,13,0,13,0.5714285714285714,0.0,0.2222222222222222,0.5714285714285714,0.0,0.0
17p13.3 microduplication syndrome,33180,3,8,18,1,17,30,1,29,0.125,0.125,0.05555555555555555,0.125,0.03333333333333333,0.125
Combined immunodeficiency due to DOCK8 deficiency,29937,3,15,22,11,11,29,2,27,0.7333333333333333,0.13333333333333333,0.5,0.7333333333333333,0.06896551724137931,0.13333333333333333
Xeroderma pigmentosum-Cockayne syndrome complex,32596,2,21,19,13,6,32,3,29,0.6190476190476191,0.14285714285714285,0.6842105263157895,0.6190476190476191,0.09375,0.14285714285714285
Juvenile primary lateral sclerosis,28624,12,9,19,6,13,31,2,29,0.6666666666666666,0.2222222222222222,0.3157894736842105,0.6666666666666666,0.06451612903225806,0.2222222222222222
1q44 microdeletion syndrome,29659,3,8,17,0,17,28,2,26,0.0,0.25,0.0,0.0,0.07142857142857142,0.25
4q21 microdeletion syndrome,32429,5,6,104,5,99,34,3,31,0.8333333333333334,0.5,0.04807692307692308,0.8333333333333334,0.08823529411764706,0.5
Primary orthostatic tremor,36976,14,5,14,2,12,16,2,14,0.4,0.4,0.14285714285714285,0.4,0.125,0.4
Familial clubfoot due to 17q23.1q23.2 microduplication,29529,7,1,16,2,14,14,2,12,2.0,2.0,0.125,2.0,0.14285714285714285,2.0
Hypohidrotic ectodermal dysplasia,32453,2,11,20,1,19,25,1,24,0.09090909090909091,0.09090909090909091,0.05,0.09090909090909091,0.04,0.09090909090909091
15q11q13 microduplication syndrome,32869,1,6,18,2,16,23,2,21,0.3333333333333333,0.3333333333333333,0.1111111111111111,0.3333333333333333,0.08695652173913043,0.3333333333333333
Microcornea-posterior megalolenticonus-persistent fetal vasculature-coloboma syndrome,32668,9,4,20,4,16,23,1,22,1.0,0.25,0.2,1.0,0.043478260869565216,0.25
6p22 microdeletion syndrome,33109,2,3,20,2,18,28,1,27,0.6666666666666666,0.3333333333333333,0.1,0.6666666666666666,0.03571428571428571,0.3333333333333333
3q29 microduplication syndrome,31466,3,0,20,0,20,31,0,31,0.0,0.0,0.0,0.0,0.0,0.0
2q32q33 microdeletion syndrome,32429,6,4,100,2,98,28,2,26,0.5,0.5,0.02,0.5,0.07142857142857142,0.5
2q31.1 microdeletion syndrome,32429,6,2,99,2,97,23,1,22,1.0,0.5,0.020202020202020204,1.0,0.043478260869565216,0.5
1q21.1 microduplication syndrome,32869,1,2,19,2,17,25,1,24,1.0,0.5,0.10526315789473684,1.0,0.04,0.5
1q21.1 microdeletion syndrome,32429,4,0,99,0,99,30,0,30,0.0,0.0,0.0,0.0,0.0,0.0
Autosomal recessive Stickler syndrome,32565,11,5,24,3,21,33,1,32,0.6,0.2,0.125,0.6,0.030303030303030304,0.2
Isolated aniridia,32592,15,7,22,3,19,32,2,30,0.42857142857142855,0.2857142857142857,0.13636363636363635,0.42857142857142855,0.0625,0.2857142857142857
Dominant beta-thalassemia,33437,2,2,17,0,17,30,0,30,0.0,0.0,0.0,0.0,0.0,0.0
Usher syndrome type 3,27268,3,9,17,0,17,23,1,22,0.0,0.1111111111111111,0.0,0.0,0.043478260869565216,0.1111111111111111
Beta-thalassemia major,33437,2,8,17,1,16,28,0,28,0.125,0.0,0.058823529411764705,0.125,0.0,0.0
Usher syndrome type 1,27268,4,12,17,2,15,28,2,26,0.16666666666666666,0.16666666666666666,0.11764705882352941,0.16666666666666666,0.07142857142857142,0.16666666666666666
Usher syndrome type 2,27268,5,8,17,0,17,37,0,37,0.0,0.0,0.0,0.0,0.0,0.0
Classical-like Ehlers-Danlos syndrome type 1,28078,1,1,17,0,17,24,0,24,0.0,0.0,0.0,0.0,0.0,0.0
Combined immunodeficiency due to partial RAG1 deficiency,33548,6,7,20,5,15,17,1,16,0.7142857142857143,0.14285714285714285,0.25,0.7142857142857143,0.058823529411764705,0.14285714285714285
Non-acquired combined pituitary hormone deficiency-sensorineural hearing loss-spine abnormalities syndrome,27919,1,9,18,9,9,26,0,26,1.0,0.0,0.5,1.0,0.0,0.0
Beta-thalassemia-X-linked thrombocytopenia syndrome,31589,5,6,16,7,9,20,5,15,1.1666666666666667,0.8333333333333334,0.4375,1.1666666666666667,0.25,0.8333333333333334
Alpha-thalassemia-myelodysplastic syndrome,28428,6,5,22,4,18,19,1,18,0.8,0.2,0.18181818181818182,0.8,0.05263157894736842,0.2
Hemoglobin C-beta-thalassemia syndrome,33422,7,4,23,4,19,22,2,20,1.0,0.5,0.17391304347826086,1.0,0.09090909090909091,0.5
Hemoglobin E-beta-thalassemia syndrome,33424,13,3,25,4,21,28,2,26,1.3333333333333333,0.6666666666666666,0.16,1.3333333333333333,0.07142857142857142,0.6666666666666666
Delta-beta-thalassemia,33418,5,3,32,3,29,27,1,26,1.0,0.3333333333333333,0.09375,1.0,0.037037037037037035,0.3333333333333333
Persistent placoid maculopathy,32470,5,3,20,4,16,30,2,28,1.3333333333333333,0.6666666666666666,0.2,1.3333333333333333,0.06666666666666667,0.6666666666666666
Dermotrichic syndrome,33320,0,15,20,12,8,26,0,26,0.8,0.0,0.6,0.8,0.0,0.0
Ravine syndrome,32332,1,10,14,11,3,27,0,27,1.1,0.0,0.7857142857142857,1.1,0.0,0.0
Familial gestational hyperthyroidism,27661,3,9,21,6,15,16,2,14,0.6666666666666666,0.2222222222222222,0.2857142857142857,0.6666666666666666,0.125,0.2222222222222222
Symptomatic form of HFE-related hemochromatosis,28176,4,4,18,0,18,32,0,32,0.0,0.0,0.0,0.0,0.0,0.0
IRVAN syndrome,32496,0,0,19,0,19,38,0,38,0.0,0.0,0.0,0.0,0.0,0.0
Zebra body myopathy,32218,1,21,16,15,1,22,2,20,0.7142857142857143,0.09523809523809523,0.9375,0.7142857142857143,0.09090909090909091,0.09523809523809523
Interstitial granulomatous dermatitis with arthritis,33197,8,6,21,5,16,28,2,26,0.8333333333333334,0.3333333333333333,0.23809523809523808,0.8333333333333334,0.07142857142857142,0.3333333333333333
Kidney tubulopathy-dilated cardiomyopathy syndrome,32335,0,6,17,5,12,19,0,19,0.8333333333333334,0.0,0.29411764705882354,0.8333333333333334,0.0,0.0
Familial isolated hypoparathyroidism due to agenesis of parathyroid gland,31288,5,6,18,6,12,30,0,30,1.0,0.0,0.3333333333333333,1.0,0.0,0.0
Familial hyperthyroidism due to mutations in TSH receptor,27204,4,9,16,7,9,31,4,27,0.7777777777777778,0.4444444444444444,0.4375,0.7777777777777778,0.12903225806451613,0.4444444444444444
PLIN1-related familial partial lipodystrophy,27788,0,12,19,1,18,9,0,9,0.08333333333333333,0.0,0.05263157894736842,0.08333333333333333,0.0,0.0
Idiopathic localized lipodystrophy,33043,2,2,15,2,13,29,0,29,1.0,0.0,0.13333333333333333,1.0,0.0,0.0
Drug-induced localized lipodystrophy,33049,7,2,23,2,21,28,0,28,1.0,0.0,0.08695652173913043,1.0,0.0,0.0
Sagliker syndrome,32644,0,4,21,4,17,24,0,24,1.0,0.0,0.19047619047619047,1.0,0.0,0.0
Cono-spondylar dysplasia,33540,0,4,21,3,18,19,0,19,0.75,0.0,0.14285714285714285,0.75,0.0,0.0
Aneurysm of sinus of Valsalva,33011,6,1,19,1,18,26,0,26,1.0,0.0,0.05263157894736842,1.0,0.0,0.0
Bazex syndrome,32801,0,7,17,6,11,24,0,24,0.8571428571428571,0.0,0.35294117647058826,0.8571428571428571,0.0,0.0
Tetrasomy 5p syndrome,39338,20,21,31,0,31,26,0,26,0.0,0.0,0.0,0.0,0.0,0.0
Autoimmune hemolytic anemia-autoimmune thrombocytopenia-primary immunodeficiency syndrome due to TPP2 deficiency,32994,6,10,24,7,17,29,2,27,0.7,0.2,0.2916666666666667,0.7,0.06896551724137931,0.2
Lichen planus pemphigoides,32627,5,4,21,4,17,24,1,23,1.0,0.25,0.19047619047619047,1.0,0.041666666666666664,0.25
Monosomy 18q syndrome,32686,1,0,44,0,44,29,0,29,0.0,0.0,0.0,0.0,0.0,0.0
Pineoblastoma,96482,12,2,23,1,22,20,1,19,0.5,0.5,0.043478260869565216,0.5,0.05,0.5
Madras motor neuron disease,32310,4,2,17,1,16,17,0,17,0.5,0.0,0.058823529411764705,0.5,0.0,0.0
Ganglioneuroma,33013,1,1,16,1,15,29,0,29,1.0,0.0,0.0625,1.0,0.0,0.0
Perioral myoclonia with absences,32756,3,6,21,5,16,29,0,29,0.8333333333333334,0.0,0.23809523809523808,0.8333333333333334,0.0,0.0
Elastoderma,32459,12,4,20,4,16,28,1,27,1.0,0.25,0.2,1.0,0.03571428571428571,0.25
Cap polyposis,32576,12,5,16,4,12,24,2,22,0.8,0.4,0.25,0.8,0.08333333333333333,0.4
Congenital panfollicular nevus,27712,7,3,18,2,16,15,1,14,0.6666666666666666,0.3333333333333333,0.1111111111111111,0.6666666666666666,0.06666666666666667,0.3333333333333333
Linear atrophoderma of Moulin,27786,8,1,21,0,21,43,0,43,0.0,0.0,0.0,0.0,0.0,0.0
Microcephalic primordial dwarfism-insulin resistance syndrome,33102,2,7,20,6,14,24,0,24,0.8571428571428571,0.0,0.3,0.8571428571428571,0.0,0.0
Pseudoxanthoma elasticum-like skin manifestations with retinitis pigmentosa,33256,6,10,20,10,10,34,1,33,1.0,0.1,0.5,1.0,0.029411764705882353,0.1
Chylomicron retention disease,30905,1,6,17,2,15,20,1,19,0.3333333333333333,0.16666666666666666,0.11764705882352941,0.3333333333333333,0.05,0.16666666666666666
Idiopathic hypercalciuria,29700,6,2,14,1,13,22,1,21,0.5,0.5,0.07142857142857142,0.5,0.045454545454545456,0.5
Intrauterine growth restriction-short stature-early adult-onset diabetes syndrome,33086,19,3,24,3,21,27,1,26,1.0,0.3333333333333333,0.125,1.0,0.037037037037037035,0.3333333333333333
Hyperlipidemia due to hepatic triacylglycerol lipase deficiency,31492,6,3,20,3,17,33,1,32,1.0,0.3333333333333333,0.15,1.0,0.030303030303030304,0.3333333333333333
Contractures-developmental delay-Pierre Robin syndrome,32988,3,2,18,2,16,29,0,29,1.0,0.0,0.1111111111111111,1.0,0.0,0.0
HIDEA syndrome,28693,4,8,27,1,26,28,2,26,0.125,0.25,0.037037037037037035,0.125,0.07142857142857142,0.25
20q11.2 microdeletion syndrome,32429,3,4,100,1,99,30,0,30,0.25,0.0,0.01,0.25,0.0,0.0
Distal deletion 1q syndrome,32517,1,15,20,14,6,28,1,27,0.9333333333333333,0.06666666666666667,0.7,0.9333333333333333,0.03571428571428571,0.06666666666666667
11q22.2q22.3 microdeletion syndrome,32429,2,0,18,0,18,31,0,31,0.0,0.0,0.0,0.0,0.0,0.0
Steroid-responsive encephalopathy associated with autoimmune thyroiditis,27715,3,3,18,1,17,30,0,30,0.3333333333333333,0.0,0.05555555555555555,0.3333333333333333,0.0,0.0
Isolated sedoheptulokinase deficiency,31189,0,3,16,1,15,31,0,31,0.3333333333333333,0.0,0.0625,0.3333333333333333,0.0,0.0
AApoAIV amyloidosis,33159,5,2,20,0,20,23,0,23,0.0,0.0,0.0,0.0,0.0,0.0
Autosomal dominant myopia-midfacial retrusion-sensorineural hearing loss-rhizomelic dysplasia syndrome,33282,2,6,17,6,11,31,2,29,1.0,0.3333333333333333,0.35294117647058826,1.0,0.06451612903225806,0.3333333333333333
Evans syndrome,29415,8,4,23,1,22,22,3,19,0.25,0.75,0.043478260869565216,0.25,0.13636363636363635,0.75
Immune thrombocytopenia,83934,19,1,23,0,23,25,0,25,0.0,0.0,0.0,0.0,0.0,0.0
Primary biliary cholangitis,31144,2,6,19,2,17,24,0,24,0.3333333333333333,0.0,0.10526315789473684,0.3333333333333333,0.0,0.0
Atopic keratoconjunctivitis,32918,3,4,16,1,15,26,1,25,0.25,0.25,0.0625,0.25,0.038461538461538464,0.25
Myasthenia gravis,31650,2,1,25,2,23,23,1,22,2.0,1.0,0.08,2.0,0.043478260869565216,1.0
CAMOS syndrome,32309,0,9,15,8,7,18,0,18,0.8888888888888888,0.0,0.5333333333333333,0.8888888888888888,0.0,0.0
X-linked microcephaly-growth retardation-prognathism-cryptorchidism syndrome,32378,0,9,18,5,13,10,2,8,0.5555555555555556,0.2222222222222222,0.2777777777777778,0.5555555555555556,0.2,0.2222222222222222
COG2-CDG,32379,0,0,18,0,18,15,0,15,0.0,0.0,0.0,0.0,0.0,0.0
Short stature-advanced bone age-early-onset osteoarthritis syndrome,33539,11,0,19,0,19,31,0,31,0.0,0.0,0.0,0.0,0.0,0.0
3p25.3 microdeletion syndrome,33211,2,1,42,1,41,30,1,29,1.0,1.0,0.023809523809523808,1.0,0.03333333333333333,1.0
Stargardt disease,27913,1,13,17,11,6,19,2,17,0.8461538461538461,0.15384615384615385,0.6470588235294118,0.8461538461538461,0.10526315789473684,0.15384615384615385
Estrogen resistance syndrome,27750,1,14,16,12,4,38,1,37,0.8571428571428571,0.07142857142857142,0.75,0.8571428571428571,0.02631578947368421,0.07142857142857142
Primary hypergonadotropic hypogonadism-partial alopecia syndrome,28245,3,27,39,26,13,25,4,21,0.9629629629629629,0.14814814814814814,0.6666666666666666,0.9629629629629629,0.16,0.14814814814814814
Keppen-Lubinsky syndrome,28280,1,9,34,6,28,20,2,18,0.6666666666666666,0.2222222222222222,0.17647058823529413,0.6666666666666666,0.1,0.2222222222222222
Stiff person spectrum disorder,98549,6,5,20,0,20,25,1,24,0.0,0.2,0.0,0.0,0.04,0.2
Progressive supranuclear palsy,27828,5,9,27,3,24,27,1,26,0.3333333333333333,0.1111111111111111,0.1111111111111111,0.3333333333333333,0.037037037037037035,0.1111111111111111
Laminin subunit alpha 2-related congenital muscular dystrophy,31690,2,16,28,3,25,22,3,19,0.1875,0.1875,0.10714285714285714,0.1875,0.13636363636363635,0.1875
Leber hereditary optic neuropathy,30612,4,2,17,1,16,26,0,26,0.5,0.0,0.058823529411764705,0.5,0.0,0.0
Aromatase deficiency,28433,2,20,16,10,6,27,2,25,0.5,0.1,0.625,0.5,0.07407407407407407,0.1
Familial median cleft of the upper and lower lips,30845,3,10,15,10,5,28,2,26,1.0,0.2,0.6666666666666666,1.0,0.07142857142857142,0.2
Lissencephaly type 3-metacarpal bone dysplasia syndrome,29795,0,23,18,14,4,26,1,25,0.6086956521739131,0.043478260869565216,0.7777777777777778,0.6086956521739131,0.038461538461538464,0.043478260869565216
MEDNIK syndrome,30928,0,5,19,4,15,19,0,19,0.8,0.0,0.21052631578947367,0.8,0.0,0.0
Postorgasmic illness syndrome,35879,13,2,32,1,31,17,1,16,0.5,0.5,0.03125,0.5,0.058823529411764705,0.5
Muscular hypertrophy-hepatomegaly-polyhydramnios syndrome,32632,2,8,17,6,11,14,0,14,0.75,0.0,0.35294117647058826,0.75,0.0,0.0
Ketamine-induced biliary dilatation,32921,11,4,26,6,20,21,3,18,1.5,0.75,0.23076923076923078,1.5,0.14285714285714285,0.75
7p22.1 microduplication syndrome,32377,10,11,27,9,18,32,4,28,0.8181818181818182,0.36363636363636365,0.3333333333333333,0.8181818181818182,0.125,0.36363636363636365
Autosomal recessive frontotemporal pachygyria,31852,4,7,22,7,15,24,0,24,1.0,0.0,0.3181818181818182,1.0,0.0,0.0
Woodhouse-Sakati syndrome,32075,1,29,17,13,4,16,1,15,0.4482758620689655,0.034482758620689655,0.7647058823529411,0.4482758620689655,0.0625,0.034482758620689655
Mitochondrial DNA-related cardiomyopathy and hearing loss,30794,11,7,29,4,25,33,4,29,0.5714285714285714,0.5714285714285714,0.13793103448275862,0.5714285714285714,0.12121212121212122,0.5714285714285714
Birdshot chorioretinopathy,31512,4,8,24,8,16,21,1,20,1.0,0.125,0.3333333333333333,1.0,0.047619047619047616,0.125
Generalized eruptive keratoacanthoma,33339,2,0,23,0,23,15,0,15,0.0,0.0,0.0,0.0,0.0,0.0
Multiple myeloma,30494,2,2,20,1,19,27,0,27,0.5,0.0,0.05,0.5,0.0,0.0
Congenital megacalycosis,32922,3,1,17,1,16,17,1,16,1.0,1.0,0.058823529411764705,1.0,0.058823529411764705,1.0
Herpes simplex virus stromal keratitis,32880,6,4,20,5,15,20,1,19,1.25,0.25,0.25,1.25,0.05,0.25
Transaldolase deficiency,30351,0,6,20,4,16,34,0,34,0.6666666666666666,0.0,0.2,0.6666666666666666,0.0,0.0
Congenital hypothyroidism due to maternal intake of antithyroid drugs,27711,1,5,20,1,19,42,1,41,0.2,0.2,0.05,0.2,0.023809523809523808,0.2
LIPE-related familial partial lipodystrophy,30508,0,18,19,11,8,14,0,14,0.6111111111111112,0.0,0.5789473684210527,0.6111111111111112,0.0,0.0
CIDEC-related familial partial lipodystrophy,30508,1,15,18,8,10,25,1,24,0.5333333333333333,0.06666666666666667,0.4444444444444444,0.5333333333333333,0.04,0.06666666666666667
"Short stature, Brussels type",29294,3,3,16,5,11,30,3,27,1.6666666666666667,1.0,0.3125,1.6666666666666667,0.1,1.0
Neovascular glaucoma,33472,4,4,15,3,12,16,1,15,0.75,0.25,0.2,0.75,0.0625,0.25
Familial multinodular goiter,30539,12,1,20,1,19,30,1,29,1.0,1.0,0.05,1.0,0.03333333333333333,1.0
Developmental and speech delay due to SOX5 deficiency,32780,3,4,29,4,25,31,3,28,1.0,0.75,0.13793103448275862,1.0,0.0967741935483871,0.75
Idiopathic pulmonary arterial hypertension,27688,6,6,16,6,10,20,3,17,1.0,0.5,0.375,1.0,0.15,0.5
Eiken syndrome,27233,1,3,17,2,15,28,1,27,0.6666666666666666,0.3333333333333333,0.11764705882352941,0.6666666666666666,0.03571428571428571,0.3333333333333333
Combined hamartoma of the retina and retinal pigment epithelium,32683,12,2,23,2,21,33,0,33,1.0,0.0,0.08695652173913043,1.0,0.0,0.0
Familial anetoderma,32454,5,1,21,1,20,22,0,22,1.0,0.0,0.047619047619047616,1.0,0.0,0.0
Leukoencephalopathy with bilateral anterior temporal lobe cysts,32765,5,6,19,6,13,23,0,23,1.0,0.0,0.3157894736842105,1.0,0.0,0.0
Infantile digital fibromatosis,32463,4,1,16,1,15,23,0,23,1.0,0.0,0.0625,1.0,0.0,0.0
Cardiomyopathy-hypotonia-lactic acidosis syndrome,29195,4,6,19,6,13,18,2,16,1.0,0.3333333333333333,0.3157894736842105,1.0,0.1111111111111111,0.3333333333333333
DEND syndrome,27812,1,2,18,2,16,35,0,35,1.0,0.0,0.1111111111111111,1.0,0.0,0.0
GNE myopathy,27807,2,7,35,8,27,21,0,21,1.1428571428571428,0.0,0.22857142857142856,1.1428571428571428,0.0,0.0
Autosomal recessive spastic paraplegia type 57,27668,4,14,22,4,18,36,2,34,0.2857142857142857,0.14285714285714285,0.18181818181818182,0.2857142857142857,0.05555555555555555,0.14285714285714285
Burkitt lymphoma,30075,1,0,16,0,16,21,0,21,0.0,0.0,0.0,0.0,0.0,0.0
PPARG-related familial partial lipodystrophy,27788,0,10,18,5,13,9,0,9,0.5,0.0,0.2777777777777778,0.5,0.0,0.0
Infantile nephropathic cystinosis,27421,1,22,19,4,15,13,2,11,0.18181818181818182,0.09090909090909091,0.21052631578947367,0.18181818181818182,0.15384615384615385,0.09090909090909091
RIN2 syndrome,29596,1,16,20,9,11,32,0,32,0.5625,0.0,0.45,0.5625,0.0,0.0
Pseudoprogeria syndrome,28486,1,20,19,17,2,32,3,29,0.85,0.15,0.8947368421052632,0.85,0.09375,0.15
Osteosarcoma,31481,3,2,14,2,12,19,0,19,1.0,0.0,0.14285714285714285,1.0,0.0,0.0
Insulin autoimmune syndrome,33029,5,6,23,5,18,24,0,24,0.8333333333333334,0.0,0.21739130434782608,0.8333333333333334,0.0,0.0
Acrocephalopolydactyly,28752,1,19,19,5,14,29,1,28,0.2631578947368421,0.05263157894736842,0.2631578947368421,0.2631578947368421,0.034482758620689655,0.05263157894736842
AKT2-related familial partial lipodystrophy,33204,1,9,26,8,18,12,1,11,0.8888888888888888,0.1111111111111111,0.3076923076923077,0.8888888888888888,0.08333333333333333,0.1111111111111111
Atypical juvenile parkinsonism,32974,3,8,16,3,13,22,4,18,0.375,0.5,0.1875,0.375,0.18181818181818182,0.5
Friedreich ataxia,30072,2,7,18,2,16,9,1,8,0.2857142857142857,0.14285714285714285,0.1111111111111111,0.2857142857142857,0.1111111111111111,0.14285714285714285
3MC syndrome,28191,0,6,37,3,34,10,0,10,0.5,0.0,0.08108108108108109,0.5,0.0,0.0
Gonadoblastoma,38782,6,3,15,2,13,25,1,24,0.6666666666666666,0.3333333333333333,0.13333333333333333,0.6666666666666666,0.04,0.3333333333333333
Distal 16p11.2 microdeletion syndrome,33190,1,11,17,9,8,28,0,28,0.8181818181818182,0.0,0.5294117647058824,0.8181818181818182,0.0,0.0
Paternal uniparental disomy of chromosome X syndrome,39314,22,16,35,3,32,36,3,33,0.1875,0.1875,0.08571428571428572,0.1875,0.08333333333333333,0.1875
FGFR2-related bent bone dysplasia,28410,0,24,18,12,6,23,0,23,0.5,0.0,0.6666666666666666,0.5,0.0,0.0
Familial isolated hyperparathyroidism,32242,8,12,20,8,12,20,3,17,0.6666666666666666,0.25,0.4,0.6666666666666666,0.15,0.25
AL amyloidosis,30929,14,1,32,1,31,28,1,27,1.0,1.0,0.03125,1.0,0.03571428571428571,1.0
Wild type ATTR amyloidosis,33505,3,9,16,6,10,29,0,29,0.6666666666666666,0.0,0.375,0.6666666666666666,0.0,0.0
Congenital hyperinsulinism due to HNF4A deficiency,32482,4,21,19,8,11,36,2,34,0.38095238095238093,0.09523809523809523,0.42105263157894735,0.38095238095238093,0.05555555555555555,0.09523809523809523
15q overgrowth syndrome,33237,2,30,16,10,6,40,4,36,0.3333333333333333,0.13333333333333333,0.625,0.3333333333333333,0.1,0.13333333333333333
Insulin-resistance syndrome type B,33489,4,14,49,14,35,31,4,27,1.0,0.2857142857142857,0.2857142857142857,1.0,0.12903225806451613,0.2857142857142857
Pituitary gigantism,33518,2,16,17,16,1,34,2,32,1.0,0.125,0.9411764705882353,1.0,0.058823529411764705,0.125
Transient neonatal diabetes mellitus,27653,3,5,25,3,22,20,2,18,0.6,0.4,0.12,0.6,0.1,0.4
Overgrowth-macrocephaly-facial dysmorphism syndrome,32695,1,11,18,8,10,7,2,5,0.7272727272727273,0.18181818181818182,0.4444444444444444,0.7272727272727273,0.2857142857142857,0.18181818181818182
Male infertility with teratozoospermia due to single gene mutation,32368,7,8,22,9,13,18,2,16,1.125,0.25,0.4090909090909091,1.125,0.1111111111111111,0.25
Acanthosis nigricans-insulin resistance-muscle cramps-acral enlargement syndrome,28821,3,8,23,5,18,11,1,10,0.625,0.125,0.21739130434782608,0.625,0.09090909090909091,0.125
Rapid-onset childhood obesity-hypothalamic dysfunction-hypoventilation-autonomic dysregulation syndrome,27767,2,29,29,16,13,17,1,16,0.5517241379310345,0.034482758620689655,0.5517241379310345,0.5517241379310345,0.058823529411764705,0.034482758620689655
Isolated permanent neonatal diabetes mellitus,27653,2,8,16,7,9,29,1,28,0.875,0.125,0.4375,0.875,0.034482758620689655,0.125
Growth delay due to insulin-like growth factor type 1 deficiency,30465,2,20,17,6,11,22,2,20,0.3,0.1,0.35294117647058826,0.3,0.09090909090909091,0.1
Familial hyperprolactinemia,28375,6,2,22,1,21,28,2,26,0.5,1.0,0.045454545454545456,0.5,0.07142857142857142,1.0
Lysosomal acid lipase deficiency,28518,1,19,31,13,18,25,2,23,0.6842105263157895,0.10526315789473684,0.41935483870967744,0.6842105263157895,0.08,0.10526315789473684
Duplication of the pituitary gland,33268,1,33,23,22,1,40,2,38,0.6666666666666666,0.06060606060606061,0.9565217391304348,0.6666666666666666,0.05,0.06060606060606061
Ovarian hyperstimulation syndrome,29924,3,10,16,8,8,23,2,21,0.8,0.2,0.5,0.8,0.08695652173913043,0.2
Ovarian fibroma,33050,1,5,13,4,9,27,1,26,0.8,0.2,0.3076923076923077,0.8,0.037037037037037035,0.2
Ovarian fibrothecoma,33050,5,6,13,5,8,34,4,30,0.8333333333333334,0.6666666666666666,0.38461538461538464,0.8333333333333334,0.11764705882352941,0.6666666666666666
Cataract-growth hormone deficiency-sensory neuropathy-sensorineural hearing loss-skeletal dysplasia syndrome,30859,3,24,18,6,12,25,5,20,0.25,0.20833333333333334,0.3333333333333333,0.25,0.2,0.20833333333333334
Intellectual disability-seizures-macrocephaly-obesity syndrome,32266,6,33,24,15,9,31,5,26,0.45454545454545453,0.15151515151515152,0.625,0.45454545454545453,0.16129032258064516,0.15151515151515152
1p21.3 microdeletion syndrome,39278,16,10,31,2,29,30,2,28,0.2,0.2,0.06451612903225806,0.2,0.06666666666666667,0.2
Trisomy 18p syndrome,33439,1,17,24,12,12,27,0,27,0.7058823529411765,0.0,0.5,0.7058823529411765,0.0,0.0
Developmental delay-language impairment-dopa responsive dystonia-parkinsonism syndrome due to 2q24 microdeletion,33271,1,19,19,13,6,23,0,23,0.6842105263157895,0.0,0.6842105263157895,0.6842105263157895,0.0,0.0
Distal Xq28 microduplication syndrome,33059,3,38,39,31,8,29,4,25,0.8157894736842105,0.10526315789473684,0.7948717948717948,0.8157894736842105,0.13793103448275862,0.10526315789473684
Benign schwannoma,27820,2,7,22,6,16,26,0,26,0.8571428571428571,0.0,0.2727272727272727,0.8571428571428571,0.0,0.0
SHOX-related short stature,31845,1,15,15,14,1,29,4,25,0.9333333333333333,0.26666666666666666,0.9333333333333333,0.9333333333333333,0.13793103448275862,0.26666666666666666
X small rings syndrome,32871,0,29,18,13,5,22,3,19,0.4482758620689655,0.10344827586206896,0.7222222222222222,0.4482758620689655,0.13636363636363635,0.10344827586206896
Intellectual disability-obesity-brain malformations-facial dysmorphism syndrome,32754,5,26,24,20,4,38,4,34,0.7692307692307693,0.15384615384615385,0.8333333333333334,0.7692307692307693,0.10526315789473684,0.15384615384615385
Autosomal dominant hyperinsulinism due to Kir6.2 deficiency,98643,19,6,30,2,28,32,0,32,0.3333333333333333,0.0,0.06666666666666667,0.3333333333333333,0.0,0.0
Autosomal dominant hyperinsulinism due to SUR1 deficiency,98642,16,7,30,2,28,25,0,25,0.2857142857142857,0.0,0.06666666666666667,0.2857142857142857,0.0,0.0
Familial multiple lipomatosis,30054,1,3,18,2,16,29,0,29,0.6666666666666666,0.0,0.1111111111111111,0.6666666666666666,0.0,0.0
Deafness-hypogonadism syndrome,32269,1,11,16,12,4,24,1,23,1.0909090909090908,0.09090909090909091,0.75,1.0909090909090908,0.041666666666666664,0.09090909090909091
Chondroectodermal dysplasia with night blindness,32782,3,27,16,15,1,27,2,25,0.5555555555555556,0.07407407407407407,0.9375,0.5555555555555556,0.07407407407407407,0.07407407407407407
Short stature due to primary acid-labile subunit deficiency,31056,4,4,19,5,14,30,3,27,1.25,0.75,0.2631578947368421,1.25,0.1,0.75
Insulinoma,32272,4,11,27,9,18,19,1,18,0.8181818181818182,0.09090909090909091,0.3333333333333333,0.8181818181818182,0.05263157894736842,0.09090909090909091
Progressive non-fluent aphasia,27776,0,9,18,5,13,6,2,4,0.5555555555555556,0.2222222222222222,0.2777777777777778,0.5555555555555556,0.3333333333333333,0.2222222222222222
LMNA-related cardiocutaneous progeria syndrome,33408,8,27,30,9,21,34,1,33,0.3333333333333333,0.037037037037037035,0.3,0.3333333333333333,0.029411764705882353,0.037037037037037035
Behavioral variant of frontotemporal dementia,32688,3,25,32,18,14,28,6,22,0.72,0.24,0.5625,0.72,0.21428571428571427,0.24
Hyperinsulinism due to UCP2 deficiency,33032,1,7,17,1,16,30,2,28,0.14285714285714285,0.2857142857142857,0.058823529411764705,0.14285714285714285,0.06666666666666667,0.2857142857142857
Non-insulinoma pancreatogenous hypoglycemia syndrome,33196,3,14,17,13,4,25,3,22,0.9285714285714286,0.21428571428571427,0.7647058823529411,0.9285714285714286,0.12,0.21428571428571427
Severe early-onset obesity-insulin resistance syndrome due to SH2B1 deficiency,27694,8,5,24,5,19,28,2,26,1.0,0.4,0.20833333333333334,1.0,0.07142857142857142,0.4
Hyperinsulinism due to HNF1A deficiency,32795,2,6,16,1,15,31,0,31,0.16666666666666666,0.0,0.0625,0.16666666666666666,0.0,0.0
Congenital bilateral absence of vas deferens,32340,12,3,25,3,22,26,0,26,1.0,0.0,0.12,1.0,0.0,0.0
Obesity due to SIM1 deficiency,27826,2,9,23,10,13,45,2,43,1.1111111111111112,0.2222222222222222,0.43478260869565216,1.1111111111111112,0.044444444444444446,0.2222222222222222
Dysbetalipoproteinemia,31925,5,5,18,1,17,24,3,21,0.2,0.6,0.05555555555555555,0.2,0.125,0.6
Familial hyperaldosteronism type II,27723,5,3,18,1,17,30,2,28,0.3333333333333333,0.6666666666666666,0.05555555555555555,0.3333333333333333,0.06666666666666667,0.6666666666666666
Genetic transient congenital hypothyroidism,38624,11,0,33,0,33,36,0,36,0.0,0.0,0.0,0.0,0.0,0.0
Pancreatic colipase deficiency,27784,14,5,20,5,15,33,3,30,1.0,0.6,0.25,1.0,0.09090909090909091,0.6
Hypercholesterolemia due to cholesterol 7alpha-hydroxylase deficiency,32526,5,9,18,10,8,25,3,22,1.1111111111111112,0.3333333333333333,0.5555555555555556,1.1111111111111112,0.12,0.3333333333333333
Familial papillary thyroid carcinoma with renal papillary neoplasia,32194,0,5,17,3,14,19,0,19,0.6,0.0,0.17647058823529413,0.6,0.0,0.0
Familial aortic dissection,32443,1,1,18,0,18,21,0,21,0.0,0.0,0.0,0.0,0.0,0.0
Short fifth metacarpals-insulin resistance syndrome,32983,8,6,17,4,13,26,0,26,0.6666666666666666,0.0,0.23529411764705882,0.6666666666666666,0.0,0.0
Familial papillary or follicular thyroid carcinoma,33296,0,4,10,1,9,12,0,12,0.25,0.0,0.1,0.25,0.0,0.0
Short stature due to GHSR deficiency,30142,4,9,16,10,6,26,4,22,1.1111111111111112,0.4444444444444444,0.625,1.1111111111111112,0.15384615384615385,0.4444444444444444
Short stature due to partial GHR deficiency,28365,13,4,22,6,16,26,4,22,1.5,1.0,0.2727272727272727,1.5,0.15384615384615385,1.0
Gangliocytoma,33037,0,1,17,0,17,24,0,24,0.0,0.0,0.0,0.0,0.0,0.0
Pancreatoblastoma,33163,10,0,19,0,19,17,0,17,0.0,0.0,0.0,0.0,0.0,0.0
Leukoencephalopathy-palmoplantar keratoderma syndrome,33009,2,8,16,8,8,36,2,34,1.0,0.25,0.5,1.0,0.05555555555555555,0.25
Internal carotid absence,30453,15,0,33,0,33,37,0,37,0.0,0.0,0.0,0.0,0.0,0.0
TEMPI syndrome,33192,0,9,18,8,10,21,0,21,0.8888888888888888,0.0,0.4444444444444444,0.8888888888888888,0.0,0.0
Pituicytoma,33510,6,3,24,2,22,32,0,32,0.6666666666666666,0.0,0.08333333333333333,0.6666666666666666,0.0,0.0
Cutaneous collagenous vasculopathy,33258,5,8,19,8,11,28,5,23,1.0,0.625,0.42105263157894735,1.0,0.17857142857142858,0.625
Thyrotoxic periodic paralysis,27771,3,21,15,5,10,25,1,24,0.23809523809523808,0.047619047619047616,0.3333333333333333,0.23809523809523808,0.04,0.047619047619047616
Weaver-Williams syndrome,33364,0,6,24,5,19,20,0,20,0.8333333333333334,0.0,0.20833333333333334,0.8333333333333334,0.0,0.0
Kimura disease,33450,1,3,19,3,16,31,0,31,1.0,0.0,0.15789473684210525,1.0,0.0,0.0
"Combined pituitary hormone deficiencies, genetic forms",38320,15,1,26,1,25,38,1,37,1.0,1.0,0.038461538461538464,1.0,0.02631578947368421,1.0
Isolated follicle stimulating hormone deficiency,27680,3,13,23,5,18,20,1,19,0.38461538461538464,0.07692307692307693,0.21739130434782608,0.38461538461538464,0.05,0.07692307692307693
Eosinophilic gastroenteritis,37746,16,1,19,0,19,17,0,17,0.0,0.0,0.0,0.0,0.0,0.0
Familial nasal acilia,32082,10,0,17,0,17,20,0,20,0.0,0.0,0.0,0.0,0.0,0.0
Congenital pancreatic cyst,32862,9,0,18,0,18,24,0,24,0.0,0.0,0.0,0.0,0.0,0.0
Lelis syndrome,33202,0,4,18,2,16,16,0,16,0.5,0.0,0.1111111111111111,0.5,0.0,0.0
Non-acquired panhypopituitarism,32600,2,1,17,0,17,26,0,26,0.0,0.0,0.0,0.0,0.0,0.0
Hydrocephalus-obesity-hypogonadism syndrome,33486,2,12,16,9,7,20,3,17,0.75,0.25,0.5625,0.75,0.15,0.25
Wells syndrome,27731,3,2,22,1,21,35,0,35,0.5,0.0,0.045454545454545456,0.5,0.0,0.0
Susac syndrome,33010,4,1,21,1,20,22,1,21,1.0,1.0,0.047619047619047616,1.0,0.045454545454545456,1.0
Lethal recessive chondrodysplasia,30248,0,8,20,1,19,27,0,27,0.125,0.0,0.05,0.125,0.0,0.0
Spastic paraplegia-Paget disease of bone syndrome,32867,0,13,16,13,3,30,0,30,1.0,0.0,0.8125,1.0,0.0,0.0
Aorto-ventricular tunnel,98820,12,2,23,0,23,22,0,22,0.0,0.0,0.0,0.0,0.0,0.0
Central neurocytoma,32261,3,4,17,4,13,28,2,26,1.0,0.5,0.23529411764705882,1.0,0.07142857142857142,0.5
Bilateral acute depigmentation of the iris,33085,6,2,20,3,17,22,0,22,1.5,0.0,0.15,1.5,0.0,0.0
Kikuchi-Fujimoto disease,32790,5,1,26,0,26,25,1,24,0.0,1.0,0.0,0.0,0.04,1.0
Cogan syndrome,32356,3,6,16,7,9,25,3,22,1.1666666666666667,0.5,0.4375,1.1666666666666667,0.12,0.5
Arginine vasopressin resistance,29832,0,4,16,0,16,23,0,23,0.0,0.0,0.0,0.0,0.0,0.0
Functioning gonadotropic adenoma,32910,2,1,27,1,26,24,0,24,1.0,0.0,0.037037037037037035,1.0,0.0,0.0
Juvenile temporal arteritis,27692,3,0,24,0,24,19,0,19,0.0,0.0,0.0,0.0,0.0,0.0
Middle ear neuroendocrine tumor,33112,6,3,16,2,14,22,0,22,0.6666666666666666,0.0,0.125,0.6666666666666666,0.0,0.0
Familial hyperaldosteronism type I,27723,3,4,18,2,16,21,2,19,0.5,0.5,0.1111111111111111,0.5,0.09523809523809523,0.5
Familial hypoaldosteronism,33456,1,9,16,8,8,27,2,25,0.8888888888888888,0.2222222222222222,0.5,0.8888888888888888,0.07407407407407407,0.2222222222222222
Primary hyperaldosteronism-seizures-neurological abnormalities syndrome,27832,1,8,19,6,13,20,3,17,0.75,0.375,0.3157894736842105,0.75,0.15,0.375
Vulvovaginal gingival syndrome,32315,4,1,19,1,18,19,0,19,1.0,0.0,0.05263157894736842,1.0,0.0,0.0
Isaacs syndrome,32662,7,0,16,0,16,27,0,27,0.0,0.0,0.0,0.0,0.0,0.0
Epidermal nevus syndrome,32761,1,1,18,1,17,18,0,18,1.0,0.0,0.05555555555555555,1.0,0.0,0.0
Granulomatous slack skin,33452,4,0,14,0,14,26,0,26,0.0,0.0,0.0,0.0,0.0,0.0
Acute adrenal insufficiency,38666,15,16,20,6,14,17,6,11,0.375,0.375,0.3,0.375,0.35294117647058826,0.375
Addison disease,30813,4,15,18,7,11,18,6,12,0.4666666666666667,0.4,0.3888888888888889,0.4666666666666667,0.3333333333333333,0.4
Acquired generalized lipodystrophy,31864,1,3,26,1,25,32,1,31,0.3333333333333333,0.3333333333333333,0.038461538461538464,0.3333333333333333,0.03125,0.3333333333333333
Adrenocortical carcinoma with pure aldosterone hypersecretion,32820,4,8,16,6,10,19,5,14,0.75,0.625,0.375,0.75,0.2631578947368421,0.625
Ectopic aldosterone-producing tumor,32811,10,7,17,6,11,34,4,30,0.8571428571428571,0.5714285714285714,0.35294117647058826,0.8571428571428571,0.11764705882352941,0.5714285714285714
Familial hyperaldosteronism type III,27723,2,5,18,2,16,29,3,26,0.4,0.6,0.1111111111111111,0.4,0.10344827586206896,0.6
Familial pseudohyperkalemia,27444,5,1,16,1,15,20,0,20,1.0,0.0,0.0625,1.0,0.0,0.0
Primary unilateral adrenal hyperplasia,32943,6,3,17,3,14,22,1,21,1.0,0.3333333333333333,0.17647058823529413,1.0,0.045454545454545456,0.3333333333333333
Aseptic abscess syndrome,32413,3,2,16,1,15,27,1,26,0.5,0.5,0.0625,0.5,0.037037037037037035,0.5
Plummer-Vinson syndrome,33448,6,8,17,5,12,16,3,13,0.625,0.375,0.29411764705882354,0.625,0.1875,0.375
Myoclonic epilepsy of infancy,33036,0,5,20,5,15,14,0,14,1.0,0.0,0.25,1.0,0.0,0.0
Hyperparathyroidism-jaw tumor syndrome,30026,1,7,27,3,24,18,1,17,0.42857142857142855,0.14285714285714285,0.1111111111111111,0.42857142857142855,0.05555555555555555,0.14285714285714285
Generalized glucocorticoid resistance syndrome,32087,2,5,17,5,12,15,1,14,1.0,0.2,0.29411764705882354,1.0,0.06666666666666667,0.2
Idiopathic isolated micropenis,27742,5,1,25,0,25,19,0,19,0.0,0.0,0.0,0.0,0.0,0.0
Congenital isolated ACTH deficiency,27685,4,7,33,4,29,28,3,25,0.5714285714285714,0.42857142857142855,0.12121212121212122,0.5714285714285714,0.10714285714285714,0.42857142857142855
Congenital tricuspid stenosis,27663,21,2,23,1,22,29,1,28,0.5,0.5,0.043478260869565216,0.5,0.034482758620689655,0.5
Body skin hyperlaxity due to vitamin K-dependent coagulation factor deficiency,29300,0,4,16,6,10,27,0,27,1.5,0.0,0.375,1.5,0.0,0.0
Maternal uniparental disomy of chromosome 9 syndrome,32675,0,19,17,16,1,26,0,26,0.8421052631578947,0.0,0.9411764705882353,0.8421052631578947,0.0,0.0
Paternal uniparental disomy of chromosome 5 syndrome,32667,3,13,33,8,25,18,0,18,0.6153846153846154,0.0,0.24242424242424243,0.6153846153846154,0.0,0.0
Severe congenital hypochromic anemia with ringed sideroblasts,30402,3,4,18,4,14,30,1,29,1.0,0.25,0.2222222222222222,1.0,0.03333333333333333,0.25
Congenital dyserythropoietic anemia type III,28183,2,3,21,2,19,25,2,23,0.6666666666666666,0.6666666666666666,0.09523809523809523,0.6666666666666666,0.08,0.6666666666666666
Ring chromosome 7 syndrome,32373,1,29,22,8,14,33,3,30,0.27586206896551724,0.10344827586206896,0.36363636363636365,0.27586206896551724,0.09090909090909091,0.10344827586206896
Congenital alpha2-antiplasmin deficiency,31680,5,2,18,2,16,23,0,23,1.0,0.0,0.1111111111111111,1.0,0.0,0.0
Classic glucose transporter type 1 deficiency syndrome,31483,2,11,23,7,16,22,0,22,0.6363636363636364,0.0,0.30434782608695654,0.6363636363636364,0.0,0.0
N syndrome,28524,1,11,19,8,11,33,0,33,0.7272727272727273,0.0,0.42105263157894735,0.7272727272727273,0.0,0.0
Pineocytoma,33055,4,5,18,5,13,39,5,34,1.0,1.0,0.2777777777777778,1.0,0.1282051282051282,1.0
Papillary tumor of the pineal region,39302,11,6,21,3,18,34,6,28,0.5,1.0,0.14285714285714285,0.5,0.17647058823529413,1.0
Congenital factor XI deficiency,29969,7,5,21,7,14,18,1,17,1.4,0.2,0.3333333333333333,1.4,0.05555555555555555,0.2
Hereditary arterial and articular multiple calcification syndrome,28242,1,4,18,4,14,31,1,30,1.0,0.25,0.2222222222222222,1.0,0.03225806451612903,0.25
Hemolytic anemia due to red cell pyruvate kinase deficiency,31607,2,6,19,4,15,35,3,32,0.6666666666666666,0.5,0.21052631578947367,0.6666666666666666,0.08571428571428572,0.5
Congenital factor VII deficiency,28673,3,2,15,2,13,25,1,24,1.0,0.5,0.13333333333333333,1.0,0.04,0.5
Familial cerebral cavernous malformation,33380,6,4,19,3,16,34,5,29,0.75,1.25,0.15789473684210525,0.75,0.14705882352941177,1.25
Familial bicuspid aortic valve,33281,7,7,20,5,15,19,1,18,0.7142857142857143,0.14285714285714285,0.25,0.7142857142857143,0.05263157894736842,0.14285714285714285
Squamous cell carcinoma of the anal canal,32970,7,5,18,5,13,24,2,22,1.0,0.4,0.2777777777777778,1.0,0.08333333333333333,0.4
Adenocarcinoma of the anal canal,38141,15,5,23,2,21,25,2,23,0.4,0.4,0.08695652173913043,0.4,0.08,0.4
"Spondyloepimetaphyseal dysplasia, matrilin-3 type",38339,5,3,17,1,16,23,1,22,0.3333333333333333,0.3333333333333333,0.058823529411764705,0.3333333333333333,0.043478260869565216,0.3333333333333333
"Craniometadiaphyseal dysplasia, wormian bone type",32101,0,26,40,25,15,21,1,20,0.9615384615384616,0.038461538461538464,0.625,0.9615384615384616,0.047619047619047616,0.038461538461538464
Spondyloepiphyseal dysplasia-craniosynostosis-cleft palate-cataracts-intellectual disability syndrome,31488,5,28,32,6,26,27,1,26,0.21428571428571427,0.03571428571428571,0.1875,0.21428571428571427,0.037037037037037035,0.03571428571428571
Familial short QT syndrome,27655,5,2,21,1,20,23,0,23,0.5,0.0,0.047619047619047616,0.5,0.0,0.0
Osteoporosis-oculocutaneous hypopigmentation syndrome,27401,5,12,17,11,6,29,4,25,0.9166666666666666,0.3333333333333333,0.6470588235294118,0.9166666666666666,0.13793103448275862,0.3333333333333333
Primary hyperoxaluria type 1,29946,2,7,19,2,17,11,1,10,0.2857142857142857,0.14285714285714285,0.10526315789473684,0.2857142857142857,0.09090909090909091,0.14285714285714285
Hypergonadotropic hypogonadism-cataract syndrome,28407,3,10,17,4,13,34,5,29,0.4,0.5,0.23529411764705882,0.4,0.14705882352941177,0.5
Circumscribed palmoplantar hypokeratosis,33083,7,5,17,5,12,17,2,15,1.0,0.4,0.29411764705882354,1.0,0.11764705882352941,0.4
Amoebic keratitis,33229,5,5,16,7,9,17,4,13,1.4,0.8,0.4375,1.4,0.23529411764705882,0.8
Thrombotic thrombocytopenic purpura,29935,4,5,17,4,13,21,2,19,0.8,0.4,0.23529411764705882,0.8,0.09523809523809523,0.4
Hypoparathyroidism-sensorineural deafness-renal disease syndrome,30648,1,3,22,2,20,18,0,18,0.6666666666666666,0.0,0.09090909090909091,0.6666666666666666,0.0,0.0
Anonychia with flexural pigmentation,31744,1,13,18,11,7,16,1,15,0.8461538461538461,0.07692307692307693,0.6111111111111112,0.8461538461538461,0.0625,0.07692307692307693
Hypogonadotropic hypogonadism-retinitis pigmentosa syndrome,33522,3,15,18,13,5,32,3,29,0.8666666666666667,0.2,0.7222222222222222,0.8666666666666667,0.09375,0.2
Congenital sucrase-isomaltase deficiency,98349,16,2,23,3,20,21,3,18,1.5,1.5,0.13043478260869565,1.5,0.14285714285714285,1.5
Retinopathy of prematurity,32877,8,4,20,4,16,27,1,26,1.0,0.25,0.2,1.0,0.037037037037037035,0.25
Autosomal dominant Charcot-Marie-Tooth disease type 2F,94966,17,12,23,1,22,26,2,24,0.08333333333333333,0.16666666666666666,0.043478260869565216,0.08333333333333333,0.07692307692307693,0.16666666666666666
Osteochondritis dissecans,27943,3,5,26,6,20,26,5,21,1.2,1.0,0.23076923076923078,1.2,0.19230769230769232,1.0
AA amyloidosis,33159,8,5,25,0,25,24,0,24,0.0,0.0,0.0,0.0,0.0,0.0
Radiation proctitis,32916,7,8,20,8,12,22,1,21,1.0,0.125,0.4,1.0,0.045454545454545456,0.125
Spinocerebellar ataxia type 11,27402,7,8,27,2,25,9,2,7,0.25,0.25,0.07407407407407407,0.25,0.2222222222222222,0.25
Spinocerebellar ataxia type 3,27402,6,13,33,1,32,16,3,13,0.07692307692307693,0.23076923076923078,0.030303030303030304,0.07692307692307693,0.1875,0.23076923076923078
Paroxysmal exertion-induced dyskinesia,29166,1,3,18,2,16,21,0,21,0.6666666666666666,0.0,0.1111111111111111,0.6666666666666666,0.0,0.0
Maternal uniparental disomy of chromosome 6 syndrome,32677,2,0,17,0,17,26,0,26,0.0,0.0,0.0,0.0,0.0,0.0
Maternal uniparental disomy of chromosome 1 syndrome,33160,1,0,26,0,26,30,0,30,0.0,0.0,0.0,0.0,0.0,0.0
Spinocerebellar ataxia type 5,27402,10,4,23,4,19,11,2,9,1.0,0.5,0.17391304347826086,1.0,0.18181818181818182,0.5
Paternal uniparental disomy of chromosome 6 syndrome,32666,0,26,17,13,4,26,1,25,0.5,0.038461538461538464,0.7647058823529411,0.5,0.038461538461538464,0.038461538461538464
Hemihyperplasia-multiple lipomatosis syndrome,32607,0,1,17,1,16,21,0,21,1.0,0.0,0.058823529411764705,1.0,0.0,0.0
Paternal uniparental disomy of chromosome 1 syndrome,33161,2,0,16,0,16,30,0,30,0.0,0.0,0.0,0.0,0.0,0.0
Maternal uniparental disomy of chromosome 4 syndrome,32678,3,0,18,0,18,31,0,31,0.0,0.0,0.0,0.0,0.0,0.0
Primary hyperoxaluria type 3,29946,2,9,23,5,18,17,1,16,0.5555555555555556,0.1111111111111111,0.21739130434782608,0.5555555555555556,0.058823529411764705,0.1111111111111111
Primary hyperoxaluria type 2,29946,2,3,16,2,14,9,0,9,0.6666666666666666,0.0,0.125,0.6666666666666666,0.0,0.0
Congenital glucokinase-related hyperinsulinism,31796,2,5,16,3,13,26,0,26,0.6,0.0,0.1875,0.6,0.0,0.0
Placental insufficiency,33231,2,7,16,6,10,30,2,28,0.8571428571428571,0.2857142857142857,0.375,0.8571428571428571,0.06666666666666667,0.2857142857142857
Pulmonary fibrosis-hepatic hyperplasia-bone marrow hypoplasia syndrome,32389,2,5,16,5,11,22,0,22,1.0,0.0,0.3125,1.0,0.0,0.0
Maternal uniparental disomy of chromosome 2 syndrome,32679,0,3,17,3,14,41,0,41,1.0,0.0,0.17647058823529413,1.0,0.0,0.0
Dermochondrocorneal dystrophy,30236,0,7,17,4,13,23,1,22,0.5714285714285714,0.14285714285714285,0.23529411764705882,0.5714285714285714,0.043478260869565216,0.14285714285714285
Hereditary breast and/or ovarian cancer syndrome,83817,10,3,16,1,15,27,2,25,0.3333333333333333,0.6666666666666666,0.0625,0.3333333333333333,0.07407407407407407,0.6666666666666666
Kleefstra syndrome due to 9q34 microdeletion,32652,3,14,17,4,13,25,2,23,0.2857142857142857,0.14285714285714285,0.23529411764705882,0.2857142857142857,0.08,0.14285714285714285
Pediatric hepatocellular carcinoma,32621,5,4,17,4,13,16,2,14,1.0,0.5,0.23529411764705882,1.0,0.125,0.5
Microphthalmia with linear skin defects syndrome,32750,3,11,71,9,62,34,4,30,0.8181818181818182,0.36363636363636365,0.1267605633802817,0.8181818181818182,0.11764705882352941,0.36363636363636365
Microcephaly-lymphedema-chorioretinopathy syndrome,30010,0,4,28,0,28,29,4,25,0.0,1.0,0.0,0.0,0.13793103448275862,1.0
Neu-Laxova syndrome,31697,2,7,26,1,25,35,1,34,0.14285714285714285,0.14285714285714285,0.038461538461538464,0.14285714285714285,0.02857142857142857,0.14285714285714285
Mietens syndrome,30953,0,15,34,13,21,43,0,43,0.8666666666666667,0.0,0.38235294117647056,0.8666666666666667,0.0,0.0
"Blepharophimosis-intellectual disability syndrome, SBBYS type",35826,18,18,26,3,23,20,3,17,0.16666666666666666,0.16666666666666666,0.11538461538461539,0.16666666666666666,0.15,0.16666666666666666
Ear-patella-short stature syndrome,29471,4,20,17,2,15,32,1,31,0.1,0.05,0.11764705882352941,0.1,0.03125,0.05
Chronic inflammatory demyelinating polyneuropathy,27761,1,12,18,8,10,31,2,29,0.6666666666666666,0.16666666666666666,0.4444444444444444,0.6666666666666666,0.06451612903225806,0.16666666666666666
Baraitser-Winter cerebrofrontofacial syndrome,33405,3,38,21,15,6,30,4,26,0.39473684210526316,0.10526315789473684,0.7142857142857143,0.39473684210526316,0.13333333333333333,0.10526315789473684
Ichthyosis follicularis-alopecia-photophobia syndrome,38721,17,9,20,2,18,34,3,31,0.2222222222222222,0.3333333333333333,0.1,0.2222222222222222,0.08823529411764706,0.3333333333333333
Nicolaides-Baraitser syndrome,31904,0,22,17,1,16,40,2,38,0.045454545454545456,0.09090909090909091,0.058823529411764705,0.045454545454545456,0.05,0.09090909090909091
Filippi syndrome,31620,0,14,46,9,37,41,0,41,0.6428571428571429,0.0,0.1956521739130435,0.6428571428571429,0.0,0.0
Wild type ABeta2M amyloidosis,33133,0,3,16,0,16,31,1,30,0.0,0.3333333333333333,0.0,0.0,0.03225806451612903,0.3333333333333333
Hemophilia B,27361,3,14,25,9,16,25,5,20,0.6428571428571429,0.35714285714285715,0.36,0.6428571428571429,0.2,0.35714285714285715
Hemophilia A,32220,7,4,16,1,15,27,2,25,0.25,0.5,0.0625,0.25,0.07407407407407407,0.5
Autosomal semi-dominant severe lipodystrophic laminopathy,32642,0,15,24,8,16,22,0,22,0.5333333333333333,0.0,0.3333333333333333,0.5333333333333333,0.0,0.0
"GM2 gangliosidosis, AB variant",38766,18,13,45,1,44,26,1,25,0.07692307692307693,0.07692307692307693,0.022222222222222223,0.07692307692307693,0.038461538461538464,0.07692307692307693
Duchenne muscular dystrophy,32149,2,15,17,8,9,37,5,32,0.5333333333333333,0.3333333333333333,0.47058823529411764,0.5333333333333333,0.13513513513513514,0.3333333333333333
Bronchopulmonary dysplasia,37877,14,10,18,4,14,23,3,20,0.4,0.3,0.2222222222222222,0.4,0.13043478260869565,0.3
Neurofibroma,27275,3,1,27,0,27,47,1,46,0.0,1.0,0.0,0.0,0.02127659574468085,1.0
Meningioma,33215,1,3,28,1,27,33,0,33,0.3333333333333333,0.0,0.03571428571428571,0.3333333333333333,0.0,0.0
Pyruvate dehydrogenase E3 deficiency,31168,4,5,31,5,26,25,0,25,1.0,0.0,0.16129032258064516,1.0,0.0,0.0
Familial atrial myxoma,27881,1,3,16,1,15,24,0,24,0.3333333333333333,0.0,0.0625,0.3333333333333333,0.0,0.0
PRKAR1B-related neurodegenerative dementia with intermediate filaments,27744,3,6,18,7,11,21,0,21,1.1666666666666667,0.0,0.3888888888888889,1.1666666666666667,0.0,0.0
Congenital glaucoma,33033,14,2,19,1,18,24,1,23,0.5,0.5,0.05263157894736842,0.5,0.041666666666666664,0.5
Medulloblastoma,31067,3,1,32,1,31,22,0,22,1.0,0.0,0.03125,1.0,0.0,0.0
Walker-Warburg syndrome,32027,1,30,33,0,33,24,2,22,0.0,0.06666666666666667,0.0,0.0,0.08333333333333333,0.06666666666666667
Ullrich congenital muscular dystrophy,27258,1,12,19,4,15,27,0,27,0.3333333333333333,0.0,0.21052631578947367,0.3333333333333333,0.0,0.0
Drug-induced lupus erythematosus,32190,6,20,21,14,7,21,4,17,0.7,0.2,0.6666666666666666,0.7,0.19047619047619047,0.2
Hereditary angioedema type 1,29854,7,12,28,12,16,24,4,20,1.0,0.3333333333333333,0.42857142857142855,1.0,0.16666666666666666,0.3333333333333333
POEMS syndrome,33287,5,7,37,7,30,26,1,25,1.0,0.14285714285714285,0.1891891891891892,1.0,0.038461538461538464,0.14285714285714285
"46,XX difference of sex development-skeletal anomalies syndrome",27795,1,9,18,11,7,50,0,50,1.2222222222222223,0.0,0.6111111111111112,1.2222222222222223,0.0,0.0
Severe neurodegenerative syndrome with lipodystrophy,31872,1,8,36,7,29,24,2,22,0.875,0.25,0.19444444444444445,0.875,0.08333333333333333,0.25
Dextrocardia,30952,0,4,20,2,18,29,0,29,0.5,0.0,0.1,0.5,0.0,0.0
Infantile systemic hyalinosis,33337,0,37,18,19,-1,27,4,23,0.5135135135135135,0.10810810810810811,1.0555555555555556,0.5135135135135135,0.14814814814814814,0.10810810810810811
Occipital horn syndrome,30923,2,11,18,6,12,17,2,15,0.5454545454545454,0.18181818181818182,0.3333333333333333,0.5454545454545454,0.11764705882352941,0.18181818181818182
Arterial tortuosity syndrome,29806,3,7,27,3,24,24,1,23,0.42857142857142855,0.14285714285714285,0.1111111111111111,0.42857142857142855,0.041666666666666664,0.14285714285714285
Progeria-short stature-pigmented nevi syndrome,29625,5,48,57,40,17,37,6,31,0.8333333333333334,0.125,0.7017543859649122,0.8333333333333334,0.16216216216216217,0.125
Autosomal dominant Robinow syndrome,29073,1,10,17,1,16,32,0,32,0.1,0.0,0.058823529411764705,0.1,0.0,0.0
Desmosterolosis,30138,0,18,69,20,49,47,0,47,1.1111111111111112,0.0,0.2898550724637681,1.1111111111111112,0.0,0.0
Oculoectodermal syndrome,29016,0,7,17,0,17,28,0,28,0.0,0.0,0.0,0.0,0.0,0.0
Secondary syringomyelia,31462,9,2,16,0,16,25,0,25,0.0,0.0,0.0,0.0,0.0,0.0
Genetic hyperferritinemia without iron overload,27831,12,1,28,0,28,19,0,19,0.0,0.0,0.0,0.0,0.0,0.0
Adenohypophysitis,32603,1,1,25,1,24,19,0,19,1.0,0.0,0.04,1.0,0.0,0.0
Panhypophysitis,32600,1,3,18,2,16,19,0,19,0.6666666666666666,0.0,0.1111111111111111,0.6666666666666666,0.0,0.0
Perlman syndrome,29079,0,17,17,5,12,21,0,21,0.29411764705882354,0.0,0.29411764705882354,0.29411764705882354,0.0,0.0
Sheehan syndrome,32905,3,7,17,1,16,28,0,28,0.14285714285714285,0.0,0.058823529411764705,0.14285714285714285,0.0,0.0
Lenz-Majewski hyperostotic dwarfism,30033,2,30,18,7,11,24,3,21,0.23333333333333334,0.1,0.3888888888888889,0.23333333333333334,0.125,0.1
Osteopathia striata-cranial sclerosis syndrome,30098,2,8,25,3,22,9,2,7,0.375,0.25,0.12,0.375,0.2222222222222222,0.25
NK-cell enteropathy,33479,7,3,18,3,15,24,0,24,1.0,0.0,0.16666666666666666,1.0,0.0,0.0
Focal facial dermal dysplasia type IV,27910,1,3,67,3,64,24,0,24,1.0,0.0,0.04477611940298507,1.0,0.0,0.0
Interstitial cystitis,33249,3,13,15,11,4,18,3,15,0.8461538461538461,0.23076923076923078,0.7333333333333333,0.8461538461538461,0.16666666666666666,0.23076923076923078
Autosomal dominant optic atrophy and cataract,27858,3,3,41,4,37,27,3,24,1.3333333333333333,1.0,0.0975609756097561,1.3333333333333333,0.1111111111111111,1.0
X-linked endothelial corneal dystrophy,29476,11,4,19,7,12,24,3,21,1.75,0.75,0.3684210526315789,1.75,0.125,0.75
Encephalocraniocutaneous lipomatosis,30513,2,10,16,2,14,33,2,31,0.2,0.2,0.125,0.2,0.06060606060606061,0.2
Thrombocytopenia with congenital dyserythropoietic anemia,33233,7,9,22,8,14,29,2,27,0.8888888888888888,0.2222222222222222,0.36363636363636365,0.8888888888888888,0.06896551724137931,0.2222222222222222
Obesity due to melanocortin 4 receptor deficiency,32571,19,3,27,4,23,31,3,28,1.3333333333333333,1.0,0.14814814814814814,1.3333333333333333,0.0967741935483871,1.0
Obesity due to leptin receptor gene deficiency,27508,2,14,25,10,15,19,2,17,0.7142857142857143,0.14285714285714285,0.4,0.7142857142857143,0.10526315789473684,0.14285714285714285
Obesity due to congenital leptin deficiency,29143,0,14,18,9,9,34,2,32,0.6428571428571429,0.14285714285714285,0.5,0.6428571428571429,0.058823529411764705,0.14285714285714285
Lynch syndrome,31841,4,9,11,0,11,22,2,20,0.0,0.2222222222222222,0.0,0.0,0.09090909090909091,0.2222222222222222
Sarcoidosis,32967,0,0,17,0,17,30,0,30,0.0,0.0,0.0,0.0,0.0,0.0
Vernal keratoconjunctivitis,32918,4,12,20,9,11,20,5,15,0.75,0.4166666666666667,0.45,0.75,0.25,0.4166666666666667
Familial Alzheimer-like prion disease,31527,6,12,16,1,15,24,3,21,0.08333333333333333,0.25,0.0625,0.08333333333333333,0.125,0.25
Adenylosuccinate lyase deficiency,31130,3,17,27,6,21,27,1,26,0.35294117647058826,0.058823529411764705,0.2222222222222222,0.35294117647058826,0.037037037037037035,0.058823529411764705
ALG13-CDG,31434,1,1,26,0,26,22,0,22,0.0,0.0,0.0,0.0,0.0,0.0
Brain dopamine-serotonin vesicular transport disease,32882,2,31,18,16,2,31,2,29,0.5161290322580645,0.06451612903225806,0.8888888888888888,0.5161290322580645,0.06451612903225806,0.06451612903225806
Juvenile absence epilepsy,33115,0,3,24,4,20,19,1,18,1.3333333333333333,0.3333333333333333,0.16666666666666666,1.3333333333333333,0.05263157894736842,0.3333333333333333
Pituitary apoplexy,32738,4,2,32,2,30,33,0,33,1.0,0.0,0.0625,1.0,0.0,0.0
Pituitary dermoid and epidermoid cysts,32900,4,4,17,5,12,44,1,43,1.25,0.25,0.29411764705882354,1.25,0.022727272727272728,0.25
Early-onset Lafora body disease,31763,3,2,16,1,15,33,0,33,0.5,0.0,0.0625,0.5,0.0,0.0
Late-onset isolated ACTH deficiency,27685,5,16,33,13,20,27,8,19,0.8125,0.5,0.3939393939393939,0.8125,0.2962962962962963,0.5
Tangier disease,30143,3,2,25,1,24,26,0,26,0.5,0.0,0.04,0.5,0.0,0.0
Severe X-linked mitochondrial encephalomyopathy,30819,2,11,19,5,14,30,0,30,0.45454545454545453,0.0,0.2631578947368421,0.45454545454545453,0.0,0.0
VIPoma,27660,2,3,18,1,17,20,1,19,0.3333333333333333,0.3333333333333333,0.05555555555555555,0.3333333333333333,0.05,0.3333333333333333
Glycine encephalopathy,28289,3,8,17,6,11,26,1,25,0.75,0.125,0.35294117647058826,0.75,0.038461538461538464,0.125
American trypanosomiasis,32503,1,0,19,0,19,37,0,37,0.0,0.0,0.0,0.0,0.0,0.0
RFT1-CDG,30571,4,5,31,5,26,28,1,27,1.0,0.2,0.16129032258064516,1.0,0.03571428571428571,0.2
SSR4-CDG,100022,6,16,27,0,27,33,2,31,0.0,0.125,0.0,0.0,0.06060606060606061,0.125
SLC35A1-CDG,29977,0,13,21,10,11,22,0,22,0.7692307692307693,0.0,0.47619047619047616,0.7692307692307693,0.0,0.0
STT3A-CDG,30045,2,9,17,8,9,24,1,23,0.8888888888888888,0.1111111111111111,0.47058823529411764,0.8888888888888888,0.041666666666666664,0.1111111111111111
STT3B-CDG,32157,1,9,16,8,8,27,1,26,0.8888888888888888,0.1111111111111111,0.5,0.8888888888888888,0.037037037037037035,0.1111111111111111
Chronic myeloid leukemia,30039,2,1,14,1,13,32,0,32,1.0,0.0,0.07142857142857142,1.0,0.0,0.0
Acral peeling skin syndrome,27197,6,0,18,0,18,21,0,21,0.0,0.0,0.0,0.0,0.0,0.0
Kaposi sarcoma,99253,17,5,19,0,19,25,0,25,0.0,0.0,0.0,0.0,0.0,0.0
PPoma,32273,4,2,19,0,19,32,0,32,0.0,0.0,0.0,0.0,0.0,0.0
Moyamoya disease with early-onset achalasia,28581,1,1,16,1,15,17,0,17,1.0,0.0,0.0625,1.0,0.0,0.0
Zollinger-Ellison syndrome,32875,3,8,22,4,18,22,4,18,0.5,0.5,0.18181818181818182,0.5,0.18181818181818182,0.5
"Pseudoleprechaunism syndrome, Patterson type",27308,1,25,37,23,14,18,1,17,0.92,0.04,0.6216216216216216,0.92,0.05555555555555555,0.04
Colchicine poisoning,33018,1,7,17,5,12,24,3,21,0.7142857142857143,0.42857142857142855,0.29411764705882354,0.7142857142857143,0.125,0.42857142857142855
AICA-ribosiduria,30286,1,10,19,7,12,26,0,26,0.7,0.0,0.3684210526315789,0.7,0.0,0.0
Glucagonoma,32267,4,1,29,1,28,27,0,27,1.0,0.0,0.034482758620689655,1.0,0.0,0.0
Malaria,33128,3,7,18,6,12,17,4,13,0.8571428571428571,0.5714285714285714,0.3333333333333333,0.8571428571428571,0.23529411764705882,0.5714285714285714
Leishmaniasis,38998,16,14,32,2,30,25,4,21,0.14285714285714285,0.2857142857142857,0.0625,0.14285714285714285,0.16,0.2857142857142857
Uveal melanoma,33172,3,3,17,3,14,18,1,17,1.0,0.3333333333333333,0.17647058823529413,1.0,0.05555555555555555,0.3333333333333333
GRFoma,32281,2,1,17,0,17,43,0,43,0.0,0.0,0.0,0.0,0.0,0.0
Somatostatinoma,96642,14,0,24,0,24,27,0,27,0.0,0.0,0.0,0.0,0.0,0.0
RHYNS syndrome,29684,0,6,18,3,15,13,0,13,0.5,0.0,0.16666666666666666,0.5,0.0,0.0
Åland Islands eye disease,27416,4,9,22,8,14,27,2,25,0.8888888888888888,0.2222222222222222,0.36363636363636365,0.8888888888888888,0.07407407407407407,0.2222222222222222
7q11.23 microduplication syndrome,32059,3,1,57,1,56,27,1,26,1.0,1.0,0.017543859649122806,1.0,0.037037037037037035,1.0
Hepatic veno-occlusive disease,32827,10,9,20,9,11,28,4,24,1.0,0.4444444444444444,0.45,1.0,0.14285714285714285,0.4444444444444444
Mercury poisoning,32280,2,0,16,0,16,38,0,38,0.0,0.0,0.0,0.0,0.0,0.0
Sickle cell anemia,28921,4,4,17,5,12,29,3,26,1.25,0.75,0.29411764705882354,1.25,0.10344827586206896,0.75
Ring chromosome 13 syndrome,32681,1,4,17,2,15,33,3,30,0.5,0.75,0.11764705882352941,0.5,0.09090909090909091,0.75
Monosomy 13q34 syndrome,32684,1,5,31,3,28,31,1,30,0.6,0.2,0.0967741935483871,0.6,0.03225806451612903,0.2
Urocanic aciduria,38526,8,11,23,0,23,42,0,42,0.0,0.0,0.0,0.0,0.0,0.0
20q13.33 microdeletion syndrome,32429,6,8,105,7,98,32,5,27,0.875,0.625,0.06666666666666667,0.875,0.15625,0.625
Microtriplication 11q24.1 syndrome,27698,2,31,18,15,3,16,2,14,0.4838709677419355,0.06451612903225806,0.8333333333333334,0.4838709677419355,0.125,0.06451612903225806
Pancreatic hypoplasia-diabetes-congenital heart disease syndrome,30063,2,5,21,4,17,30,0,30,0.8,0.0,0.19047619047619047,0.8,0.0,0.0
SERKAL syndrome,27931,0,5,19,4,15,15,0,15,0.8,0.0,0.21052631578947367,0.8,0.0,0.0
Lennox-Gastaut syndrome,29865,4,3,20,4,16,33,1,32,1.3333333333333333,0.3333333333333333,0.2,1.3333333333333333,0.030303030303030304,0.3333333333333333
BNAR syndrome,32053,5,5,21,5,16,15,0,15,1.0,0.0,0.23809523809523808,1.0,0.0,0.0
Amyotrophic lateral sclerosis,31996,2,4,42,2,40,23,0,23,0.5,0.0,0.047619047619047616,0.5,0.0,0.0
Symphalangism with multiple anomalies of hands and feet,31741,0,3,28,3,25,34,0,34,1.0,0.0,0.10714285714285714,1.0,0.0,0.0
6-pyruvoyl-tetrahydropterin synthase deficiency,31733,4,0,19,0,19,29,0,29,0.0,0.0,0.0,0.0,0.0,0.0
Hypoinsulinemic hypoglycemia and body hemihypertrophy,27764,3,12,21,10,11,23,1,22,0.8333333333333334,0.08333333333333333,0.47619047619047616,0.8333333333333334,0.043478260869565216,0.08333333333333333
FADD-related immunodeficiency,30359,1,3,16,3,13,29,0,29,1.0,0.0,0.1875,1.0,0.0,0.0
Kyphoscoliotic Ehlers-Danlos syndrome due to FKBP22 deficiency,33340,4,11,17,4,13,34,1,33,0.36363636363636365,0.09090909090909091,0.23529411764705882,0.36363636363636365,0.029411764705882353,0.09090909090909091
Hyperinsulinism due to INSR deficiency,28937,6,5,19,5,14,32,2,30,1.0,0.4,0.2631578947368421,1.0,0.0625,0.4
Systemic primary carnitine deficiency,29130,12,9,21,1,20,26,1,25,0.1111111111111111,0.1111111111111111,0.047619047619047616,0.1111111111111111,0.038461538461538464,0.1111111111111111
Papular xanthoma,33506,9,3,20,3,17,16,0,16,1.0,0.0,0.15,1.0,0.0,0.0
Multiple endocrine neoplasia type 4,28426,6,6,39,3,36,32,2,30,0.5,0.3333333333333333,0.07692307692307693,0.5,0.0625,0.3333333333333333
Monosomy 22 syndrome,32660,1,0,18,0,18,24,0,24,0.0,0.0,0.0,0.0,0.0,0.0
"Spondyloepimetaphyseal dysplasia, aggrecan type",38339,4,15,21,2,19,19,0,19,0.13333333333333333,0.0,0.09523809523809523,0.13333333333333333,0.0,0.0
CHST3-related skeletal dysplasia,27279,4,18,115,18,97,26,1,25,1.0,0.05555555555555555,0.1565217391304348,1.0,0.038461538461538464,0.05555555555555555
Sensorineural deafness with dilated cardiomyopathy,98109,16,5,24,1,23,18,0,18,0.2,0.0,0.041666666666666664,0.2,0.0,0.0
Congenital fibrinogen deficiency,30267,1,26,16,14,2,21,4,17,0.5384615384615384,0.15384615384615385,0.875,0.5384615384615384,0.19047619047619047,0.15384615384615385
Atypical hemolytic uremic syndrome,30066,3,8,21,3,18,18,4,14,0.375,0.5,0.14285714285714285,0.375,0.2222222222222222,0.5
Oculocutaneous albinism type 5,84278,6,7,25,7,18,24,4,20,1.0,0.5714285714285714,0.28,1.0,0.16666666666666666,0.5714285714285714
Primary sclerosing cholangitis,27700,5,3,32,4,28,19,1,18,1.3333333333333333,0.3333333333333333,0.125,1.3333333333333333,0.05263157894736842,0.3333333333333333
Centrifugal lipodystrophy,33048,6,2,16,2,14,29,0,29,1.0,0.0,0.125,1.0,0.0,0.0
Panniculitis-induced localized lipodystrophy,33044,3,2,20,2,18,20,0,20,1.0,0.0,0.1,1.0,0.0,0.0
Emanuel syndrome,31692,0,1,69,1,68,26,0,26,1.0,0.0,0.014492753623188406,1.0,0.0,0.0
Tetrasomy 9p syndrome,39342,15,0,25,0,25,31,0,31,0.0,0.0,0.0,0.0,0.0,0.0
X-linked adrenoleukodystrophy,32783,1,21,41,7,34,39,6,33,0.3333333333333333,0.2857142857142857,0.17073170731707318,0.3333333333333333,0.15384615384615385,0.2857142857142857
Pressure-induced localized lipoatrophy,33041,2,3,22,3,19,17,0,17,1.0,0.0,0.13636363636363635,1.0,0.0,0.0
"Primary dystonia, DYT13 type",27743,8,5,70,5,65,29,2,27,1.0,0.4,0.07142857142857142,1.0,0.06896551724137931,0.4
Ring chromosome 12 syndrome,32385,0,3,20,3,17,33,0,33,1.0,0.0,0.15,1.0,0.0,0.0
Autosomal recessive hypophosphatemic rickets,27800,2,26,17,12,5,23,4,19,0.46153846153846156,0.15384615384615385,0.7058823529411765,0.46153846153846156,0.17391304347826086,0.15384615384615385
Craniopharyngioma,32939,4,6,39,6,33,32,1,31,1.0,0.16666666666666666,0.15384615384615385,1.0,0.03125,0.16666666666666666
Pituitary deficiency due to empty sella turcica syndrome,27741,1,0,17,0,17,20,0,20,0.0,0.0,0.0,0.0,0.0,0.0
Solar urticaria,32231,9,13,21,11,10,31,7,24,0.8461538461538461,0.5384615384615384,0.5238095238095238,0.8461538461538461,0.22580645161290322,0.5384615384615384
Becker muscular dystrophy,30669,3,7,17,3,14,24,2,22,0.42857142857142855,0.2857142857142857,0.17647058823529413,0.42857142857142855,0.08333333333333333,0.2857142857142857
Pituitary deficiency due to Rathke cleft cysts,32899,0,1,17,2,15,27,0,27,2.0,0.0,0.11764705882352941,2.0,0.0,0.0
Nelson syndrome,28832,0,5,19,0,19,32,0,32,0.0,0.0,0.0,0.0,0.0,0.0
Dimethylglycine dehydrogenase deficiency,28290,0,5,7,4,3,20,0,20,0.8,0.0,0.5714285714285714,0.8,0.0,0.0
Giant axonal neuropathy,29389,1,9,25,6,19,27,1,26,0.6666666666666666,0.1111111111111111,0.24,0.6666666666666666,0.037037037037037035,0.1111111111111111
Inhalational anthrax,32710,8,4,19,2,17,29,2,27,0.5,0.5,0.10526315789473684,0.5,0.06896551724137931,0.5
Branchioskeletogenital syndrome,29196,0,37,29,0,29,22,0,22,0.0,0.0,0.0,0.0,0.0,0.0
Hereditary chronic pancreatitis,28384,3,4,16,3,13,21,2,19,0.75,0.5,0.1875,0.75,0.09523809523809523,0.5
Autism spectrum disorder-epilepsy-arthrogryposis syndrome,29642,2,1,17,1,16,35,0,35,1.0,0.0,0.058823529411764705,1.0,0.0,0.0
Oculocutaneous albinism type 6,84278,8,7,29,5,24,31,4,27,0.7142857142857143,0.5714285714285714,0.1724137931034483,0.7142857142857143,0.12903225806451613,0.5714285714285714
Focal facial dermal dysplasia type II,27910,1,6,26,2,24,29,0,29,0.3333333333333333,0.0,0.07692307692307693,0.3333333333333333,0.0,0.0
Calciphylaxis,84215,11,12,27,2,25,22,2,20,0.16666666666666666,0.16666666666666666,0.07407407407407407,0.16666666666666666,0.09090909090909091,0.16666666666666666
Homozygous familial hypercholesterolemia,33299,8,5,27,3,24,35,3,32,0.6,0.6,0.1111111111111111,0.6,0.08571428571428572,0.6
Familial chylomicronemia syndrome,27755,1,8,16,4,12,29,2,27,0.5,0.25,0.25,0.5,0.06896551724137931,0.25
Obesity due to pro-opiomelanocortin deficiency,30170,4,3,17,2,15,19,3,16,0.6666666666666666,1.0,0.11764705882352941,0.6666666666666666,0.15789473684210525,1.0
Obesity due to prohormone convertase I deficiency,30410,0,3,17,2,15,50,2,48,0.6666666666666666,0.6666666666666666,0.11764705882352941,0.6666666666666666,0.04,0.6666666666666666
Autoimmune hypoparathyroidism,33262,2,3,18,1,17,21,0,21,0.3333333333333333,0.0,0.05555555555555555,0.3333333333333333,0.0,0.0
Auricular abnormalities-cleft lip with or without cleft palate-ocular abnormalities syndrome,33184,0,2,16,0,16,30,1,29,0.0,0.5,0.0,0.0,0.03333333333333333,0.5
Autosomal recessive primary microcephaly,27182,5,9,25,7,18,26,2,24,0.7777777777777778,0.2222222222222222,0.28,0.7777777777777778,0.07692307692307693,0.2222222222222222
Autoimmune polyendocrinopathy type 3,27834,2,1,70,2,68,22,0,22,2.0,0.0,0.02857142857142857,2.0,0.0,0.0
Autoimmune polyendocrinopathy type 4,38555,18,1,27,0,27,22,0,22,0.0,0.0,0.0,0.0,0.0,0.0
Primary hepatic neuroendocrine carcinoma,27774,3,2,22,2,20,26,0,26,1.0,0.0,0.09090909090909091,1.0,0.0,0.0
Gallbladder neuroendocrine tumor,33106,3,2,17,1,16,26,0,26,0.5,0.0,0.058823529411764705,0.5,0.0,0.0
Bronchial neuroendocrine tumor,32264,4,1,17,1,16,27,0,27,1.0,0.0,0.058823529411764705,1.0,0.0,0.0
Neuroendocrine tumor of stomach,33118,3,1,22,0,22,23,0,23,0.0,0.0,0.0,0.0,0.0,0.0
Adrenocortical carcinoma,38037,13,1,24,0,24,24,0,24,0.0,0.0,0.0,0.0,0.0,0.0
Pure autonomic failure,33468,7,5,20,5,15,26,3,23,1.0,0.6,0.25,1.0,0.11538461538461539,0.6
Laryngeal neuroendocrine tumor,33111,3,2,16,2,14,34,0,34,1.0,0.0,0.125,1.0,0.0,0.0
Cutaneous neuroendocrine carcinoma,27810,3,1,17,1,16,19,0,19,1.0,0.0,0.058823529411764705,1.0,0.0,0.0
Neuroendocrine tumor of the colon,33114,2,1,16,0,16,19,0,19,0.0,0.0,0.0,0.0,0.0,0.0
Neuroendocrine neoplasm of appendix,39113,14,1,29,0,29,21,0,21,0.0,0.0,0.0,0.0,0.0,0.0
Neuroendocrine tumor of anal canal,33110,2,1,19,0,19,22,0,22,0.0,0.0,0.0,0.0,0.0,0.0
Neuroendocrine tumor of the rectum,33116,2,1,20,0,20,24,0,24,0.0,0.0,0.0,0.0,0.0,0.0
Ulbright-Hodes syndrome,28730,1,0,45,0,45,38,0,38,0.0,0.0,0.0,0.0,0.0,0.0
Spastic paraplegia-nephritis-deafness syndrome,30994,2,9,18,8,10,34,1,33,0.8888888888888888,0.1111111111111111,0.4444444444444444,0.8888888888888888,0.029411764705882353,0.1111111111111111
Tubular aggregate myopathy,32730,10,6,18,7,11,18,2,16,1.1666666666666667,0.3333333333333333,0.3888888888888889,1.1666666666666667,0.1111111111111111,0.3333333333333333
Carcinoid syndrome,33104,1,1,16,1,15,29,0,29,1.0,0.0,0.0625,1.0,0.0,0.0
Otodental syndrome,31500,0,5,71,0,71,19,1,18,0.0,0.2,0.0,0.0,0.05263157894736842,0.2
Pili torti-onychodysplasia syndrome,32594,5,1,17,0,17,27,0,27,0.0,0.0,0.0,0.0,0.0,0.0
Pelvis-shoulder dysplasia,31759,0,1,28,0,28,25,0,25,0.0,0.0,0.0,0.0,0.0,0.0
DPM3-CDG,28471,2,1,16,0,16,27,0,27,0.0,0.0,0.0,0.0,0.0,0.0
COG4-CDG,29748,0,2,42,2,40,11,0,11,1.0,0.0,0.047619047619047616,1.0,0.0,0.0
COASY protein-associated neurodegeneration,29074,11,13,137,17,120,21,2,19,1.3076923076923077,0.15384615384615385,0.12408759124087591,1.3076923076923077,0.09523809523809523,0.15384615384615385
Severe combined immunodeficiency due to adenosine deaminase deficiency,32100,5,0,28,0,28,31,0,31,0.0,0.0,0.0,0.0,0.0,0.0
Ichthyosis-hepatosplenomegaly-cerebellar degeneration syndrome,29578,6,8,21,8,13,31,3,28,1.0,0.375,0.38095238095238093,1.0,0.0967741935483871,0.375
Glycogen storage disease with severe cardiomyopathy due to glycogenin deficiency,30954,11,0,22,0,22,29,0,29,0.0,0.0,0.0,0.0,0.0,0.0
Yunis-Varon syndrome,32112,0,3,98,3,95,40,0,40,1.0,0.0,0.030612244897959183,1.0,0.0,0.0
Cerebellar ataxia-areflexia-pes cavus-optic atrophy-sensorineural hearing loss syndrome,27541,5,6,19,6,13,7,3,4,1.0,0.5,0.3157894736842105,1.0,0.42857142857142855,0.5
Glioblastoma,37487,20,2,28,0,28,24,0,24,0.0,0.0,0.0,0.0,0.0,0.0
Idiopathic pulmonary fibrosis,30661,4,1,16,2,14,18,0,18,2.0,0.0,0.125,2.0,0.0,0.0
Cenani-Lenz syndrome,32005,0,7,19,4,15,4,0,4,0.5714285714285714,0.0,0.21052631578947367,0.5714285714285714,0.0,0.0
Isolated distal symphalangism,30247,0,3,14,1,13,24,0,24,0.3333333333333333,0.0,0.07142857142857142,0.3333333333333333,0.0,0.0
Isotretinoin-like syndrome,27758,0,1,19,1,18,31,0,31,1.0,0.0,0.05263157894736842,1.0,0.0,0.0
Pfeiffer-Palm-Teller syndrome,28193,3,0,20,0,20,31,0,31,0.0,0.0,0.0,0.0,0.0,0.0
Non-progressive predominantly posterior cavitating leukoencephalopathy with peripheral neuropathy,97948,5,2,20,0,20,20,0,20,0.0,0.0,0.0,0.0,0.0,0.0
"Cardiocranial syndrome, Pfeiffer type",31346,0,7,34,8,26,13,0,13,1.1428571428571428,0.0,0.23529411764705882,1.1428571428571428,0.0,0.0
Renpenning syndrome,32065,0,5,20,1,19,16,0,16,0.2,0.0,0.05,0.2,0.0,0.0
Deafness-vitiligo-achalasia syndrome,28430,11,6,24,4,20,34,1,33,0.6666666666666666,0.16666666666666666,0.16666666666666666,0.6666666666666666,0.029411764705882353,0.16666666666666666
Cardiospondylocarpofacial syndrome,32109,0,9,30,6,24,26,0,26,0.6666666666666666,0.0,0.2,0.6666666666666666,0.0,0.0
Multiple synostoses syndrome,28804,4,5,58,6,52,44,1,43,1.2,0.2,0.10344827586206896,1.2,0.022727272727272728,0.2
Deafness-genital anomalies-metacarpal and metatarsal synostosis syndrome,32333,1,16,24,9,15,36,2,34,0.5625,0.125,0.375,0.5625,0.05555555555555555,0.125
Deafness-enamel hypoplasia-nail defects syndrome,32330,3,18,18,13,5,39,5,34,0.7222222222222222,0.2777777777777778,0.7222222222222222,0.7222222222222222,0.1282051282051282,0.2777777777777778
Deafness-small bowel diverticulosis-neuropathy syndrome,29269,0,8,18,6,12,21,0,21,0.75,0.0,0.3333333333333333,0.75,0.0,0.0
Spastic paraplegia-glaucoma-intellectual disability syndrome,38974,10,4,28,2,26,33,0,33,0.5,0.0,0.07142857142857142,0.5,0.0,0.0
Spastic paraplegia-facial-cutaneous lesions syndrome,32437,3,9,21,5,16,22,1,21,0.5555555555555556,0.1111111111111111,0.23809523809523808,0.5555555555555556,0.045454545454545456,0.1111111111111111
Peripheral motor neuropathy-dysautonomia syndrome,32032,4,7,16,6,10,33,0,33,0.8571428571428571,0.0,0.375,0.8571428571428571,0.0,0.0
X-linked immunoneurologic disorder,30901,0,0,16,0,16,24,0,24,0.0,0.0,0.0,0.0,0.0,0.0
Undifferentiated pleomorphic sarcoma,96287,13,3,36,0,36,21,0,21,0.0,0.0,0.0,0.0,0.0,0.0
Long chain 3-hydroxyacyl-CoA dehydrogenase deficiency,27860,3,3,18,1,17,26,3,23,0.3333333333333333,1.0,0.05555555555555555,0.3333333333333333,0.11538461538461539,1.0
Nephrosis-deafness-urinary tract-digital malformations syndrome,29757,4,0,18,0,18,36,0,36,0.0,0.0,0.0,0.0,0.0,0.0
Trigonocephaly-short stature-developmental delay syndrome,28461,1,3,22,3,19,36,1,35,1.0,0.3333333333333333,0.13636363636363635,1.0,0.027777777777777776,0.3333333333333333
Nasopalpebral lipoma-coloboma syndrome,27754,3,3,32,4,28,27,1,26,1.3333333333333333,0.3333333333333333,0.125,1.3333333333333333,0.037037037037037035,0.3333333333333333
Thyrocerebrorenal syndrome,27696,3,0,20,0,20,31,0,31,0.0,0.0,0.0,0.0,0.0,0.0
Idiopathic/heritable pulmonary arterial hypertension,39076,15,1,19,0,19,18,0,18,0.0,0.0,0.0,0.0,0.0,0.0
Autoimmune pulmonary alveolar proteinosis,31774,7,1,17,0,17,16,0,16,0.0,0.0,0.0,0.0,0.0,0.0
Ichthyosis-intellectual disability-dwarfism-renal impairment syndrome,31725,2,4,20,2,18,39,1,38,0.5,0.25,0.1,0.5,0.02564102564102564,0.25
PHAVER syndrome,32597,0,8,25,8,17,25,0,25,1.0,0.0,0.32,1.0,0.0,0.0
Autosomal recessive Kenny-Caffey syndrome,27547,0,3,17,1,16,34,0,34,0.3333333333333333,0.0,0.058823529411764705,0.3333333333333333,0.0,0.0
Autosomal dominant Kenny-Caffey syndrome,27547,1,4,17,3,14,36,0,36,0.75,0.0,0.17647058823529413,0.75,0.0,0.0
Postpoliomyelitis syndrome,33269,3,2,16,3,13,28,3,25,1.5,1.5,0.1875,1.5,0.10714285714285714,1.5
Familial cerebral saccular aneurysm,33557,1,1,20,0,20,28,0,28,0.0,0.0,0.0,0.0,0.0,0.0
Neuromyelitis optica spectrum disorder,33400,1,10,16,8,8,28,4,24,0.8,0.4,0.5,0.8,0.14285714285714285,0.4
Posterior cortical atrophy,32407,5,10,17,7,10,25,3,22,0.7,0.3,0.4117647058823529,0.7,0.12,0.3
Acyl-CoA dehydrogenase 9 deficiency,28731,6,1,18,0,18,28,0,28,0.0,0.0,0.0,0.0,0.0,0.0
Rigid spine syndrome,32221,1,7,18,6,12,24,1,23,0.8571428571428571,0.14285714285714285,0.3333333333333333,0.8571428571428571,0.041666666666666664,0.14285714285714285
Glycogen storage disease due to lactate dehydrogenase deficiency,33023,10,3,20,1,19,25,0,25,0.3333333333333333,0.0,0.05,0.3333333333333333,0.0,0.0
Metachondromatosis,31364,7,7,20,6,14,23,1,22,0.8571428571428571,0.14285714285714285,0.3,0.8571428571428571,0.043478260869565216,0.14285714285714285
Mesomelia-synostoses syndrome,28345,2,24,33,15,18,42,0,42,0.625,0.0,0.45454545454545453,0.625,0.0,0.0
Mutilating hereditary sensory neuropathy with spastic paraplegia,39084,7,9,25,4,21,36,3,33,0.4444444444444444,0.3333333333333333,0.16,0.4444444444444444,0.08333333333333333,0.3333333333333333
Pericardial and diaphragmatic defect,32412,2,2,16,1,15,24,0,24,0.5,0.0,0.0625,0.5,0.0,0.0
Acrootoocular syndrome,27815,1,0,17,0,17,38,0,38,0.0,0.0,0.0,0.0,0.0,0.0
Autosomal recessive omodysplasia,31857,0,12,17,5,12,18,0,18,0.4166666666666667,0.0,0.29411764705882354,0.4166666666666667,0.0,0.0
Arachnodactyly-abnormal ossification-intellectual disability syndrome,33227,2,0,19,0,19,42,0,42,0.0,0.0,0.0,0.0,0.0,0.0
Erythrokeratoderma ''en cocardes'',38275,4,4,25,4,21,24,2,22,1.0,0.5,0.16,1.0,0.08333333333333333,0.5
Systemic capillary leak syndrome,32762,0,2,17,2,15,21,0,21,1.0,0.0,0.11764705882352941,1.0,0.0,0.0
Autosomal dominant hypohidrotic ectodermal dysplasia,32453,3,8,28,4,24,35,1,34,0.5,0.125,0.14285714285714285,0.5,0.02857142857142857,0.125
Toxic epidermal necrolysis,32299,3,11,31,3,28,23,3,20,0.2727272727272727,0.2727272727272727,0.0967741935483871,0.2727272727272727,0.13043478260869565,0.2727272727272727
CHIME syndrome,31712,2,21,41,11,30,24,3,21,0.5238095238095238,0.14285714285714285,0.2682926829268293,0.5238095238095238,0.125,0.14285714285714285
GCGR-related hyperglucagonemia,27646,9,1,20,1,19,19,0,19,1.0,0.0,0.05,1.0,0.0,0.0
Inverted duplicated chromosome 15 syndrome,27697,0,4,17,3,14,21,0,21,0.75,0.0,0.17647058823529413,0.75,0.0,0.0
Sporadic pheochromocytoma/secreting paraganglioma,33207,8,3,20,0,20,18,0,18,0.0,0.0,0.0,0.0,0.0,0.0
Non-functioning paraganglioma,28429,1,1,16,1,15,17,0,17,1.0,0.0,0.0625,1.0,0.0,0.0
Hereditary pheochromocytoma-paraganglioma,33431,4,3,23,2,21,18,0,18,0.6666666666666666,0.0,0.08695652173913043,0.6666666666666666,0.0,0.0
Kleefstra syndrome,32549,4,12,19,2,17,28,2,26,0.16666666666666666,0.16666666666666666,0.10526315789473684,0.16666666666666666,0.07142857142857142,0.16666666666666666
Tietz syndrome,29062,0,6,20,6,14,1,0,1,1.0,0.0,0.3,1.0,0.0,0.0
Tyrosinemia type 2,37602,19,4,26,0,26,28,0,28,0.0,0.0,0.0,0.0,0.0,0.0
Malignant atrophic papulosis,31893,0,3,17,3,14,23,1,22,1.0,0.3333333333333333,0.17647058823529413,1.0,0.043478260869565216,0.3333333333333333
Congenital ichthyosis-microcephalus-tetraplegia syndrome,33497,9,8,23,6,17,28,5,23,0.75,0.625,0.2608695652173913,0.75,0.17857142857142858,0.625
Male hypergonadotropic hypogonadism-intellectual disability-skeletal anomalies syndrome,28452,3,12,17,8,9,26,4,22,0.6666666666666666,0.3333333333333333,0.47058823529411764,0.6666666666666666,0.15384615384615385,0.3333333333333333
Hydrocephaly-tall stature-joint laxity syndrome,28637,4,7,16,9,7,30,3,27,1.2857142857142858,0.42857142857142855,0.5625,1.2857142857142858,0.1,0.42857142857142855
Hydrocephalus-costovertebral dysplasia-Sprengel anomaly syndrome,29540,2,3,25,3,22,23,1,22,1.0,0.3333333333333333,0.12,1.0,0.043478260869565216,0.3333333333333333
Johnson neuroectodermal syndrome,31953,0,5,18,4,14,27,0,27,0.8,0.0,0.2222222222222222,0.8,0.0,0.0
IVIC syndrome,28220,0,5,17,4,13,37,0,37,0.8,0.0,0.23529411764705882,0.8,0.0,0.0
Microvillus inclusion disease,28835,4,0,16,0,16,27,0,27,0.0,0.0,0.0,0.0,0.0,0.0
Superficial epidermolytic ichthyosis,38946,7,6,19,0,19,17,0,17,0.0,0.0,0.0,0.0,0.0,0.0
Umbilical cord ulceration-intestinal atresia syndrome,33382,4,3,10,0,10,24,0,24,0.0,0.0,0.0,0.0,0.0,0.0
NPHP3-related Meckel-like syndrome,29600,0,3,18,2,16,23,0,23,0.6666666666666666,0.0,0.1111111111111111,0.6666666666666666,0.0,0.0
Nail-patella-like renal disease,27551,10,6,23,6,17,17,4,13,1.0,0.6666666666666666,0.2608695652173913,1.0,0.23529411764705882,0.6666666666666666
Hirschsprung disease-deafness-polydactyly syndrome,29484,11,2,24,2,22,20,0,20,1.0,0.0,0.08333333333333333,1.0,0.0,0.0
Hirschsprung disease-type D brachydactyly syndrome,29999,2,2,18,2,16,16,0,16,1.0,0.0,0.1111111111111111,1.0,0.0,0.0
Hennekam syndrome,31425,2,18,23,2,21,26,2,24,0.1111111111111111,0.1111111111111111,0.08695652173913043,0.1111111111111111,0.07692307692307693,0.1111111111111111
X-linked intellectual disability-epilepsy-progressive joint contractures-dysmorphism syndrome,32558,8,0,21,0,21,29,0,29,0.0,0.0,0.0,0.0,0.0,0.0
Isolated arrhinia,33224,1,0,20,0,20,12,0,12,0.0,0.0,0.0,0.0,0.0,0.0
Shprintzen-Goldberg syndrome,28538,3,14,22,6,16,70,4,66,0.42857142857142855,0.2857142857142857,0.2727272727272727,0.42857142857142855,0.05714285714285714,0.2857142857142857
MOMO syndrome,27713,0,1,18,0,18,31,0,31,0.0,0.0,0.0,0.0,0.0,0.0
Lethal Kniest-like dysplasia,28026,0,0,61,0,61,21,0,21,0.0,0.0,0.0,0.0,0.0,0.0
Melnick-Needles syndrome,31600,0,11,26,7,19,30,0,30,0.6363636363636364,0.0,0.2692307692307692,0.6363636363636364,0.0,0.0
Melorheostosis,29790,3,12,19,12,7,25,4,21,1.0,0.3333333333333333,0.631578947368421,1.0,0.16,0.3333333333333333
Marshall-Smith syndrome,29367,0,11,19,4,15,15,0,15,0.36363636363636365,0.0,0.21052631578947367,0.36363636363636365,0.0,0.0
Matthew-Wood syndrome,30311,0,3,18,1,17,16,0,16,0.3333333333333333,0.0,0.05555555555555555,0.3333333333333333,0.0,0.0
Bifid uvula,31121,3,1,19,1,18,31,0,31,1.0,0.0,0.05263157894736842,1.0,0.0,0.0
Juberg-Hayward syndrome,28696,2,4,28,3,25,27,0,27,0.75,0.0,0.10714285714285714,0.75,0.0,0.0
Kapur-Toriello syndrome,31290,1,8,19,5,14,31,1,30,0.625,0.125,0.2631578947368421,0.625,0.03225806451612903,0.125
Mitochondrial neurogastrointestinal encephalomyopathy,32417,0,14,24,1,23,27,2,25,0.07142857142857142,0.14285714285714285,0.041666666666666664,0.07142857142857142,0.07407407407407407,0.14285714285714285
Chronic graft versus host disease,32520,1,3,21,0,21,19,0,19,0.0,0.0,0.0,0.0,0.0,0.0
Pleural mesothelioma,30725,3,1,20,1,19,28,0,28,1.0,0.0,0.05,1.0,0.0,0.0
Müllerian derivatives-lymphangiectasia-polydactyly syndrome,29432,1,39,41,32,9,19,0,19,0.8205128205128205,0.0,0.7804878048780488,0.8205128205128205,0.0,0.0
Arnold-Chiari malformation type I,31379,5,5,62,6,56,27,3,24,1.2,0.6,0.0967741935483871,1.2,0.1111111111111111,0.6
Restrictive dermopathy,29066,1,42,26,19,7,13,1,12,0.4523809523809524,0.023809523809523808,0.7307692307692307,0.4523809523809524,0.07692307692307693,0.023809523809523808
Wrinkly skin syndrome,27675,0,53,21,13,8,20,0,20,0.24528301886792453,0.0,0.6190476190476191,0.24528301886792453,0.0,0.0
Distal deletion 15q syndrome,33436,2,2,17,1,16,21,0,21,0.5,0.0,0.058823529411764705,0.5,0.0,0.0
Turner syndrome due to structural X chromosome anomalies,32829,5,21,25,9,16,28,5,23,0.42857142857142855,0.23809523809523808,0.36,0.42857142857142855,0.17857142857142858,0.23809523809523808
Mosaic monosomy X syndrome,32637,2,21,24,7,17,40,6,34,0.3333333333333333,0.2857142857142857,0.2916666666666667,0.3333333333333333,0.15,0.2857142857142857
X-linked spasticity-intellectual disability-epilepsy syndrome,28704,14,7,23,4,19,21,4,17,0.5714285714285714,0.5714285714285714,0.17391304347826086,0.5714285714285714,0.19047619047619047,0.5714285714285714
Denys-Drash syndrome,31013,6,5,18,5,13,24,1,23,1.0,0.2,0.2777777777777778,1.0,0.041666666666666664,0.2
Danon disease,36778,14,6,30,1,29,23,0,23,0.16666666666666666,0.0,0.03333333333333333,0.16666666666666666,0.0,0.0
De Barsy syndrome,27798,0,52,54,43,11,38,0,38,0.8269230769230769,0.0,0.7962962962962963,0.8269230769230769,0.0,0.0
Hemangioblastoma,32188,3,8,15,9,6,31,4,27,1.125,0.5,0.6,1.125,0.12903225806451613,0.5
Thymic neuroendocrine tumor,95096,20,4,28,0,28,23,0,23,0.0,0.0,0.0,0.0,0.0,0.0
Wiedemann-Rautenstrauch syndrome,30429,2,31,141,27,114,23,0,23,0.8709677419354839,0.0,0.19148936170212766,0.8709677419354839,0.0,0.0
"Heart-hand syndrome, Slovenian type",31419,1,6,13,5,8,28,1,27,0.8333333333333334,0.16666666666666666,0.38461538461538464,0.8333333333333334,0.03571428571428571,0.16666666666666666
Congenital enterocyte heparan sulfate deficiency,33360,4,5,16,3,13,28,2,26,0.6,0.4,0.1875,0.6,0.07142857142857142,0.4
Patent ductus arteriosus-bicuspid aortic valve-hand anomalies syndrome,27701,4,7,18,8,10,37,2,35,1.1428571428571428,0.2857142857142857,0.4444444444444444,1.1428571428571428,0.05405405405405406,0.2857142857142857
Hyperinsulinism due to short chain 3-hydroxylacyl-CoA dehydrogenase deficiency,33397,2,20,19,12,7,28,1,27,0.6,0.05,0.631578947368421,0.6,0.03571428571428571,0.05
Gray platelet syndrome,31205,2,4,17,4,13,31,4,27,1.0,1.0,0.23529411764705882,1.0,0.12903225806451613,1.0
Atrial septal defect-atrioventricular conduction defects syndrome,28295,1,3,18,5,13,23,1,22,1.6666666666666667,0.3333333333333333,0.2777777777777778,1.6666666666666667,0.043478260869565216,0.3333333333333333
Meacham syndrome,31400,0,6,18,0,18,18,0,18,0.0,0.0,0.0,0.0,0.0,0.0
Microcephaly-albinism-digital anomalies syndrome,29753,9,8,26,6,20,28,2,26,0.75,0.25,0.23076923076923078,0.75,0.07142857142857142,0.25
Microbrachycephaly-ptosis-cleft lip syndrome,29673,4,34,20,13,7,28,6,22,0.38235294117647056,0.17647058823529413,0.65,0.38235294117647056,0.21428571428571427,0.17647058823529413
Microcephaly-cardiomyopathy syndrome,31468,5,4,18,3,15,24,3,21,0.75,0.75,0.16666666666666666,0.75,0.125,0.75
Blindness-scoliosis-arachnodactyly syndrome,32292,4,4,19,3,16,30,2,28,0.75,0.5,0.15789473684210525,0.75,0.06666666666666667,0.5
Glycogen storage disease due to hepatic glycogen synthase deficiency,28161,1,0,17,0,17,23,0,23,0.0,0.0,0.0,0.0,0.0,0.0
Leri pleonosteosis,27912,0,15,19,8,11,21,0,21,0.5333333333333333,0.0,0.42105263157894735,0.5333333333333333,0.0,0.0
Polydactyly-myopia syndrome,29088,2,2,18,1,17,33,1,32,0.5,0.5,0.05555555555555555,0.5,0.030303030303030304,0.5
Orofaciodigital syndrome type 4,27672,0,42,27,12,15,17,1,16,0.2857142857142857,0.023809523809523808,0.4444444444444444,0.2857142857142857,0.058823529411764705,0.023809523809523808
Pitt-Hopkins syndrome,38983,9,45,27,5,22,23,3,20,0.1111111111111111,0.06666666666666667,0.18518518518518517,0.1111111111111111,0.13043478260869565,0.06666666666666667
Marden-Walker syndrome,30945,0,28,33,12,21,26,2,24,0.42857142857142855,0.07142857142857142,0.36363636363636365,0.42857142857142855,0.07692307692307693,0.07142857142857142
Osteosclerotic bone dysplasia,38177,15,11,27,0,27,16,0,16,0.0,0.0,0.0,0.0,0.0,0.0
Marinesco-Sjögren syndrome,99505,12,20,37,0,37,17,0,17,0.0,0.0,0.0,0.0,0.0,0.0
Palmoplantar keratoderma-spastic paralysis syndrome,33538,2,10,16,9,7,29,1,28,0.9,0.1,0.5625,0.9,0.034482758620689655,0.1
Palmoplantar keratoderma-deafness syndrome,29543,12,3,26,2,24,39,0,39,0.6666666666666666,0.0,0.07692307692307693,0.6666666666666666,0.0,0.0
Autosomal dominant epidermolytic ichthyosis,38946,16,7,24,3,21,24,4,20,0.42857142857142855,0.5714285714285714,0.125,0.42857142857142855,0.16666666666666666,0.5714285714285714
Palmoplantar keratoderma-esophageal carcinoma syndrome,30179,5,5,20,6,14,27,4,23,1.2,0.8,0.3,1.2,0.14814814814814814,0.8
Epidermolysis bullosa simplex with muscular dystrophy,27434,2,12,25,3,22,25,0,25,0.25,0.0,0.12,0.25,0.0,0.0
Hydrolethalus,29931,0,8,24,6,18,35,0,35,0.75,0.0,0.25,0.75,0.0,0.0
Arthrochalasia Ehlers-Danlos syndrome,28563,1,18,19,6,13,21,0,21,0.3333333333333333,0.0,0.3157894736842105,0.3333333333333333,0.0,0.0
Dermatosparaxis Ehlers-Danlos syndrome,27624,5,28,26,11,15,33,2,31,0.39285714285714285,0.07142857142857142,0.4230769230769231,0.39285714285714285,0.06060606060606061,0.07142857142857142
Thumb deformity-alopecia-pigmentation anomaly syndrome,29692,3,5,22,3,19,24,1,23,0.6,0.2,0.13636363636363635,0.6,0.041666666666666664,0.2
Hyposmia-nasal and ocular hypoplasia-hypogonadotropic hypogonadism syndrome,33507,0,14,17,9,8,23,2,21,0.6428571428571429,0.14285714285714285,0.5294117647058824,0.6428571428571429,0.08695652173913043,0.14285714285714285
Ulna hypoplasia-intellectual disability syndrome,30575,2,18,26,21,5,37,2,35,1.1666666666666667,0.1111111111111111,0.8076923076923077,1.1666666666666667,0.05405405405405406,0.1111111111111111
Hypertrichosis cubiti,29153,0,6,25,1,24,6,0,6,0.16666666666666666,0.0,0.04,0.16666666666666666,0.0,0.0
Cervical hypertrichosis-peripheral neuropathy syndrome,30000,9,3,18,2,16,38,0,38,0.6666666666666666,0.0,0.1111111111111111,0.6666666666666666,0.0,0.0
Hypertelorism-microtia-facial clefting syndrome,29319,2,5,28,3,25,40,3,37,0.6,0.6,0.10714285714285714,0.6,0.075,0.6
Hypertelorism-hypospadias-polysyndactyly syndrome,31233,2,15,34,12,22,32,3,29,0.8,0.2,0.35294117647058826,0.8,0.09375,0.2
Ankylosing vertebral hyperostosis with tylosis,33335,1,3,20,2,18,23,2,21,0.6666666666666666,0.6666666666666666,0.1,0.6666666666666666,0.08695652173913043,0.6666666666666666
Congenital patella dislocation,33356,8,1,14,1,13,22,1,21,1.0,1.0,0.07142857142857142,1.0,0.045454545454545456,1.0
Adenosine monophosphate deaminase deficiency,27667,0,5,18,7,11,13,0,13,1.4,0.0,0.3888888888888889,1.4,0.0,0.0
Acitretin/etretinate embryopathy,32239,0,1,22,0,22,39,0,39,0.0,0.0,0.0,0.0,0.0,0.0
Carnitine-acylcarnitine translocase deficiency,31976,5,20,18,9,9,30,6,24,0.45,0.3,0.5,0.45,0.2,0.3
Pudendal nerve entrapment syndrome,27690,5,10,25,5,20,23,3,20,0.5,0.3,0.2,0.5,0.13043478260869565,0.3
Double uterus-hemivagina-renal agenesis syndrome,28216,0,12,12,11,1,24,2,22,0.9166666666666666,0.16666666666666666,0.9166666666666666,0.9166666666666666,0.08333333333333333,0.16666666666666666
W syndrome,38849,9,25,42,0,42,32,0,32,0.0,0.0,0.0,0.0,0.0,0.0
DDOST-CDG,30268,0,19,18,14,4,22,1,21,0.7368421052631579,0.05263157894736842,0.7777777777777778,0.7368421052631579,0.045454545454545456,0.05263157894736842
XK aprosencephaly syndrome,30599,3,3,21,2,19,41,2,39,0.6666666666666666,0.6666666666666666,0.09523809523809523,0.6666666666666666,0.04878048780487805,0.6666666666666666
Lateral meningocele syndrome,30158,0,14,19,4,15,3,0,3,0.2857142857142857,0.0,0.21052631578947367,0.2857142857142857,0.0,0.0
X-linked sideroblastic anemia and spinocerebellar ataxia,30154,4,6,18,3,15,22,2,20,0.5,0.3333333333333333,0.16666666666666666,0.5,0.09090909090909091,0.3333333333333333
Björnstad syndrome,31383,2,3,17,2,15,29,0,29,0.6666666666666666,0.0,0.11764705882352941,0.6666666666666666,0.0,0.0
Acquired hypertrichosis lanuginosa,33530,2,6,17,5,12,12,0,12,0.8333333333333334,0.0,0.29411764705882354,0.8333333333333334,0.0,0.0
Kallmann syndrome-heart disease syndrome,33051,3,3,20,1,19,25,1,24,0.3333333333333333,0.3333333333333333,0.05,0.3333333333333333,0.04,0.3333333333333333
Familial pancreatic carcinoma,29050,5,8,16,6,10,21,3,18,0.75,0.375,0.375,0.75,0.14285714285714285,0.375
Congenital aortic valve stenosis,32802,6,3,19,2,17,21,2,19,0.6666666666666666,0.6666666666666666,0.10526315789473684,0.6666666666666666,0.09523809523809523,0.6666666666666666
Ring chromosome 22 syndrome,32376,0,0,31,0,31,30,0,30,0.0,0.0,0.0,0.0,0.0,0.0
Early-onset autosomal dominant Alzheimer disease,28780,5,15,23,6,17,28,3,25,0.4,0.2,0.2608695652173913,0.4,0.10714285714285714,0.2
DNAJB6-related limb-girdle muscular dystrophy D1,30310,2,1,19,1,18,22,0,22,1.0,0.0,0.05263157894736842,1.0,0.0,0.0
Myoclonus-dystonia syndrome,33386,10,4,28,5,23,32,2,30,1.25,0.5,0.17857142857142858,1.25,0.0625,0.5
Lambert-Eaton myasthenic syndrome,33451,6,7,26,8,18,20,0,20,1.1428571428571428,0.0,0.3076923076923077,1.1428571428571428,0.0,0.0
Inclusion body myopathy with Paget disease of bone and frontotemporal dementia,28751,0,9,24,4,20,21,0,21,0.4444444444444444,0.0,0.16666666666666666,0.4444444444444444,0.0,0.0
Partial deletion of the short arm of chromosome 8 syndrome,39324,20,0,59,0,59,30,0,30,0.0,0.0,0.0,0.0,0.0,0.0
Trisomy 8p syndrome,32953,1,0,17,0,17,37,0,37,0.0,0.0,0.0,0.0,0.0,0.0
Dopa-responsive dystonia due to sepiapterin reductase deficiency,27441,4,0,20,0,20,31,0,31,0.0,0.0,0.0,0.0,0.0,0.0
Distal duplication 5q syndrome,38415,10,2,31,1,30,26,2,24,0.5,1.0,0.03225806451612903,0.5,0.07692307692307693,1.0
Spinal muscular atrophy-Dandy-Walker malformation-cataracts syndrome,32247,10,7,25,8,17,30,1,29,1.1428571428571428,0.14285714285714285,0.32,1.1428571428571428,0.03333333333333333,0.14285714285714285
Combined immunodeficiency-enteropathy spectrum,38553,13,4,30,0,30,24,0,24,0.0,0.0,0.0,0.0,0.0,0.0
X-linked intellectual disability-plagiocephaly syndrome,28823,2,0,14,0,14,38,0,38,0.0,0.0,0.0,0.0,0.0,0.0
SCARF syndrome,28136,0,0,36,0,36,29,0,29,0.0,0.0,0.0,0.0,0.0,0.0
Ulnar-mammary syndrome,30503,0,5,19,3,16,21,0,21,0.6,0.0,0.15789473684210525,0.6,0.0,0.0
Hereditary hyperekplexia,27484,3,13,24,11,13,23,6,17,0.8461538461538461,0.46153846153846156,0.4583333333333333,0.8461538461538461,0.2608695652173913,0.46153846153846156
Stimmler syndrome,30523,0,9,17,7,10,19,0,19,0.7777777777777778,0.0,0.4117647058823529,0.7777777777777778,0.0,0.0
"Deaf blind hypopigmentation syndrome, Yemenite type",27918,0,10,13,0,13,38,5,33,0.0,0.5,0.0,0.0,0.13157894736842105,0.5
Tetramelic monodactyly,29581,6,2,25,1,24,22,0,22,0.5,0.0,0.04,0.5,0.0,0.0
Microcephaly-cleft palate-abnormal retinal pigmentation syndrome,32767,3,4,25,3,22,29,2,27,0.75,0.5,0.12,0.75,0.06896551724137931,0.5
Infantile epileptic spasms syndrome,39077,5,4,54,1,53,30,2,28,0.25,0.5,0.018518518518518517,0.25,0.06666666666666667,0.5
"Oculocerebrofacial syndrome, Kaufman type",30909,0,16,17,4,13,9,0,9,0.25,0.0,0.23529411764705882,0.25,0.0,0.0
"Autosomal recessive cutis laxa type 2, classic type",27841,7,43,30,15,15,29,1,28,0.3488372093023256,0.023255813953488372,0.5,0.3488372093023256,0.034482758620689655,0.023255813953488372
Neuhauser-Eichner-Opitz syndrome,98826,0,5,6,0,6,32,0,32,0.0,0.0,0.0,0.0,0.0,0.0
Port-wine nevi-mega cisterna magna-hydrocephalus syndrome,98778,15,8,30,0,30,30,0,30,0.0,0.0,0.0,0.0,0.0,0.0
"Blepharophimosis-intellectual disability syndrome, Ohdo type",35826,0,22,26,6,20,17,3,14,0.2727272727272727,0.13636363636363635,0.23076923076923078,0.2727272727272727,0.17647058823529413,0.13636363636363635
Imperforate oropharynx-costovertebral anomalies syndrome,32391,3,14,26,15,11,21,3,18,1.0714285714285714,0.21428571428571427,0.5769230769230769,1.0714285714285714,0.14285714285714285,0.21428571428571427
Postaxial tetramelic oligodactyly,29948,3,4,17,3,14,18,0,18,0.75,0.0,0.17647058823529413,0.75,0.0,0.0
Digital extensor muscle aplasia-polyneuropathy,27875,0,6,18,6,12,25,0,25,1.0,0.0,0.3333333333333333,1.0,0.0,0.0
Ptosis-vocal cord paralysis syndrome,29904,8,4,28,4,24,27,0,27,1.0,0.0,0.14285714285714285,1.0,0.0,0.0
"Familial osteodysplasia, Anderson type",32383,0,24,17,13,4,16,0,16,0.5416666666666666,0.0,0.7647058823529411,0.5416666666666666,0.0,0.0
Renal caliceal diverticuli-deafness syndrome,32430,9,3,23,3,20,28,0,28,1.0,0.0,0.13043478260869565,1.0,0.0,0.0
Wilson-Turner syndrome,27809,1,22,18,9,9,30,0,30,0.4090909090909091,0.0,0.5,0.4090909090909091,0.0,0.0
Absent radius-anogenital anomalies syndrome,30195,2,5,16,4,12,36,1,35,0.8,0.2,0.25,0.8,0.027777777777777776,0.2
Radio-renal syndrome,30731,1,24,25,19,6,17,1,16,0.7916666666666666,0.041666666666666664,0.76,0.7916666666666666,0.058823529411764705,0.041666666666666664
Microgastria-limb reduction defect syndrome,28114,1,10,52,7,45,32,1,31,0.7,0.1,0.1346153846153846,0.7,0.03125,0.1
VACTERL with hydrocephalus,28762,3,12,18,4,14,22,4,18,0.3333333333333333,0.3333333333333333,0.2222222222222222,0.3333333333333333,0.18181818181818182,0.3333333333333333
Tremor-nystagmus-duodenal ulcer syndrome,29154,8,3,27,4,23,25,1,24,1.3333333333333333,0.3333333333333333,0.14814814814814814,1.3333333333333333,0.04,0.3333333333333333
Extensor tendons of finger anomalies,29251,1,3,13,2,11,12,0,12,0.6666666666666666,0.0,0.15384615384615385,0.6666666666666666,0.0,0.0
Classic Hodgkin lymphoma,33077,4,4,17,3,14,20,1,19,0.75,0.25,0.17647058823529413,0.75,0.05,0.25
Inherited Creutzfeldt-Jakob disease,32477,5,0,28,0,28,22,0,22,0.0,0.0,0.0,0.0,0.0,0.0
SHORT syndrome,27483,1,6,17,1,16,34,0,34,0.16666666666666666,0.0,0.058823529411764705,0.16666666666666666,0.0,0.0
Neuroectodermal melanolysosomal disease,95816,18,9,39,1,38,33,1,32,0.1111111111111111,0.1111111111111111,0.02564102564102564,0.1111111111111111,0.030303030303030304,0.1111111111111111
Anophthalmia-megalocornea-cardiopathy-skeletal anomalies syndrome,33240,3,0,19,0,19,30,0,30,0.0,0.0,0.0,0.0,0.0,0.0
Ogden syndrome,30624,0,0,57,0,57,34,0,34,0.0,0.0,0.0,0.0,0.0,0.0
Proximal myopathy with extrapyramidal signs,27666,3,0,19,0,19,27,0,27,0.0,0.0,0.0,0.0,0.0,0.0
Hereditary myopathy with early respiratory failure,30168,2,0,22,0,22,22,0,22,0.0,0.0,0.0,0.0,0.0,0.0
Congenital muscular dystrophy-respiratory failure-skin abnormalities-joint hyperlaxity syndrome,29690,2,4,31,4,27,23,1,22,1.0,0.25,0.12903225806451613,1.0,0.043478260869565216,0.25
Autosomal dominant Emery-Dreifuss muscular dystrophy,27738,4,7,39,4,35,26,0,26,0.5714285714285714,0.0,0.10256410256410256,0.5714285714285714,0.0,0.0
Autosomal recessive Emery-Dreifuss muscular dystrophy,27738,4,7,19,3,16,24,1,23,0.42857142857142855,0.14285714285714285,0.15789473684210525,0.42857142857142855,0.041666666666666664,0.14285714285714285
X-linked Emery-Dreifuss muscular dystrophy,27674,3,7,23,2,21,29,1,28,0.2857142857142857,0.14285714285714285,0.08695652173913043,0.2857142857142857,0.034482758620689655,0.14285714285714285
Pontocerebellar hypoplasia type 10,27716,2,4,38,1,37,14,0,14,0.25,0.0,0.02631578947368421,0.25,0.0,0.0
Autosomal recessive centronuclear myopathy,29888,4,0,47,0,47,23,0,23,0.0,0.0,0.0,0.0,0.0,0.0
Autosomal dominant Charcot-Marie-Tooth disease type 2K,29098,2,0,27,0,27,21,0,21,0.0,0.0,0.0,0.0,0.0,0.0
FKRP-related limb-girdle muscular dystrophy R9,30310,4,4,19,2,17,29,1,28,0.5,0.25,0.10526315789473684,0.5,0.034482758620689655,0.25
Cap myopathy,33498,0,0,17,0,17,18,0,18,0.0,0.0,0.0,0.0,0.0,0.0
KAT6-related intellectual disability-craniofacial anomalies-cardiac defects syndrome,98748,18,10,27,2,25,45,1,44,0.2,0.1,0.07407407407407407,0.2,0.022222222222222223,0.1
Wiedemann-Steiner syndrome,30199,2,1,53,1,52,21,0,21,1.0,0.0,0.018867924528301886,1.0,0.0,0.0
GMPPB-related limb-girdle muscular dystrophy R19,27315,10,0,29,0,29,29,0,29,0.0,0.0,0.0,0.0,0.0,0.0
Moderate multiminicore disease with hand involvement,32818,2,0,16,0,16,16,0,16,0.0,0.0,0.0,0.0,0.0,0.0
Antenatal multiminicore disease with arthrogryposis multiplex congenita,32819,0,0,18,0,18,19,0,19,0.0,0.0,0.0,0.0,0.0,0.0
CLN12 disease,29506,6,1,26,0,26,30,0,30,0.0,0.0,0.0,0.0,0.0,0.0
Severe congenital nemaline myopathy,27294,3,0,126,0,126,12,0,12,0.0,0.0,0.0,0.0,0.0,0.0
Typical nemaline myopathy,27294,5,0,124,0,124,17,0,17,0.0,0.0,0.0,0.0,0.0,0.0
Classic multiminicore myopathy,28689,0,1,13,0,13,21,0,21,0.0,0.0,0.0,0.0,0.0,0.0
Caribbean parkinsonism,27682,5,3,20,3,17,33,3,30,1.0,1.0,0.15,1.0,0.09090909090909091,1.0
Cranio-cervical dystonia with laryngeal and upper-limb involvement,38345,8,0,30,0,30,29,0,29,0.0,0.0,0.0,0.0,0.0,0.0
Cirrhosis-dystonia-polycythemia-hypermanganesemia syndrome,30577,1,0,28,0,28,37,0,37,0.0,0.0,0.0,0.0,0.0,0.0
Oromandibular dystonia,32613,4,0,17,0,17,31,0,31,0.0,0.0,0.0,0.0,0.0,0.0
Hereditary late-onset Parkinson disease,27576,6,1,43,2,41,24,0,24,2.0,0.0,0.046511627906976744,2.0,0.0,0.0
X-linked parkinsonism-spasticity syndrome,31408,3,2,16,2,14,25,1,24,1.0,0.5,0.125,1.0,0.04,0.5
Parkinsonian-pyramidal syndrome,30093,7,2,19,2,17,28,0,28,1.0,0.0,0.10526315789473684,1.0,0.0,0.0
Infantile dystonia-parkinsonism,29875,6,2,40,2,38,30,1,29,1.0,0.5,0.05,1.0,0.03333333333333333,0.5
Calpain-3-related limb-girdle muscular dystrophy R1,84272,17,1,20,0,20,21,0,21,0.0,0.0,0.0,0.0,0.0,0.0
Beta-sarcoglycan-related limb-girdle muscular dystrophy R4,39236,16,0,20,0,20,22,0,22,0.0,0.0,0.0,0.0,0.0,0.0
Paroxysmal dystonic choreathetosis with episodic ataxia and spasticity,31507,3,1,99,0,99,23,0,23,0.0,0.0,0.0,0.0,0.0,0.0
Congenital muscular dystrophy without intellectual disability,29208,1,1,84,0,84,21,0,21,0.0,0.0,0.0,0.0,0.0,0.0
Autosomal dominant centronuclear myopathy,29888,3,1,48,0,48,31,0,31,0.0,0.0,0.0,0.0,0.0,0.0
Juvenile myoclonic epilepsy,99971,19,3,28,1,27,23,1,22,0.3333333333333333,0.3333333333333333,0.03571428571428571,0.3333333333333333,0.043478260869565216,0.3333333333333333
POMT1-related limb-girdle muscular dystrophy R11,29368,9,2,18,1,17,26,0,26,0.5,0.0,0.05555555555555555,0.5,0.0,0.0
Microform holoprosencephaly,32418,0,3,20,2,18,21,0,21,0.6666666666666666,0.0,0.1,0.6666666666666666,0.0,0.0
Charcot-Marie-Tooth disease type 1B,27530,5,1,32,1,31,20,0,20,1.0,0.0,0.03125,1.0,0.0,0.0
Charcot-Marie-Tooth disease type 1A,27530,5,0,20,0,20,22,0,22,0.0,0.0,0.0,0.0,0.0,0.0
X-linked intellectual disability-hypotonia-movement disorder syndrome,33463,4,1,19,2,17,23,1,22,2.0,1.0,0.10526315789473684,2.0,0.043478260869565216,1.0
Alpha-sarcoglycan-related limb-girdle muscular dystrophy R3,39236,18,0,27,0,27,25,0,25,0.0,0.0,0.0,0.0,0.0,0.0
Amish nemaline myopathy,27294,4,0,125,0,125,16,0,16,0.0,0.0,0.0,0.0,0.0,0.0
Congenital myasthenic syndrome,33062,2,10,35,2,33,23,3,20,0.2,0.3,0.05714285714285714,0.2,0.13043478260869565,0.3
Tibial muscular dystrophy,27375,2,0,17,0,17,26,0,26,0.0,0.0,0.0,0.0,0.0,0.0
Malignant hyperthermia of anesthesia,33459,6,0,17,0,17,32,0,32,0.0,0.0,0.0,0.0,0.0,0.0
NARP syndrome,27782,2,0,17,0,17,29,0,29,0.0,0.0,0.0,0.0,0.0,0.0
Paramyotonia congenita of Von Eulenburg,27349,2,0,18,0,18,16,0,16,0.0,0.0,0.0,0.0,0.0,0.0
Intermediate nemaline myopathy,27294,3,3,124,3,121,17,0,17,1.0,0.0,0.024193548387096774,1.0,0.0,0.0
Congenital myopathy with myasthenic-like onset,27781,1,1,17,1,16,17,0,17,1.0,0.0,0.058823529411764705,1.0,0.0,0.0
Neuronal intestinal pseudoobstruction,30090,1,5,16,4,12,20,0,20,0.8,0.0,0.25,0.8,0.0,0.0
Hereditary sensory and autonomic neuropathy type 5,27625,3,0,24,0,24,41,0,41,0.0,0.0,0.0,0.0,0.0,0.0
Delta-sarcoglycan-related limb-girdle muscular dystrophy R6,39236,16,0,27,0,27,21,0,21,0.0,0.0,0.0,0.0,0.0,0.0
Benign Samaritan congenital myopathy,32794,0,5,16,4,12,28,0,28,0.8,0.0,0.25,0.8,0.0,0.0
Amyotrophic lateral sclerosis type 4,29371,1,0,19,0,19,19,0,19,0.0,0.0,0.0,0.0,0.0,0.0
Spinocerebellar ataxia type 42,27402,6,4,8,1,7,9,1,8,0.25,0.25,0.125,0.25,0.1111111111111111,0.25
Hemidystonia-hemiatrophy syndrome,32878,1,4,19,4,15,25,1,24,1.0,0.25,0.21052631578947367,1.0,0.04,0.25
Spinocerebellar ataxia type 10,27402,7,3,9,1,8,11,1,10,0.3333333333333333,0.3333333333333333,0.1111111111111111,0.3333333333333333,0.09090909090909091,0.3333333333333333
Autosomal recessive spastic paraplegia type 15,39424,15,1,36,0,36,32,0,32,0.0,0.0,0.0,0.0,0.0,0.0
Autosomal dominant spastic paraplegia type 17,38455,6,0,24,0,24,22,0,22,0.0,0.0,0.0,0.0,0.0,0.0
Recessive mitochondrial ataxia syndrome,32303,4,0,18,0,18,30,0,30,0.0,0.0,0.0,0.0,0.0,0.0
Ataxia-telangiectasia-like disorder,30466,2,1,17,1,16,20,2,18,1.0,2.0,0.058823529411764705,1.0,0.1,2.0
Autosomal recessive spastic paraplegia type 20,39424,9,0,19,0,19,32,0,32,0.0,0.0,0.0,0.0,0.0,0.0
Autosomal recessive spastic paraplegia type 21,39424,7,3,18,1,17,26,1,25,0.3333333333333333,0.3333333333333333,0.05555555555555555,0.3333333333333333,0.038461538461538464,0.3333333333333333
Autosomal recessive spastic paraplegia type 23,39424,20,0,24,0,24,25,0,25,0.0,0.0,0.0,0.0,0.0,0.0
Autosomal recessive spastic paraplegia type 24,39424,11,6,12,0,12,26,0,26,0.0,0.0,0.0,0.0,0.0,0.0
Autosomal recessive spastic paraplegia type 26,39424,14,0,31,0,31,28,0,28,0.0,0.0,0.0,0.0,0.0,0.0
Autosomal recessive spastic paraplegia type 27,39424,18,5,33,0,33,30,0,30,0.0,0.0,0.0,0.0,0.0,0.0
Spinocerebellar ataxia type 4,29145,4,4,18,0,18,17,0,17,0.0,0.0,0.0,0.0,0.0,0.0
Spinocerebellar ataxia type 15/16,27402,3,1,32,2,30,5,1,4,2.0,1.0,0.0625,2.0,0.2,1.0
Spinocerebellar ataxia type 13,27402,6,0,23,0,23,14,0,14,0.0,0.0,0.0,0.0,0.0,0.0
Autosomal dominant cerebellar ataxia-deafness-narcolepsy syndrome,29925,2,2,29,1,28,6,1,5,0.5,0.5,0.034482758620689655,0.5,0.16666666666666666,0.5
Spinocerebellar ataxia type 18,27402,6,4,6,0,6,12,0,12,0.0,0.0,0.0,0.0,0.0,0.0
Childhood-onset spasticity with hyperglycinemia,27211,2,2,31,2,29,34,1,33,1.0,0.5,0.06451612903225806,1.0,0.029411764705882353,0.5
Spinocerebellar ataxia type 40,27402,7,0,19,0,19,14,0,14,0.0,0.0,0.0,0.0,0.0,0.0
Tremor-ataxia-central hypomyelination syndrome,33516,2,0,35,0,35,5,0,5,0.0,0.0,0.0,0.0,0.0,0.0
Primary progressive freezing gait,33138,3,3,18,3,15,33,1,32,1.0,0.3333333333333333,0.16666666666666666,1.0,0.030303030303030304,0.3333333333333333
X-linked non progressive cerebellar ataxia,27395,3,1,17,1,16,12,0,12,1.0,0.0,0.058823529411764705,1.0,0.0,0.0
X-linked progressive cerebellar ataxia,27395,2,1,17,0,17,17,0,17,0.0,0.0,0.0,0.0,0.0,0.0
Huntington disease-like 1,38307,16,1,24,0,24,18,0,18,0.0,0.0,0.0,0.0,0.0,0.0
Huntington disease-like 2,38307,16,0,18,0,18,17,0,17,0.0,0.0,0.0,0.0,0.0,0.0
Autosomal recessive spastic paraplegia type 75,27668,1,9,15,4,11,23,1,22,0.4444444444444444,0.1111111111111111,0.26666666666666666,0.4444444444444444,0.043478260869565216,0.1111111111111111
Hemiparkinsonism-hemiatrophy syndrome,32759,2,0,15,0,15,27,0,27,0.0,0.0,0.0,0.0,0.0,0.0
Presynaptic congenital myasthenic syndromes,27760,4,10,62,9,53,28,5,23,0.9,0.5,0.14516129032258066,0.9,0.17857142857142858,0.5
Postsynaptic congenital myasthenic syndromes,33062,4,0,35,0,35,33,0,33,0.0,0.0,0.0,0.0,0.0,0.0
"Cerebellar ataxia, Cayman type",27352,2,1,17,1,16,12,0,12,1.0,0.0,0.058823529411764705,1.0,0.0,0.0
Autosomal recessive ataxia due to PEX10 deficiency,27817,8,2,17,0,17,28,0,28,0.0,0.0,0.0,0.0,0.0,0.0
Gamma-sarcoglycan-related limb-girdle muscular dystrophy R5,39236,15,0,22,0,22,21,0,21,0.0,0.0,0.0,0.0,0.0,0.0
Synaptic congenital myasthenic syndromes,33061,2,3,51,3,48,21,0,21,1.0,0.0,0.058823529411764705,1.0,0.0,0.0
Anoctamin-5-related limb-girdle muscular dystrophy R12,30310,2,4,21,0,21,23,2,21,0.0,0.5,0.0,0.0,0.08695652173913043,0.5
Congenital multicore myopathy with external ophthalmoplegia,27213,2,0,21,0,21,30,0,30,0.0,0.0,0.0,0.0,0.0,0.0
Congenital myasthenic syndromes with glycosylation defect,33198,8,0,29,0,29,25,0,25,0.0,0.0,0.0,0.0,0.0,0.0
Autosomal dominant progressive external ophthalmoplegia,33290,5,2,27,1,26,25,2,23,0.5,1.0,0.037037037037037035,0.5,0.08,1.0
Autosomal recessive progressive external ophthalmoplegia,33290,4,0,30,0,30,28,0,28,0.0,0.0,0.0,0.0,0.0,0.0
Autosomal recessive spastic paraplegia type 54,38455,15,3,31,0,31,30,0,30,0.0,0.0,0.0,0.0,0.0,0.0
Autosomal recessive spastic paraplegia type 55,38455,17,0,34,0,34,28,0,28,0.0,0.0,0.0,0.0,0.0,0.0
Autosomal recessive spastic paraplegia type 43,38455,20,7,32,1,31,36,0,36,0.14285714285714285,0.0,0.03125,0.14285714285714285,0.0,0.0
Episodic ataxia type 7,27813,9,4,45,4,41,26,3,23,1.0,0.75,0.08888888888888889,1.0,0.11538461538461539,0.75
Autosomal recessive cerebellar ataxia-psychomotor delay syndrome,27739,1,9,19,5,14,20,5,15,0.5555555555555556,0.5555555555555556,0.2631578947368421,0.5555555555555556,0.25,0.5555555555555556
Autosomal recessive cerebellar ataxia-movement disorder syndrome,27739,0,9,20,7,13,13,0,13,0.7777777777777778,0.0,0.35,0.7777777777777778,0.0,0.0
Posterior column ataxia-retinitis pigmentosa syndrome,31638,3,3,46,5,41,15,3,12,1.6666666666666667,1.0,0.10869565217391304,1.6666666666666667,0.2,1.0
Autosomal recessive spastic paraplegia type 28,39424,20,2,36,0,36,33,0,33,0.0,0.0,0.0,0.0,0.0,0.0
Autosomal spastic paraplegia type 72,30156,3,2,20,0,20,20,0,20,0.0,0.0,0.0,0.0,0.0,0.0
Episodic ataxia with slurred speech,38156,8,3,9,1,8,16,1,15,0.3333333333333333,0.3333333333333333,0.1111111111111111,0.3333333333333333,0.0625,0.3333333333333333
Episodic ataxia type 5,27813,5,0,23,0,23,25,0,25,0.0,0.0,0.0,0.0,0.0,0.0
Autosomal recessive spastic paraplegia type 76,27668,2,3,17,3,14,33,0,33,1.0,0.0,0.17647058823529413,1.0,0.0,0.0
Autosomal recessive spastic paraplegia type 9B,39424,9,4,12,0,12,26,0,26,0.0,0.0,0.0,0.0,0.0,0.0
X-linked spastic paraplegia type 34,38801,18,0,28,0,28,33,0,33,0.0,0.0,0.0,0.0,0.0,0.0
Autosomal recessive spastic paraplegia type 62,27668,1,1,18,2,16,27,0,27,2.0,0.0,0.1111111111111111,2.0,0.0,0.0
Beta-propeller protein-associated neurodegeneration,29074,3,0,16,0,16,43,0,43,0.0,0.0,0.0,0.0,0.0,0.0
Spinocerebellar ataxia type 20,27402,6,1,22,1,21,14,1,13,1.0,1.0,0.045454545454545456,1.0,0.07142857142857142,1.0
Classic pantothenate kinase-associated neurodegeneration,28116,8,1,105,2,103,29,0,29,2.0,0.0,0.01904761904761905,2.0,0.0,0.0
Spastic paraplegia-neuropathy-poikiloderma syndrome,28013,0,0,19,0,19,29,0,29,0.0,0.0,0.0,0.0,0.0,0.0
"Primary dystonia, DYT21 type",27743,6,1,65,1,64,22,0,22,1.0,0.0,0.015384615384615385,1.0,0.0,0.0
Childhood-onset benign chorea with striatal involvement,27708,7,1,19,0,19,30,0,30,0.0,0.0,0.0,0.0,0.0,0.0
Atypical pantothenate kinase-associated neurodegeneration,28116,7,0,105,0,105,32,0,32,0.0,0.0,0.0,0.0,0.0,0.0
Postencephalitic parkinsonism,32468,5,1,24,1,23,19,0,19,1.0,0.0,0.041666666666666664,1.0,0.0,0.0
X-linked spinocerebellar ataxia type 4,29145,3,1,18,0,18,8,0,8,0.0,0.0,0.0,0.0,0.0,0.0
Autosomal recessive spastic ataxia of Charlevoix-Saguenay,31049,6,0,20,0,20,28,0,28,0.0,0.0,0.0,0.0,0.0,0.0
Delayed encephalopathy due to carbon monoxide poisoning,97084,22,5,25,0,25,26,0,26,0.0,0.0,0.0,0.0,0.0,0.0
Manganese poisoning,32704,1,15,18,11,7,22,1,21,0.7333333333333333,0.06666666666666667,0.6111111111111112,0.7333333333333333,0.045454545454545456,0.06666666666666667
"Primary dystonia, DYT6 type",27743,9,2,72,2,70,35,0,35,1.0,0.0,0.027777777777777776,1.0,0.0,0.0
"Primary dystonia, DYT4 type",27743,5,3,15,0,15,31,0,31,0.0,0.0,0.0,0.0,0.0,0.0
Severe motor and intellectual disabilities-sensorineural deafness-dystonia syndrome,30801,1,4,19,4,15,21,1,20,1.0,0.25,0.21052631578947367,1.0,0.047619047619047616,0.25
Semantic dementia,29468,0,5,17,2,15,6,0,6,0.4,0.0,0.11764705882352941,0.4,0.0,0.0
Cyanide-induced parkinsonism-dystonia,32700,5,0,17,0,17,17,0,17,0.0,0.0,0.0,0.0,0.0,0.0
Spinocerebellar ataxia type 23,27402,7,4,22,2,20,18,1,17,0.5,0.25,0.09090909090909091,0.5,0.05555555555555555,0.25
Spinocerebellar ataxia type 21,27402,2,4,23,1,22,4,0,4,0.25,0.0,0.043478260869565216,0.25,0.0,0.0
RIDDLE syndrome,30932,0,6,16,3,13,32,0,32,0.5,0.0,0.1875,0.5,0.0,0.0
Joubert syndrome with Jeune asphyxiating thoracic dystrophy,33081,0,0,67,0,67,1,0,1,0.0,0.0,0.0,0.0,0.0,0.0
Juvenile-onset diabetes mellitus-central and peripheral neurodegeneration syndrome,30777,2,0,17,0,17,15,0,15,0.0,0.0,0.0,0.0,0.0,0.0
Encephalitis lethargica,32753,3,2,18,1,17,33,0,33,0.5,0.0,0.05555555555555555,0.5,0.0,0.0
Rolandic epilepsy-paroxysmal exercise-induced dystonia-writer's cramp syndrome,31210,3,0,18,0,18,21,0,21,0.0,0.0,0.0,0.0,0.0,0.0
Spinocerebellar ataxia type 12,27402,9,0,20,0,20,19,0,19,0.0,0.0,0.0,0.0,0.0,0.0
Autosomal dominant spastic ataxia type 1,27721,7,4,91,6,85,17,0,17,1.5,0.0,0.06593406593406594,1.5,0.0,0.0
Autosomal dominant spastic paraplegia type 73,27668,1,6,15,4,11,34,0,34,0.6666666666666666,0.0,0.26666666666666666,0.6666666666666666,0.0,0.0
Autosomal dominant spastic paraplegia type 38,30156,3,8,22,4,18,23,1,22,0.5,0.125,0.18181818181818182,0.5,0.043478260869565216,0.125
Autosomal dominant spastic paraplegia type 41,38901,15,5,26,0,26,29,1,28,0.0,0.2,0.0,0.0,0.034482758620689655,0.2
Autosomal dominant spastic paraplegia type 42,38455,15,7,19,0,19,29,0,29,0.0,0.0,0.0,0.0,0.0,0.0
Autosomal dominant spastic paraplegia type 37,30156,2,2,23,0,23,28,0,28,0.0,0.0,0.0,0.0,0.0,0.0
Autosomal dominant spastic paraplegia type 19,30156,3,7,23,4,19,30,2,28,0.5714285714285714,0.2857142857142857,0.17391304347826086,0.5714285714285714,0.06666666666666667,0.2857142857142857
Autosomal dominant spastic paraplegia type 12,30156,2,6,22,3,19,31,1,30,0.5,0.16666666666666666,0.13636363636363635,0.5,0.03225806451612903,0.16666666666666666
Autosomal dominant spastic paraplegia type 8,38901,6,6,19,0,19,25,1,24,0.0,0.16666666666666666,0.0,0.0,0.04,0.16666666666666666
Autosomal recessive cerebellar ataxia-epilepsy-intellectual disability syndrome due to TUD deficiency,29856,7,3,23,3,20,26,1,25,1.0,0.3333333333333333,0.13043478260869565,1.0,0.038461538461538464,0.3333333333333333
Autosomal recessive cerebellar ataxia-epilepsy-intellectual disability syndrome due to WWOX deficiency,27803,7,7,24,1,23,28,3,25,0.14285714285714285,0.42857142857142855,0.041666666666666664,0.14285714285714285,0.10714285714285714,0.42857142857142855
Benign paroxysmal torticollis of infancy,32585,3,1,15,1,14,8,1,7,1.0,1.0,0.06666666666666667,1.0,0.125,1.0
Episodic ataxia type 1,38156,16,3,19,0,19,27,0,27,0.0,0.0,0.0,0.0,0.0,0.0
Episodic ataxia type 6,27813,5,4,32,3,29,34,5,29,0.75,1.25,0.09375,0.75,0.14705882352941177,1.25
Autosomal recessive spastic paraplegia type 44,38455,16,10,23,1,22,36,4,32,0.1,0.4,0.043478260869565216,0.1,0.1111111111111111,0.4
Dystonia-aphonia syndrome,33366,5,6,17,5,12,32,2,30,0.8333333333333334,0.3333333333333333,0.29411764705882354,0.8333333333333334,0.0625,0.3333333333333333
Autosomal recessive spastic paraplegia type 53,39424,12,2,20,0,20,23,0,23,0.0,0.0,0.0,0.0,0.0,0.0
Autosomal recessive spastic paraplegia type 46,38455,10,5,17,1,16,13,1,12,0.2,0.2,0.058823529411764705,0.2,0.07692307692307693,0.2
Autosomal recessive spastic paraplegia type 25,39424,22,2,34,0,34,35,0,35,0.0,0.0,0.0,0.0,0.0,0.0
Autosomal recessive spastic paraplegia type 39,39424,13,0,31,0,31,22,0,22,0.0,0.0,0.0,0.0,0.0,0.0
Generalized epilepsy-paroxysmal dyskinesia syndrome,28945,1,0,19,0,19,31,0,31,0.0,0.0,0.0,0.0,0.0,0.0
Autosomal dominant spastic paraplegia type 29,30156,3,2,23,2,21,31,0,31,1.0,0.0,0.08695652173913043,1.0,0.0,0.0
Sydenham chorea,32884,7,0,24,0,24,21,0,21,0.0,0.0,0.0,0.0,0.0,0.0
Adult-onset dystonia-parkinsonism,27743,9,0,22,0,22,22,0,22,0.0,0.0,0.0,0.0,0.0,0.0
Autosomal dominant spastic paraplegia type 36,30156,3,5,23,4,19,36,1,35,0.8,0.2,0.17391304347826086,0.8,0.027777777777777776,0.2
PANDAS,31184,0,1,34,0,34,1,0,1,0.0,0.0,0.0,0.0,0.0,0.0
Spinocerebellar ataxia type 36,27402,7,5,21,4,17,11,3,8,0.8,0.6,0.19047619047619047,0.8,0.2727272727272727,0.6
Spinocerebellar ataxia type 43,27402,5,3,23,0,23,17,0,17,0.0,0.0,0.0,0.0,0.0,0.0
Autosomal dominant spastic paraplegia type 13,38455,10,2,21,0,21,26,0,26,0.0,0.0,0.0,0.0,0.0,0.0
Spastic paraplegia type 7,30156,1,1,24,0,24,32,0,32,0.0,0.0,0.0,0.0,0.0,0.0
Paroxysmal hemicrania,27770,3,2,17,2,15,27,1,26,1.0,0.5,0.11764705882352941,1.0,0.037037037037037035,0.5
Autosomal dominant spastic paraplegia type 31,38455,14,3,26,0,26,32,0,32,0.0,0.0,0.0,0.0,0.0,0.0
Autosomal spastic paraplegia type 58,30156,3,7,17,0,17,30,1,29,0.0,0.14285714285714285,0.0,0.0,0.03333333333333333,0.14285714285714285
Autosomal dominant spastic paraplegia type 6,30156,2,6,23,7,16,28,2,26,1.1666666666666667,0.3333333333333333,0.30434782608695654,1.1666666666666667,0.07142857142857142,0.3333333333333333
Autosomal dominant dopa-responsive dystonia,32450,4,0,51,0,51,27,0,27,0.0,0.0,0.0,0.0,0.0,0.0
Autosomal recessive spastic paraplegia type 35,38455,13,6,36,1,35,26,1,25,0.16666666666666666,0.16666666666666666,0.027777777777777776,0.16666666666666666,0.038461538461538464,0.16666666666666666
X-linked spastic paraplegia type 16,38818,13,0,29,0,29,27,0,27,0.0,0.0,0.0,0.0,0.0,0.0
Autosomal recessive spastic paraplegia type 61,27668,2,0,14,0,14,34,0,34,0.0,0.0,0.0,0.0,0.0,0.0
Autosomal recessive spastic paraplegia type 45,38455,9,8,23,0,23,32,0,32,0.0,0.0,0.0,0.0,0.0,0.0
Autosomal recessive spastic paraplegia type 56,27668,1,2,18,0,18,34,0,34,0.0,0.0,0.0,0.0,0.0,0.0
Autosomal spastic paraplegia type 30,30156,3,7,21,1,20,21,1,20,0.14285714285714285,0.14285714285714285,0.047619047619047616,0.14285714285714285,0.047619047619047616,0.14285714285714285
Autosomal recessive spastic paraplegia type 48,38455,23,2,28,0,28,37,0,37,0.0,0.0,0.0,0.0,0.0,0.0
Autosomal recessive spastic paraplegia type 5A,39424,12,5,15,2,13,30,2,28,0.4,0.4,0.13333333333333333,0.4,0.06666666666666667,0.4
Autosomal recessive spastic paraplegia type 14,39424,15,7,41,0,41,28,1,27,0.0,0.14285714285714285,0.0,0.0,0.03571428571428571,0.14285714285714285
Multifocal motor neuropathy,33185,6,1,17,1,16,18,0,18,1.0,0.0,0.058823529411764705,1.0,0.0,0.0
Autosomal dominant limb-girdle muscular dystrophy type 1A,27315,9,3,19,2,17,19,3,16,0.6666666666666666,1.0,0.10526315789473684,0.6666666666666666,0.15789473684210525,1.0
Episodic ataxia type 4,27813,7,1,30,2,28,28,2,26,2.0,2.0,0.06666666666666667,2.0,0.07142857142857142,2.0
Leukoencephalopathy-spondyloepimetaphyseal dysplasia syndrome,38339,14,2,33,1,32,26,0,26,0.5,0.0,0.030303030303030304,0.5,0.0,0.0
ATTRV30M amyloidosis,33159,2,2,20,0,20,23,0,23,0.0,0.0,0.0,0.0,0.0,0.0
Autosomal recessive spastic paraplegia type 64,38455,23,0,38,0,38,32,0,32,0.0,0.0,0.0,0.0,0.0,0.0
Autosomal recessive spastic paraplegia type 63,27668,1,0,13,0,13,18,0,18,0.0,0.0,0.0,0.0,0.0,0.0
Autosomal recessive ataxia due to ubiquinone deficiency,31085,2,2,16,1,15,24,0,24,0.5,0.0,0.0625,0.5,0.0,0.0
Non-progressive cerebellar ataxia with intellectual disability,39885,4,2,4,0,4,4,0,4,0.0,0.0,0.0,0.0,0.0,0.0
Spinocerebellar ataxia type 35,27402,6,1,9,0,9,16,0,16,0.0,0.0,0.0,0.0,0.0,0.0
Spinocerebellar ataxia type 26,27402,6,5,25,1,24,17,2,15,0.2,0.4,0.04,0.2,0.11764705882352941,0.4
Adult-onset autosomal recessive cerebellar ataxia,27739,1,2,18,1,17,11,0,11,0.5,0.0,0.05555555555555555,0.5,0.0,0.0
Childhood-onset autosomal recessive slowly progressive spinocerebellar ataxia,27662,5,1,26,0,26,29,0,29,0.0,0.0,0.0,0.0,0.0,0.0
Infantile-onset autosomal recessive nonprogressive cerebellar ataxia,27739,1,1,18,1,17,14,0,14,1.0,0.0,0.05555555555555555,1.0,0.0,0.0
Spectrin-associated autosomal recessive cerebellar ataxia,27739,1,1,17,0,17,12,0,12,0.0,0.0,0.0,0.0,0.0,0.0
Spinocerebellar degeneration-corneal dystrophy syndrome,31441,1,0,22,0,22,16,0,16,0.0,0.0,0.0,0.0,0.0,0.0
Myoclonus-cerebellar ataxia-deafness syndrome,28663,3,0,16,0,16,6,0,6,0.0,0.0,0.0,0.0,0.0,0.0
Progressive encephalopathy with leukodystrophy due to DECR deficiency,32025,1,0,31,0,31,22,0,22,0.0,0.0,0.0,0.0,0.0,0.0
Familial congenital mirror movements,33373,2,0,18,0,18,25,0,25,0.0,0.0,0.0,0.0,0.0,0.0
"Metachromatic leukodystrophy, adult form",29433,18,0,22,0,22,41,0,41,0.0,0.0,0.0,0.0,0.0,0.0
"Metachromatic leukodystrophy, juvenile form",29393,3,0,17,0,17,29,0,29,0.0,0.0,0.0,0.0,0.0,0.0
"Metachromatic leukodystrophy, late infantile form",29393,3,0,17,0,17,25,0,25,0.0,0.0,0.0,0.0,0.0,0.0
Mitochondrial membrane protein-associated neurodegeneration,38859,11,9,28,2,26,23,2,21,0.2222222222222222,0.2222222222222222,0.07142857142857142,0.2222222222222222,0.08695652173913043,0.2222222222222222
Paroxysmal non-kinesigenic dyskinesia,29166,3,2,18,1,17,23,0,23,0.5,0.0,0.05555555555555555,0.5,0.0,0.0
Paroxysmal kinesigenic dyskinesia,29166,2,5,18,5,13,24,2,22,1.0,0.4,0.2777777777777778,1.0,0.08333333333333333,0.4
Juvenile Huntington disease,33341,3,0,17,0,17,19,0,19,0.0,0.0,0.0,0.0,0.0,0.0
Sporadic adult-onset ataxia of unknown etiology,32721,3,3,19,4,15,12,2,10,1.3333333333333333,0.6666666666666666,0.21052631578947367,1.3333333333333333,0.16666666666666666,0.6666666666666666
Spinocerebellar ataxia with axonal neuropathy type 2,27662,1,4,30,3,27,20,2,18,0.75,0.5,0.1,0.75,0.1,0.5
Autosomal dominant spastic paraplegia type 4,38455,13,0,23,0,23,32,0,32,0.0,0.0,0.0,0.0,0.0,0.0
Autosomal dominant spastic paraplegia type 3,30156,1,4,23,4,19,23,0,23,1.0,0.0,0.17391304347826086,1.0,0.0,0.0
Familial paroxysmal ataxia,30987,8,3,21,3,18,15,5,10,1.0,1.6666666666666667,0.14285714285714285,1.0,0.3333333333333333,1.6666666666666667
Early-onset cerebellar ataxia with retained tendon reflexes,27787,2,1,17,1,16,15,0,15,1.0,0.0,0.058823529411764705,1.0,0.0,0.0
Spinocerebellar ataxia type 6,27402,6,9,25,1,24,17,3,14,0.1111111111111111,0.3333333333333333,0.04,0.1111111111111111,0.17647058823529413,0.3333333333333333
Spinocerebellar ataxia type 7,27402,9,6,24,4,20,17,5,12,0.6666666666666666,0.8333333333333334,0.16666666666666666,0.6666666666666666,0.29411764705882354,0.8333333333333334
"Multiple system atrophy, parkinsonian type",33015,4,0,16,0,16,23,0,23,0.0,0.0,0.0,0.0,0.0,0.0
"Multiple system atrophy, cerebellar type",32854,4,0,34,0,34,21,0,21,0.0,0.0,0.0,0.0,0.0,0.0
X-linked dystonia-parkinsonism,28439,4,0,17,0,17,23,0,23,0.0,0.0,0.0,0.0,0.0,0.0
Severe intellectual disability-corpus callosum agenesis-facial dysmorphism-cerebellar ataxia syndrome,31952,1,0,25,0,25,29,0,29,0.0,0.0,0.0,0.0,0.0,0.0
Acute infantile liver failure-cerebellar ataxia-peripheral sensory motor neuropathy syndrome,27793,3,0,25,0,25,18,0,18,0.0,0.0,0.0,0.0,0.0,0.0
Autosomal recessive dopa-responsive dystonia,32450,6,0,51,0,51,17,0,17,0.0,0.0,0.0,0.0,0.0,0.0
RARS-related autosomal recessive hypomyelinating leukodystrophy,27796,3,0,143,0,143,11,0,11,0.0,0.0,0.0,0.0,0.0,0.0
Spinocerebellar ataxia type 1,27662,2,2,26,1,25,11,0,11,0.5,0.0,0.038461538461538464,0.5,0.0,0.0
Spinocerebellar ataxia type 2,27402,8,2,17,0,17,21,0,21,0.0,0.0,0.0,0.0,0.0,0.0
VPS11-related autosomal recessive hypomyelinating leukodystrophy,27796,2,6,18,3,15,11,0,11,0.5,0.0,0.16666666666666666,0.5,0.0,0.0
Dentatorubral pallidoluysian atrophy,30598,4,1,21,0,21,30,0,30,0.0,0.0,0.0,0.0,0.0,0.0
17q24.2 microdeletion syndrome,32429,6,3,102,2,100,27,1,26,0.6666666666666666,0.3333333333333333,0.0196078431372549,0.6666666666666666,0.037037037037037035,0.3333333333333333
PLAA-associated neurodevelopmental disorder,38984,15,0,24,0,24,21,0,21,0.0,0.0,0.0,0.0,0.0,0.0
Cleft palate-short stature-vertebral anomalies syndrome,32539,7,0,25,0,25,26,0,26,0.0,0.0,0.0,0.0,0.0,0.0
Microcephaly-seizures-intellectual disability-heart disease syndrome,32770,1,8,17,7,10,24,1,23,0.875,0.125,0.4117647058823529,0.875,0.041666666666666664,0.125
Zimmermann-Laband syndrome,28250,0,1,17,0,17,9,0,9,0.0,0.0,0.0,0.0,0.0,0.0
Microcephaly-brachydactyly-kyphoscoliosis syndrome,33370,5,12,21,11,10,30,3,27,0.9166666666666666,0.25,0.5238095238095238,0.9166666666666666,0.1,0.25
Fallot complex-intellectual disability-growth delay syndrome,29650,2,3,17,1,16,26,0,26,0.3333333333333333,0.0,0.058823529411764705,0.3333333333333333,0.0,0.0
Microcephaly-facial dysmorphism-ocular anomalies-multiple congenital anomalies syndrome,98519,18,0,21,0,21,27,0,27,0.0,0.0,0.0,0.0,0.0,0.0
CHAND syndrome,27636,0,3,16,3,13,21,0,21,1.0,0.0,0.1875,1.0,0.0,0.0
Familial infantile bilateral striatal necrosis,31878,4,0,48,0,48,21,0,21,0.0,0.0,0.0,0.0,0.0,0.0
Sporadic infantile bilateral striatal necrosis,31878,6,0,48,0,48,30,0,30,0.0,0.0,0.0,0.0,0.0,0.0
Early-onset progressive leukoencephalopathy-central nervous system calcification-deafness-visual impairment syndrome,31550,3,0,17,0,17,25,0,25,0.0,0.0,0.0,0.0,0.0,0.0
Cataract-deafness-hypogonadism syndrome,32868,7,0,36,0,36,37,0,37,0.0,0.0,0.0,0.0,0.0,0.0
Aymé-Gripp syndrome,30872,0,4,16,1,15,32,0,32,0.25,0.0,0.0625,0.25,0.0,0.0
Atelosteogenesis type III,30049,0,0,16,0,16,26,0,26,0.0,0.0,0.0,0.0,0.0,0.0
Global developmental delay-osteopenia-ectodermal defect syndrome,32336,0,16,23,13,10,25,1,24,0.8125,0.0625,0.5652173913043478,0.8125,0.04,0.0625
Bilateral polymicrogyria,27528,9,1,20,1,19,21,0,21,1.0,0.0,0.05,1.0,0.0,0.0
Atelosteogenesis type II,30049,0,1,16,1,15,21,0,21,1.0,0.0,0.0625,1.0,0.0,0.0
Tricho-dento-osseous syndrome,31662,1,0,17,0,17,36,0,36,0.0,0.0,0.0,0.0,0.0,0.0
Unilateral polymicrogyria,27528,7,0,18,0,18,30,0,30,0.0,0.0,0.0,0.0,0.0,0.0
Isolated congenital alacrima,28705,0,1,22,1,21,31,0,31,1.0,0.0,0.045454545454545456,1.0,0.0,0.0
NKX6-2-related autosomal recessive hypomyelinating leukodystrophy,99885,16,4,20,1,19,38,1,37,0.25,0.25,0.05,0.25,0.02631578947368421,0.25
"3-phosphoserine phosphatase deficiency, infantile/juvenile form",30055,1,0,17,0,17,26,0,26,0.0,0.0,0.0,0.0,0.0,0.0
Autosomal recessive axonal Charcot-Marie-Tooth disease due to copper metabolism defect,30728,0,0,17,0,17,23,0,23,0.0,0.0,0.0,0.0,0.0,0.0
Familial acute necrotizing encephalopathy,29105,4,3,30,2,28,22,1,21,0.6666666666666666,0.3333333333333333,0.06666666666666667,0.6666666666666666,0.045454545454545456,0.3333333333333333
Chronic bilirubin encephalopathy,95110,20,4,27,0,27,29,0,29,0.0,0.0,0.0,0.0,0.0,0.0
Microphthalmia-brain atrophy syndrome,33238,1,2,19,2,17,20,1,19,1.0,0.5,0.10526315789473684,1.0,0.05,0.5
Ossification anomalies-psychomotor developmental delay syndrome,32328,1,0,21,0,21,23,0,23,0.0,0.0,0.0,0.0,0.0,0.0
Charcot-Marie-Tooth disease-deafness-intellectual disability syndrome,27720,2,7,16,3,13,27,0,27,0.42857142857142855,0.0,0.1875,0.42857142857142855,0.0,0.0
Keratosis follicularis-dwarfism-cerebral atrophy syndrome,30259,10,0,26,0,26,40,0,40,0.0,0.0,0.0,0.0,0.0,0.0
Sporadic Creutzfeldt-Jakob disease,32477,4,5,17,2,15,20,1,19,0.4,0.2,0.11764705882352941,0.4,0.05,0.2
Agammaglobulinemia-microcephaly-craniosynostosis-severe dermatitis syndrome,32747,0,1,17,1,16,31,0,31,1.0,0.0,0.058823529411764705,1.0,0.0,0.0
"3-phosphoglycerate dehydrogenase deficiency, infantile/juvenile form",35495,9,2,27,0,27,19,0,19,0.0,0.0,0.0,0.0,0.0,0.0
Periventricular nodular heterotopia,28816,3,5,26,0,26,23,0,23,0.0,0.0,0.0,0.0,0.0,0.0
S-adenosylhomocysteine hydrolase deficiency,29286,1,5,23,2,21,27,1,26,0.4,0.2,0.08695652173913043,0.4,0.037037037037037035,0.2
MYH9-related disease,27475,2,1,18,0,18,37,0,37,0.0,0.0,0.0,0.0,0.0,0.0
"X-linked intellectual disability, Snyder type",27603,5,1,114,1,113,33,0,33,1.0,0.0,0.008771929824561403,1.0,0.0,0.0
Ménétrier disease,30175,0,2,16,0,16,20,0,20,0.0,0.0,0.0,0.0,0.0,0.0
Laryngeal abductor paralysis-intellectual disability syndrome,28639,6,3,19,3,16,34,0,34,1.0,0.0,0.15789473684210525,1.0,0.0,0.0
X-linked intellectual disability-seizures-psoriasis syndrome,27727,10,0,30,0,30,34,0,34,0.0,0.0,0.0,0.0,0.0,0.0
"Autosomal dominant optic atrophy, classic form",27858,4,2,24,3,21,38,2,36,1.5,1.0,0.125,1.5,0.05263157894736842,1.0
HELLP syndrome,30274,5,3,16,3,13,22,2,20,1.0,0.6666666666666666,0.1875,1.0,0.09090909090909091,0.6666666666666666
Hyperornithinemia-hyperammonemia-homocitrullinuria syndrome,30805,6,6,20,1,19,22,4,18,0.16666666666666666,0.6666666666666666,0.05,0.16666666666666666,0.18181818181818182,0.6666666666666666
Small bowel atresia,31974,8,1,17,1,16,15,0,15,1.0,0.0,0.058823529411764705,1.0,0.0,0.0
Meige disease,29657,0,1,17,2,15,35,0,35,2.0,0.0,0.11764705882352941,2.0,0.0,0.0
Caudal appendage-deafness syndrome,33226,2,0,23,0,23,39,0,39,0.0,0.0,0.0,0.0,0.0,0.0
Chilblain lupus,27368,2,1,17,1,16,20,0,20,1.0,0.0,0.058823529411764705,1.0,0.0,0.0
Van den Bosch syndrome,31455,1,0,16,0,16,20,0,20,0.0,0.0,0.0,0.0,0.0,0.0
FG syndrome type 1,28758,1,0,17,0,17,35,0,35,0.0,0.0,0.0,0.0,0.0,0.0
Glycogen storage disease due to phosphoglycerate kinase 1 deficiency,29043,2,0,18,0,18,26,0,26,0.0,0.0,0.0,0.0,0.0,0.0
Mitochondrial DNA-associated Leigh syndrome,29857,7,2,106,1,105,25,0,25,0.5,0.0,0.009433962264150943,0.5,0.0,0.0
"Severe X-linked intellectual disability, Gustavson type",28944,3,6,20,2,18,28,2,26,0.3333333333333333,0.3333333333333333,0.1,0.3333333333333333,0.07142857142857142,0.3333333333333333
X-linked intellectual disability-psychosis-macroorchidism syndrome,32121,1,7,35,5,30,27,1,26,0.7142857142857143,0.14285714285714285,0.14285714285714285,0.7142857142857143,0.037037037037037035,0.14285714285714285
Ethylmalonic encephalopathy,28057,2,2,18,1,17,13,0,13,0.5,0.0,0.05555555555555555,0.5,0.0,0.0
Primary lateral sclerosis,28624,6,5,18,3,15,26,2,24,0.6,0.4,0.16666666666666666,0.6,0.07692307692307693,0.4
Brain malformations-musculoskeletal abnormalities-facial dysmorphism-intellectual disability syndrome,38365,22,4,34,1,33,29,1,28,0.25,0.25,0.029411764705882353,0.25,0.034482758620689655,0.25
Global developmental delay-neuro-ophthalmological abnormalities-seizures-intellectual disability syndrome,29069,11,2,22,2,20,33,0,33,1.0,0.0,0.09090909090909091,1.0,0.0,0.0
Glanzmann thrombasthenia,27527,5,2,18,2,16,22,0,22,1.0,0.0,0.1111111111111111,1.0,0.0,0.0
Bernard-Soulier syndrome,30957,6,5,16,3,13,25,3,22,0.6,0.6,0.1875,0.6,0.12,0.6
8q24.3 microdeletion syndrome,32429,4,3,100,1,99,29,1,28,0.3333333333333333,0.3333333333333333,0.01,0.3333333333333333,0.034482758620689655,0.3333333333333333
NUT midline carcinoma,33035,1,1,19,0,19,26,0,26,0.0,0.0,0.0,0.0,0.0,0.0
Distal hereditary motor neuropathy type 5,38458,15,0,24,0,24,34,0,34,0.0,0.0,0.0,0.0,0.0,0.0
Autoimmune hepatitis,33348,3,9,28,8,20,22,0,22,0.8888888888888888,0.0,0.2857142857142857,0.8888888888888888,0.0,0.0
Histidinemia,30272,1,2,16,2,14,15,0,15,1.0,0.0,0.125,1.0,0.0,0.0
Hepatic veno-occlusive disease-immunodeficiency syndrome,32827,9,4,22,0,22,25,0,25,0.0,0.0,0.0,0.0,0.0,0.0
Combined oxidative phosphorylation defect type 29,38594,13,22,21,0,21,30,0,30,0.0,0.0,0.0,0.0,0.0,0.0
Dilated cardiomyopathy with ataxia,28077,11,5,24,1,23,24,1,23,0.2,0.2,0.041666666666666664,0.2,0.041666666666666664,0.2
Mitochondrial myopathy with reversible cytochrome C oxidase deficiency,31222,1,7,39,8,31,25,1,24,1.1428571428571428,0.14285714285714285,0.20512820512820512,1.1428571428571428,0.04,0.14285714285714285
Hereditary pulmonary alveolar proteinosis,32659,3,1,16,0,16,26,0,26,0.0,0.0,0.0,0.0,0.0,0.0
Familial reactive perforating collagenosis,27811,0,2,16,2,14,23,0,23,1.0,0.0,0.125,1.0,0.0,0.0
Aneurysm-osteoarthritis syndrome,27747,1,3,21,0,21,33,0,33,0.0,0.0,0.0,0.0,0.0,0.0
Peripheral primitive neuroectodermal tumor,96073,4,1,10,0,10,44,0,44,0.0,0.0,0.0,0.0,0.0,0.0
Early-onset seizures-distal limb anomalies-facial dysmorphism-global developmental delay syndrome,29279,1,2,36,2,34,46,1,45,1.0,0.5,0.05555555555555555,1.0,0.021739130434782608,0.5
Ramos-Arroyo syndrome,31138,0,2,43,2,41,25,0,25,1.0,0.0,0.046511627906976744,1.0,0.0,0.0
Neuroleptic malignant syndrome,33454,10,6,23,1,22,20,0,20,0.16666666666666666,0.0,0.043478260869565216,0.16666666666666666,0.0,0.0
Somatomammotropinoma,33412,2,26,45,24,21,51,3,48,0.9230769230769231,0.11538461538461539,0.5333333333333333,0.9230769230769231,0.058823529411764705,0.11538461538461539
"Hypotrichosis-intellectual disability, Lopes type",33503,14,0,31,0,31,29,0,29,0.0,0.0,0.0,0.0,0.0,0.0
Pediatric-onset Graves disease,33524,1,5,31,4,27,21,0,21,0.8,0.0,0.12903225806451613,0.8,0.0,0.0
Autosomal dominant Charcot-Marie-Tooth disease type 2W,29098,2,5,29,5,24,19,1,18,1.0,0.2,0.1724137931034483,1.0,0.05263157894736842,0.2
Autosomal dominant Charcot-Marie-Tooth disease type 2A2,29098,3,6,25,2,23,21,0,21,0.3333333333333333,0.0,0.08,0.3333333333333333,0.0,0.0
Autosomal recessive axonal neuropathy with neuromyotonia,39150,13,5,23,0,23,13,0,13,0.0,0.0,0.0,0.0,0.0,0.0
Ichthyosis-alopecia-eclabion-ectropion-intellectual disability syndrome,27833,7,6,18,6,12,41,3,38,1.0,0.5,0.3333333333333333,1.0,0.07317073170731707,0.5
Osteopenia-intellectual disability-sparse hair syndrome,29559,2,0,27,0,27,17,0,17,0.0,0.0,0.0,0.0,0.0,0.0
Dysmorphism-short stature-deafness-difference of sex development syndrome,33495,3,0,17,0,17,39,0,39,0.0,0.0,0.0,0.0,0.0,0.0
Subependymoma,33499,0,1,16,1,15,26,0,26,1.0,0.0,0.0625,1.0,0.0,0.0
Ependymoma,38294,20,1,27,0,27,31,0,31,0.0,0.0,0.0,0.0,0.0,0.0
Lowry-MacLean syndrome,30395,0,0,16,0,16,26,0,26,0.0,0.0,0.0,0.0,0.0,0.0
Myxopapillary ependymoma,33500,2,2,12,2,10,30,0,30,1.0,0.0,0.16666666666666666,1.0,0.0,0.0
Marfanoid habitus-autosomal recessive intellectual disability syndrome,29507,2,7,17,3,14,24,2,22,0.42857142857142855,0.2857142857142857,0.17647058823529413,0.42857142857142855,0.08333333333333333,0.2857142857142857
Czeizel-Losonci syndrome,31961,1,0,17,0,17,40,0,40,0.0,0.0,0.0,0.0,0.0,0.0
Lethal omphalocele-cleft palate syndrome,31149,8,2,21,2,19,33,2,31,1.0,1.0,0.09523809523809523,1.0,0.06060606060606061,1.0
Metaphyseal dysostosis-intellectual disability-conductive deafness syndrome,27873,1,2,16,1,15,26,0,26,0.5,0.0,0.0625,0.5,0.0,0.0
Orofaciodigital syndrome type 2,27672,3,1,31,1,30,43,0,43,1.0,0.0,0.03225806451612903,1.0,0.0,0.0
Osteoporosis-pseudoglioma syndrome,30174,0,2,17,1,16,33,0,33,0.5,0.0,0.058823529411764705,0.5,0.0,0.0
Short stature-webbed neck-heart disease syndrome,32604,4,0,24,0,24,28,0,28,0.0,0.0,0.0,0.0,0.0,0.0
Orofaciodigital syndrome type 5,27672,0,3,33,0,33,17,0,17,0.0,0.0,0.0,0.0,0.0,0.0
Oliver syndrome,28654,0,2,18,1,17,24,0,24,0.5,0.0,0.05555555555555555,0.5,0.0,0.0
Preaxial polydactyly-colobomata-intellectual disability syndrome,33280,7,0,30,0,30,30,0,30,0.0,0.0,0.0,0.0,0.0,0.0
Qazi-Markouizos syndrome,32142,0,6,18,4,14,17,0,17,0.6666666666666666,0.0,0.2222222222222222,0.6666666666666666,0.0,0.0
Intellectual disability-balding-patella luxation-acromicria syndrome,29979,1,11,63,11,52,32,0,32,1.0,0.0,0.1746031746031746,1.0,0.0,0.0
Intellectual disability-dysmorphism-hypogonadism-diabetes mellitus syndrome,29562,4,16,28,12,16,26,0,26,0.75,0.0,0.42857142857142855,0.75,0.0,0.0
Richieri Costa-da Silva syndrome,27732,0,8,18,3,15,33,0,33,0.375,0.0,0.16666666666666666,0.375,0.0,0.0
Say-Barber-Miller syndrome,29878,0,4,29,2,27,14,0,14,0.5,0.0,0.06896551724137931,0.5,0.0,0.0
Schinzel-Giedion syndrome,30565,2,7,34,3,31,30,0,30,0.42857142857142855,0.0,0.08823529411764706,0.42857142857142855,0.0,0.0
DOORS syndrome,32136,2,13,104,15,89,24,0,24,1.1538461538461537,0.0,0.14423076923076922,1.1538461538461537,0.0,0.0
Intellectual disability-autism-speech apraxia-craniofacial dysmorphism syndrome,31809,3,2,31,1,30,35,0,35,0.5,0.0,0.03225806451612903,0.5,0.0,0.0
DNA2-related mitochondrial DNA deletion syndrome,38367,17,2,26,1,25,31,0,31,0.5,0.0,0.038461538461538464,0.5,0.0,0.0
Progressive external ophthalmoplegia-myopathy-emaciation syndrome,31717,3,1,15,0,15,19,0,19,0.0,0.0,0.0,0.0,0.0,0.0
Autosomal dominant mitochondrial myopathy with exercise intolerance,29450,0,0,16,0,16,21,0,21,0.0,0.0,0.0,0.0,0.0,0.0
Vocal cord and pharyngeal distal myopathy,27806,4,0,26,0,26,24,0,24,0.0,0.0,0.0,0.0,0.0,0.0
Congenital cataract-progressive muscular hypotonia-hearing loss-developmental delay syndrome,29667,16,0,26,0,26,27,0,27,0.0,0.0,0.0,0.0,0.0,0.0
Kyphoscoliosis-lateral tongue atrophy-hereditary spastic paraplegia syndrome,27773,2,0,18,0,18,21,0,21,0.0,0.0,0.0,0.0,0.0,0.0
Familial dyskinesia and facial myokymia,27719,4,2,16,2,14,23,1,22,1.0,0.5,0.125,1.0,0.043478260869565216,0.5
Spastic paraplegia-intellectual disability-nystagmus-obesity syndrome,29703,1,0,18,0,18,24,0,24,0.0,0.0,0.0,0.0,0.0,0.0
Spastic paraplegia-optic atrophy-neuropathy syndrome,29282,8,3,30,1,29,27,1,26,0.3333333333333333,0.3333333333333333,0.03333333333333333,0.3333333333333333,0.037037037037037035,0.3333333333333333
Cerebellar ataxia with neuropathy and bilateral vestibular areflexia syndrome,32643,4,0,17,0,17,22,0,22,0.0,0.0,0.0,0.0,0.0,0.0
Spastic paraplegia-precocious puberty syndrome,31892,6,0,19,0,19,29,0,29,0.0,0.0,0.0,0.0,0.0,0.0
Early-onset progressive encephalopathy-spastic ataxia-distal spinal muscular atrophy syndrome,27801,1,4,18,2,16,25,0,25,0.5,0.0,0.1111111111111111,0.5,0.0,0.0
Autosomal recessive spinocerebellar ataxia-blindness-deafness syndrome,27662,3,0,28,0,28,5,0,5,0.0,0.0,0.0,0.0,0.0,0.0
Sandifer syndrome,33361,5,4,19,3,16,26,1,25,0.75,0.25,0.15789473684210525,0.75,0.038461538461538464,0.25
Autosomal recessive cerebellar ataxia-pyramidal signs-nystagmus-oculomotor apraxia syndrome,27757,1,4,19,4,15,6,2,4,1.0,0.5,0.21052631578947367,1.0,0.3333333333333333,0.5
APC-related attenuated familial adenomatous polyposis,29041,0,1,18,0,18,20,0,20,0.0,0.0,0.0,0.0,0.0,0.0
MUTYH-related attenuated familial adenomatous polyposis,27714,0,1,17,0,17,20,0,20,0.0,0.0,0.0,0.0,0.0,0.0
Attenuated familial adenomatous polyposis,27714,0,1,24,0,24,23,0,23,0.0,0.0,0.0,0.0,0.0,0.0
Serrated polyposis syndrome,100017,15,1,21,0,21,18,0,18,0.0,0.0,0.0,0.0,0.0,0.0
Male infertility due to acephalic spermatozoa,29505,5,2,15,1,14,24,1,23,0.5,0.5,0.06666666666666667,0.5,0.041666666666666664,0.5
Familial adenomatous polyposis due to 5q22.2 microdeletion,32693,1,1,31,0,31,23,0,23,0.0,0.0,0.0,0.0,0.0,0.0
Primary erythromelalgia,38272,18,3,24,1,23,27,1,26,0.3333333333333333,0.3333333333333333,0.041666666666666664,0.3333333333333333,0.037037037037037035,0.3333333333333333
Hereditary mixed polyposis syndrome,30215,13,3,27,1,26,24,0,24,0.3333333333333333,0.0,0.037037037037037035,0.3333333333333333,0.0,0.0
Polymerase proofreading-related adenomatous polyposis,33525,2,0,7,0,7,28,0,28,0.0,0.0,0.0,0.0,0.0,0.0
AXIN2-related attenuated familial adenomatous polyposis,29041,0,0,22,0,22,20,0,20,0.0,0.0,0.0,0.0,0.0,0.0
NTHL1-related attenuated familial adenomatous polyposis,29041,0,1,18,0,18,24,0,24,0.0,0.0,0.0,0.0,0.0,0.0
MSH3-related attenuated familial adenomatous polyposis,27714,1,3,17,0,17,24,0,24,0.0,0.0,0.0,0.0,0.0,0.0
Laing distal myopathy,28689,4,2,17,1,16,25,0,25,0.5,0.0,0.058823529411764705,0.5,0.0,0.0
Distal anoctaminopathy,29778,0,2,9,0,9,33,0,33,0.0,0.0,0.0,0.0,0.0,0.0
Distal myotilinopathy,27323,4,5,25,0,25,22,2,20,0.0,0.4,0.0,0.0,0.09090909090909091,0.4
Mitochondrial myopathy-cerebellar ataxia-pigmentary retinopathy syndrome,28118,6,0,18,0,18,27,0,27,0.0,0.0,0.0,0.0,0.0,0.0
Mitochondrial DNA-related progressive external ophthalmoplegia,32694,7,2,34,0,34,28,0,28,0.0,0.0,0.0,0.0,0.0,0.0
Neutral lipid storage disease with myopathy,31602,3,4,32,2,30,23,0,23,0.5,0.0,0.0625,0.5,0.0,0.0
"Mitochondrial DNA depletion syndrome, myopathic form",27802,3,5,17,4,13,28,3,25,0.8,0.6,0.23529411764705882,0.8,0.10714285714285714,0.6
Sensory ataxic neuropathy-dysarthria-ophthalmoparesis syndrome,31935,2,0,24,0,24,21,0,21,0.0,0.0,0.0,0.0,0.0,0.0
Mitochondrial trifunctional protein deficiency,29972,2,3,18,1,17,26,0,26,0.3333333333333333,0.0,0.05555555555555555,0.3333333333333333,0.0,0.0
Distal nebulin myopathy,32689,0,0,16,0,16,23,0,23,0.0,0.0,0.0,0.0,0.0,0.0
Adult-onset distal myopathy due to VCP mutation,27733,3,1,24,1,23,26,2,24,1.0,2.0,0.041666666666666664,1.0,0.07692307692307693,2.0
Peripheral neuropathy-myopathy-hoarseness-hearing loss syndrome,27792,1,0,18,0,18,32,0,32,0.0,0.0,0.0,0.0,0.0,0.0
KLHL9-related early-onset distal myopathy,32448,7,5,32,6,26,24,0,24,1.2,0.0,0.1875,1.2,0.0,0.0
Finnish upper limb-onset distal myopathy,27678,1,0,18,0,18,23,0,23,0.0,0.0,0.0,0.0,0.0,0.0
"Distal myopathy, Tateyama type",27717,1,0,22,0,22,24,0,24,0.0,0.0,0.0,0.0,0.0,0.0
Distal myopathy with anterior tibial onset,27323,1,2,23,1,22,19,0,19,0.5,0.0,0.043478260869565216,0.5,0.0,0.0
9q21.13 microdeletion syndrome,32429,5,5,99,2,97,25,1,24,0.4,0.2,0.020202020202020204,0.4,0.04,0.2
Ocular anomalies-axonal neuropathy-developmental delay syndrome,33527,2,3,25,2,23,32,0,32,0.6666666666666666,0.0,0.08,0.6666666666666666,0.0,0.0
Cortical dysgenesis with pontocerebellar hypoplasia due to TUBB3 mutation,27716,7,2,25,1,24,30,0,30,0.5,0.0,0.04,0.5,0.0,0.0
Multiple congenital anomalies-hypotonia-seizures syndrome,30436,1,5,17,3,14,27,0,27,0.6,0.0,0.17647058823529413,0.6,0.0,0.0
Limb-mammary syndrome,31471,0,0,31,0,31,17,0,17,0.0,0.0,0.0,0.0,0.0,0.0
Non-specific early-onset epileptic encephalopathy,33095,3,1,18,0,18,29,0,29,0.0,0.0,0.0,0.0,0.0,0.0
Autosomal dominant spastic paraplegia type 9B,38455,15,0,23,0,23,24,0,24,0.0,0.0,0.0,0.0,0.0,0.0
Lethal infantile mitochondrial myopathy,31987,3,0,18,0,18,25,0,25,0.0,0.0,0.0,0.0,0.0,0.0
Myopathy and diabetes mellitus,31234,4,3,21,2,19,26,0,26,0.6666666666666666,0.0,0.09523809523809523,0.6666666666666666,0.0,0.0
KBG syndrome,27930,0,0,42,0,42,20,0,20,0.0,0.0,0.0,0.0,0.0,0.0
Maternal phenylketonuria,31918,0,1,20,0,20,4,0,4,0.0,0.0,0.0,0.0,0.0,0.0
Neutral lipid storage disease with ichthyosis,38786,17,2,32,0,32,24,0,24,0.0,0.0,0.0,0.0,0.0,0.0
Adult-onset multiple mitochondrial DNA deletion syndrome due to DGUOK deficiency,31398,2,0,18,0,18,31,0,31,0.0,0.0,0.0,0.0,0.0,0.0
Pure mitochondrial myopathy,33309,3,4,18,2,16,29,0,29,0.5,0.0,0.1111111111111111,0.5,0.0,0.0
Adult-onset chronic progressive external ophthalmoplegia with mitochondrial myopathy,32694,1,3,22,1,21,26,0,26,0.3333333333333333,0.0,0.045454545454545456,0.3333333333333333,0.0,0.0
Self-limited childhood occipital epilepsy,32153,3,2,17,2,15,17,0,17,1.0,0.0,0.11764705882352941,1.0,0.0,0.0
Non-24-hour sleep-wake syndrome,32227,4,0,22,0,22,8,0,8,0.0,0.0,0.0,0.0,0.0,0.0
Pyridoxal phosphate-responsive seizures,30591,0,2,31,2,29,26,0,26,1.0,0.0,0.06451612903225806,1.0,0.0,0.0
Hydroxykynureninuria,27816,0,2,17,2,15,27,0,27,1.0,0.0,0.11764705882352941,1.0,0.0,0.0
Paraparetic variant of Guillain-Barré syndrome,27775,11,0,22,0,22,25,0,25,0.0,0.0,0.0,0.0,0.0,0.0
Trigeminal neuralgia,30449,3,4,21,3,18,22,1,21,0.75,0.25,0.14285714285714285,0.75,0.045454545454545456,0.25
Complex regional pain syndrome,32316,4,1,19,1,18,22,1,21,1.0,1.0,0.05263157894736842,1.0,0.045454545454545456,1.0
Oculoauriculofrontonasal syndrome,33175,1,2,17,1,16,34,0,34,0.5,0.0,0.058823529411764705,0.5,0.0,0.0
Craniofrontonasal dysplasia-Poland anomaly syndrome,32403,5,6,21,4,17,31,1,30,0.6666666666666666,0.16666666666666666,0.19047619047619047,0.6666666666666666,0.03225806451612903,0.16666666666666666
Frontonasal dysplasia-severe microphthalmia-severe facial clefting syndrome,29916,4,0,27,0,27,27,0,27,0.0,0.0,0.0,0.0,0.0,0.0
Chronic hiccup,32174,0,1,24,0,24,14,0,14,0.0,0.0,0.0,0.0,0.0,0.0
Polyneuropathy associated with IgM monoclonal gammopathy with anti-MAG,32591,2,3,18,1,17,26,0,26,0.3333333333333333,0.0,0.05555555555555555,0.3333333333333333,0.0,0.0
SIX2-related frontonasal dysplasia,27673,0,8,16,7,9,17,0,17,0.875,0.0,0.4375,0.875,0.0,0.0
Intellectual disability-hyperkinetic movement-truncal ataxia syndrome,38229,1,0,18,0,18,3,0,3,0.0,0.0,0.0,0.0,0.0,0.0
Primary angiitis of the central nervous system,99173,17,1,32,0,32,27,0,27,0.0,0.0,0.0,0.0,0.0,0.0
"Primary dystonia, DYT2 type",27743,8,1,35,0,35,33,0,33,0.0,0.0,0.0,0.0,0.0,0.0
Rapid-onset dystonia-parkinsonism,31408,1,0,16,0,16,27,0,27,0.0,0.0,0.0,0.0,0.0,0.0
Autosomal recessive spastic paraplegia type 78,27668,1,13,16,5,11,29,3,26,0.38461538461538464,0.23076923076923078,0.3125,0.38461538461538464,0.10344827586206896,0.23076923076923078
Spinocerebellar ataxia with axonal neuropathy type 1,27662,3,0,30,0,30,15,0,15,0.0,0.0,0.0,0.0,0.0,0.0
Frontotemporal dementia with motor neuron disease,32696,0,3,32,3,29,16,0,16,1.0,0.0,0.09375,1.0,0.0,0.0
Childhood disintegrative disorder,32809,4,4,16,5,11,32,1,31,1.25,0.25,0.3125,1.25,0.03125,0.25
Aminoacylase 1 deficiency,28711,1,0,18,0,18,25,0,25,0.0,0.0,0.0,0.0,0.0,0.0
Acute inflammatory demyelinating polyradiculoneuropathy,36915,16,1,23,0,23,27,0,27,0.0,0.0,0.0,0.0,0.0,0.0
Axonal polyneuropathy associated with IgG/IgM/IgA monoclonal gammopathy,32591,1,0,17,0,17,28,0,28,0.0,0.0,0.0,0.0,0.0,0.0
Autosomal dominant spastic paraplegia type 9A,38455,12,3,18,0,18,26,0,26,0.0,0.0,0.0,0.0,0.0,0.0
Adult-onset nemaline myopathy,27294,5,3,24,0,24,21,0,21,0.0,0.0,0.0,0.0,0.0,0.0
Childhood-onset nemaline myopathy,27294,4,3,104,3,101,18,0,18,1.0,0.0,0.028846153846153848,1.0,0.0,0.0
"Primary dystonia, DYT27 type",27743,9,2,68,1,67,32,0,32,0.5,0.0,0.014705882352941176,0.5,0.0,0.0
"Adult-onset cervical dystonia, DYT23 type",27743,5,0,28,0,28,33,0,33,0.0,0.0,0.0,0.0,0.0,0.0
"Primary dystonia, DYT17 type",27743,5,3,64,2,62,26,0,26,0.6666666666666666,0.0,0.03125,0.6666666666666666,0.0,0.0
Autosomal recessive spastic paraplegia type 59,27668,0,1,15,2,13,32,0,32,2.0,0.0,0.13333333333333333,2.0,0.0,0.0
Autosomal recessive spastic paraplegia type 60,38455,11,0,32,0,32,24,0,24,0.0,0.0,0.0,0.0,0.0,0.0
Autosomal recessive spastic paraplegia type 66,27668,1,0,20,0,20,39,0,39,0.0,0.0,0.0,0.0,0.0,0.0
Autosomal recessive spastic paraplegia type 67,27668,1,0,15,0,15,35,0,35,0.0,0.0,0.0,0.0,0.0,0.0
Infantile-onset generalized dyskinesia with orofacial involvement,27706,11,1,21,1,20,35,1,34,1.0,1.0,0.047619047619047616,1.0,0.02857142857142857,1.0
Postnatal microcephaly-infantile hypotonia-spastic diplegia-dysarthria-intellectual disability syndrome,28602,3,0,36,0,36,28,0,28,0.0,0.0,0.0,0.0,0.0,0.0
Spastic paraplegia-severe developmental delay-epilepsy syndrome,27808,6,3,22,2,20,39,0,39,0.6666666666666666,0.0,0.09090909090909091,0.6666666666666666,0.0,0.0
Huntington disease-like syndrome due to C9ORF72 expansions,38307,6,0,20,0,20,22,0,22,0.0,0.0,0.0,0.0,0.0,0.0
MT-ATP6-related mitochondrial spastic paraplegia,27777,3,3,23,3,20,24,0,24,1.0,0.0,0.13043478260869565,1.0,0.0,0.0
Autosomal recessive spastic paraplegia type 74,27668,1,2,16,1,15,39,0,39,0.5,0.0,0.0625,0.5,0.0,0.0
Machado-Joseph disease type 2,29334,5,3,20,2,18,26,1,25,0.6666666666666666,0.3333333333333333,0.1,0.6666666666666666,0.038461538461538464,0.3333333333333333
Machado-Joseph disease type 1,29334,6,7,28,7,21,23,2,21,1.0,0.2857142857142857,0.25,1.0,0.08695652173913043,0.2857142857142857
Machado-Joseph disease type 3,29334,4,4,17,2,15,21,1,20,0.5,0.25,0.11764705882352941,0.5,0.047619047619047616,0.25
Auriculocondylar syndrome,30422,1,3,48,4,44,32,0,32,1.3333333333333333,0.0,0.08333333333333333,1.3333333333333333,0.0,0.0
Congenital cerebellar ataxia due to RNU12 mutation,27794,3,0,19,0,19,14,0,14,0.0,0.0,0.0,0.0,0.0,0.0
Frontonasal dysplasia-bifid nose-upper limb anomalies syndrome,28884,2,0,38,0,38,33,0,33,0.0,0.0,0.0,0.0,0.0,0.0
Autosomal recessive spastic paraplegia type 69,27668,1,0,16,0,16,32,0,32,0.0,0.0,0.0,0.0,0.0,0.0
Autosomal recessive spastic paraplegia type 71,27668,2,0,18,0,18,19,0,19,0.0,0.0,0.0,0.0,0.0,0.0
Autosomal recessive spastic paraplegia type 70,27668,1,0,16,0,16,34,0,34,0.0,0.0,0.0,0.0,0.0,0.0
Severe intellectual disability and progressive spastic paraplegia,30156,3,4,24,1,23,39,2,37,0.25,0.5,0.041666666666666664,0.25,0.05128205128205128,0.5
Autosomal recessive cerebellar ataxia with late-onset spasticity,27739,2,3,25,4,21,11,2,9,1.3333333333333333,0.6666666666666666,0.16,1.3333333333333333,0.18181818181818182,0.6666666666666666
Huntington disease-like 3,38307,17,0,19,0,19,22,0,22,0.0,0.0,0.0,0.0,0.0,0.0
HSD10 disease,27938,0,1,16,0,16,41,0,41,0.0,0.0,0.0,0.0,0.0,0.0
X-linked intellectual disability due to GRIA3 mutations,33312,1,2,23,1,22,28,0,28,0.5,0.0,0.043478260869565216,0.5,0.0,0.0
Macrocephaly-intellectual disability-left ventricular non compaction syndrome,29116,5,1,17,0,17,27,0,27,0.0,0.0,0.0,0.0,0.0,0.0
X-linked female restricted facial dysmorphism-short stature-choanal atresia-intellectual disability,32853,4,2,33,0,33,27,0,27,0.0,0.0,0.0,0.0,0.0,0.0
X-linked myotubular myopathy-abnormal genitalia syndrome,32835,4,1,21,1,20,24,0,24,1.0,0.0,0.047619047619047616,1.0,0.0,0.0
X-linked intellectual disability-short stature-overweight syndrome,30178,4,0,18,0,18,28,0,28,0.0,0.0,0.0,0.0,0.0,0.0
Brachydactyly-short stature-retinitis pigmentosa syndrome,31265,3,5,40,3,37,39,2,37,0.6,0.4,0.075,0.6,0.05128205128205128,0.4
Hereditary cryohydrocytosis with reduced stomatin,29949,1,0,19,0,19,30,0,30,0.0,0.0,0.0,0.0,0.0,0.0
X-linked intellectual disability-global development delay-facial dysmorphism-sacral caudal remnant syndrome,32787,3,13,39,12,27,41,3,38,0.9230769230769231,0.23076923076923078,0.3076923076923077,0.9230769230769231,0.07317073170731707,0.23076923076923078
CLCN4-related X-linked intellectual disability syndrome,33420,0,1,38,1,37,31,0,31,1.0,0.0,0.02631578947368421,1.0,0.0,0.0
Guanidinoacetate methyltransferase deficiency,32145,1,1,18,2,16,30,0,30,2.0,0.0,0.1111111111111111,2.0,0.0,0.0
Leukoencephalopathy with brain stem and spinal cord involvement-high lactate syndrome,28274,9,1,55,1,54,29,0,29,1.0,0.0,0.01818181818181818,1.0,0.0,0.0
Microcephaly-polymicrogyria-corpus callosum agenesis syndrome,32467,12,0,21,0,21,27,0,27,0.0,0.0,0.0,0.0,0.0,0.0
Early-onset X-linked optic atrophy,27348,2,0,23,0,23,19,0,19,0.0,0.0,0.0,0.0,0.0,0.0
"X-linked intellectual disability, Stoll type",28944,4,0,22,0,22,23,0,23,0.0,0.0,0.0,0.0,0.0,0.0
"X-linked intellectual disability, Seemanova type",28041,1,0,17,0,17,25,0,25,0.0,0.0,0.0,0.0,0.0,0.0
X-linked intellectual disability-craniofacioskeletal syndrome,29870,5,0,55,0,55,33,0,33,0.0,0.0,0.0,0.0,0.0,0.0
X-linked cerebral-cerebellar-coloboma syndrome,31423,3,0,37,0,37,36,0,36,0.0,0.0,0.0,0.0,0.0,0.0
Rolandic epilepsy-speech dyspraxia syndrome,31036,4,3,30,4,26,28,1,27,1.3333333333333333,0.3333333333333333,0.13333333333333333,1.3333333333333333,0.03571428571428571,0.3333333333333333
X-linked intellectual disability-limb spasticity-retinal dystrophy-arginine vasopressin deficiency,33463,5,1,19,0,19,37,0,37,0.0,0.0,0.0,0.0,0.0,0.0
Pontocerebellar hypoplasia type 4,27716,2,0,22,0,22,23,0,23,0.0,0.0,0.0,0.0,0.0,0.0
Native American myopathy,30258,1,2,29,2,27,13,1,12,1.0,0.5,0.06896551724137931,1.0,0.07692307692307693,0.5
Combined oxidative phosphorylation defect type 13,38594,12,2,24,0,24,18,0,18,0.0,0.0,0.0,0.0,0.0,0.0
Severe intellectual disability-poor language-strabismus-grimacing face-long fingers syndrome,29425,4,0,50,0,50,34,0,34,0.0,0.0,0.0,0.0,0.0,0.0
Intellectual disability-facial dysmorphism syndrome due to SETD5 haploinsufficiency,29365,2,4,19,2,17,37,2,35,0.5,0.5,0.10526315789473684,0.5,0.05405405405405406,0.5
SLC35A2-CDG,29977,0,7,17,2,15,21,0,21,0.2857142857142857,0.0,0.11764705882352941,0.2857142857142857,0.0,0.0
Medium chain acyl-CoA dehydrogenase deficiency,38510,15,0,27,0,27,27,0,27,0.0,0.0,0.0,0.0,0.0,0.0
Dysferlin-related limb-girdle muscular dystrophy R2,27315,9,1,31,0,31,25,0,25,0.0,0.0,0.0,0.0,0.0,0.0
Very long chain acyl-CoA dehydrogenase deficiency,38510,19,0,29,0,29,36,0,36,0.0,0.0,0.0,0.0,0.0,0.0
Tenosynovial giant cell tumor,36638,18,1,28,0,28,27,0,27,0.0,0.0,0.0,0.0,0.0,0.0
Young-onset Parkinson disease,28547,7,1,20,1,19,20,1,19,1.0,1.0,0.05,1.0,0.05,1.0
"X-linked intellectual disability, Schimke type",28944,2,0,22,0,22,32,0,32,0.0,0.0,0.0,0.0,0.0,0.0
"X-linked intellectual disability, Stocco Dos Santos type",28859,0,0,21,0,21,17,0,17,0.0,0.0,0.0,0.0,0.0,0.0
"X-linked intellectual disability, Wilson type",27603,1,0,26,0,26,23,0,23,0.0,0.0,0.0,0.0,0.0,0.0
Early-onset progressive diffuse brain atrophy-microcephaly-muscle weakness-optic atrophy syndrome,28546,5,6,62,7,55,24,2,22,1.1666666666666667,0.3333333333333333,0.11290322580645161,1.1666666666666667,0.08333333333333333,0.3333333333333333
Micrognathia-recurrent infections-behavioral abnormalities-mild intellectual disability syndrome,31611,3,3,17,1,16,30,1,29,0.3333333333333333,0.3333333333333333,0.058823529411764705,0.3333333333333333,0.03333333333333333,0.3333333333333333
Alacrimia-choreoathetosis-liver dysfunction syndrome,28661,1,3,45,0,45,36,0,36,0.0,0.0,0.0,0.0,0.0,0.0
ADNP syndrome,29661,4,6,98,6,92,45,0,45,1.0,0.0,0.061224489795918366,1.0,0.0,0.0
TARP syndrome,30719,1,4,48,4,44,23,0,23,1.0,0.0,0.08333333333333333,1.0,0.0,0.0
Tatton-Brown-Rahman syndrome,29516,1,2,20,1,19,30,0,30,0.5,0.0,0.05,0.5,0.0,0.0
Juvenile nasopharyngeal angiofibroma,32610,7,1,16,0,16,34,0,34,0.0,0.0,0.0,0.0,0.0,0.0
Malan overgrowth syndrome,31787,1,1,41,1,40,43,0,43,1.0,0.0,0.024390243902439025,1.0,0.0,0.0
Birk-Barel syndrome,29256,0,0,38,0,38,30,0,30,0.0,0.0,0.0,0.0,0.0,0.0
Pontocerebellar hypoplasia type 7,27907,2,0,17,0,17,16,0,16,0.0,0.0,0.0,0.0,0.0,0.0
Isolated childhood apraxia of speech,30522,3,2,17,2,15,8,0,8,1.0,0.0,0.11764705882352941,1.0,0.0,0.0
Early infantile epileptic encephalopathy,28025,2,6,17,3,14,29,1,28,0.5,0.16666666666666666,0.17647058823529413,0.5,0.034482758620689655,0.16666666666666666
Genetic epilepsy with febrile seizure plus,33026,4,1,21,0,21,15,0,15,0.0,0.0,0.0,0.0,0.0,0.0
Intermediate uveitis,33511,3,0,18,0,18,32,0,32,0.0,0.0,0.0,0.0,0.0,0.0
Citrullinemia type II,31702,5,4,17,1,16,31,0,31,0.25,0.0,0.058823529411764705,0.25,0.0,0.0
Pancreatic triacylglycerol lipase deficiency,28401,6,0,17,0,17,27,0,27,0.0,0.0,0.0,0.0,0.0,0.0
Apparent mineralocorticoid excess,27657,4,3,17,2,15,22,3,19,0.6666666666666666,1.0,0.11764705882352941,0.6666666666666666,0.13636363636363635,1.0
Citrullinemia type I,31702,5,2,17,1,16,23,0,23,0.5,0.0,0.058823529411764705,0.5,0.0,0.0
DYRK1A-related intellectual disability syndrome,33278,2,8,22,5,17,27,1,26,0.625,0.125,0.22727272727272727,0.625,0.037037037037037035,0.125
Microcephaly-corpus callosum and cerebellar vermis hypoplasia-facial dysmorphism-intellectual disability syndrom,29190,2,2,17,2,15,28,1,27,1.0,0.5,0.11764705882352941,1.0,0.03571428571428571,0.5
Severe intellectual disability-progressive spastic diplegia syndrome,28602,3,7,37,5,32,33,3,30,0.7142857142857143,0.42857142857142855,0.13513513513513514,0.7142857142857143,0.09090909090909091,0.42857142857142855
Idiopathic panuveitis,33531,4,0,18,0,18,20,0,20,0.0,0.0,0.0,0.0,0.0,0.0
Macrocephaly-intellectual disability-neurodevelopmental disorder-small thorax syndrome,29678,3,3,36,3,33,31,2,29,1.0,0.6666666666666666,0.08333333333333333,1.0,0.06451612903225806,0.6666666666666666
Early-onset familial hypoaldosteronism,33456,1,6,16,3,13,31,1,30,0.5,0.16666666666666666,0.1875,0.5,0.03225806451612903,0.16666666666666666
Late-onset familial hypoaldosteronism,33456,0,0,16,0,16,20,0,20,0.0,0.0,0.0,0.0,0.0,0.0
Congenital total pulmonary venous return anomaly,30720,4,1,22,1,21,30,1,29,1.0,1.0,0.045454545454545456,1.0,0.03333333333333333,1.0
Posterior urethral valve,32917,5,3,17,4,13,34,1,33,1.3333333333333333,0.3333333333333333,0.23529411764705882,1.3333333333333333,0.029411764705882353,0.3333333333333333
Infantile osteopetrosis with neuroaxonal dysplasia,31119,1,0,16,0,16,30,0,30,0.0,0.0,0.0,0.0,0.0,0.0
Polyembryoma,33007,2,0,17,0,17,30,0,30,0.0,0.0,0.0,0.0,0.0,0.0
Asherman syndrome,29997,0,0,36,0,36,20,0,20,0.0,0.0,0.0,0.0,0.0,0.0
Cleft lip and alveolus,33455,0,1,16,1,15,27,0,27,1.0,0.0,0.0625,1.0,0.0,0.0
Airway infantile hemangioma,95135,19,1,26,1,25,27,1,26,1.0,1.0,0.038461538461538464,1.0,0.037037037037037035,1.0
Idiopathic intracranial hypertension,38066,15,2,18,1,17,19,1,18,0.5,0.5,0.05555555555555555,0.5,0.05263157894736842,0.5
Intermediate osteopetrosis,38358,12,1,24,1,23,24,0,24,1.0,0.0,0.041666666666666664,1.0,0.0,0.0
Cleft lip/palate,28138,2,1,20,0,20,20,0,20,0.0,0.0,0.0,0.0,0.0,0.0
Idiopathic uveal effusion syndrome,27683,6,1,18,2,16,24,0,24,2.0,0.0,0.1111111111111111,2.0,0.0,0.0
Isolated cleft lip,32177,0,0,16,0,16,31,0,31,0.0,0.0,0.0,0.0,0.0,0.0
Neurotrophic keratopathy,32879,7,2,17,2,15,20,0,20,1.0,0.0,0.11764705882352941,1.0,0.0,0.0
Cleft velum,30842,3,0,22,0,22,16,0,16,0.0,0.0,0.0,0.0,0.0,0.0
Panner disease,32475,0,2,14,3,11,21,0,21,1.5,0.0,0.21428571428571427,1.5,0.0,0.0
Pediatric systemic lupus erythematosus,33534,4,3,17,0,17,25,0,25,0.0,0.0,0.0,0.0,0.0,0.0
Secondary short bowel syndrome,32322,3,0,17,0,17,22,0,22,0.0,0.0,0.0,0.0,0.0,0.0
Eisenmenger syndrome,32244,1,3,17,1,16,25,1,24,0.3333333333333333,0.3333333333333333,0.058823529411764705,0.3333333333333333,0.04,0.3333333333333333
Osgood-Schlatter disease,32476,4,1,19,1,18,16,1,15,1.0,1.0,0.05263157894736842,1.0,0.0625,1.0
Sinding-Larsen-Johansson disease,32478,2,1,7,1,6,12,1,11,1.0,1.0,0.14285714285714285,1.0,0.08333333333333333,1.0
Severe acute respiratory syndrome,33390,5,1,18,1,17,20,1,19,1.0,1.0,0.05555555555555555,1.0,0.05,1.0
Congenital tracheal stenosis,32205,4,1,23,1,22,26,0,26,1.0,0.0,0.043478260869565216,1.0,0.0,0.0
Dietary iron overload disease,29761,1,1,27,1,26,29,0,29,1.0,0.0,0.037037037037037035,1.0,0.0,0.0
Choanal atresia,32224,8,0,20,0,20,34,0,34,0.0,0.0,0.0,0.0,0.0,0.0
Esophageal atresia,33615,12,1,22,0,22,35,0,35,0.0,0.0,0.0,0.0,0.0,0.0
Solitary fibrous tumor,33355,2,0,28,0,28,27,0,27,0.0,0.0,0.0,0.0,0.0,0.0
Psoriasis-related juvenile idiopathic arthritis,32727,4,1,16,0,16,33,0,33,0.0,0.0,0.0,0.0,0.0,0.0
Solitary bone cyst,32308,1,1,17,1,16,30,0,30,1.0,0.0,0.058823529411764705,1.0,0.0,0.0
Familial avascular necrosis of femoral head,32914,6,2,13,1,12,15,1,14,0.5,0.5,0.07692307692307693,0.5,0.06666666666666667,0.5
AGel amyloidosis,33159,4,6,18,0,18,35,0,35,0.0,0.0,0.0,0.0,0.0,0.0
Biemond syndrome type 2,28617,3,12,23,9,14,30,0,30,0.75,0.0,0.391304347826087,0.75,0.0,0.0
Acquired idiopathic sideroblastic anemia,29390,1,2,17,2,15,33,0,33,1.0,0.0,0.11764705882352941,1.0,0.0,0.0
Chronic visceral acid sphingomyelinase deficiency,98936,7,0,12,0,12,36,0,36,0.0,0.0,0.0,0.0,0.0,0.0
Proximal 16p11.2 microduplication syndrome,33180,3,21,17,2,15,33,4,29,0.09523809523809523,0.19047619047619047,0.11764705882352941,0.09523809523809523,0.12121212121212122,0.19047619047619047
MEND syndrome,30175,0,2,16,0,16,15,0,15,0.0,0.0,0.0,0.0,0.0,0.0
Myelodysplastic neoplasm with increased blasts,95113,19,2,32,1,31,28,1,27,0.5,0.5,0.03125,0.5,0.03571428571428571,0.5
Acute panmyelosis with myelofibrosis,32843,3,2,17,2,15,17,1,16,1.0,0.5,0.11764705882352941,1.0,0.058823529411764705,0.5
Myelodysplastic syndrome associated with isolated del(5q) chromosome abnormality,28311,1,1,19,2,17,24,0,24,2.0,0.0,0.10526315789473684,2.0,0.0,0.0
Unclassified myelodysplastic syndrome,28813,10,1,18,0,18,23,0,23,0.0,0.0,0.0,0.0,0.0,0.0
Myelodysplastic neoplasm with low blasts,39579,23,2,30,0,30,28,0,28,0.0,0.0,0.0,0.0,0.0,0.0
Juvenile glaucoma,30583,2,0,16,0,16,14,0,14,0.0,0.0,0.0,0.0,0.0,0.0
Macular corneal dystrophy,30135,5,4,16,5,11,22,0,22,1.25,0.0,0.3125,1.25,0.0,0.0
Gestational choriocarcinoma,32511,8,6,27,4,23,20,0,20,0.6666666666666666,0.0,0.14814814814814814,0.6666666666666666,0.0,0.0
Microtia,31577,6,2,16,0,16,21,0,21,0.0,0.0,0.0,0.0,0.0,0.0
Hydranencephaly,27804,0,7,17,6,11,24,0,24,0.8571428571428571,0.0,0.35294117647058826,0.8571428571428571,0.0,0.0
Central areolar choroidal dystrophy,96983,16,2,37,0,37,25,0,25,0.0,0.0,0.0,0.0,0.0,0.0
Chronic thromboembolic pulmonary hypertension,33068,5,3,17,2,15,18,1,17,0.6666666666666666,0.3333333333333333,0.11764705882352941,0.6666666666666666,0.05555555555555555,0.3333333333333333
Adult acute respiratory distress syndrome,33063,3,5,16,5,11,26,3,23,1.0,0.6,0.3125,1.0,0.11538461538461539,0.6
Childhood absence epilepsy,33115,2,2,19,1,18,28,0,28,0.5,0.0,0.05263157894736842,0.5,0.0,0.0
Dopamine beta-hydroxylase deficiency,30860,3,4,17,2,15,26,2,24,0.5,0.5,0.11764705882352941,0.5,0.07692307692307693,0.5
Peripartum cardiomyopathy,33304,3,0,17,0,17,23,0,23,0.0,0.0,0.0,0.0,0.0,0.0
Xq25 microduplication syndrome,31102,2,0,17,0,17,29,0,29,0.0,0.0,0.0,0.0,0.0,0.0
ANE syndrome,31157,0,0,17,0,17,15,0,15,0.0,0.0,0.0,0.0,0.0,0.0
Retinitis punctata albescens,32548,3,5,20,5,15,23,1,22,1.0,0.2,0.25,1.0,0.043478260869565216,0.2
Immune dysregulation-polyendocrinopathy-enteropathy-X-linked syndrome,31513,3,1,58,2,56,10,0,10,2.0,0.0,0.034482758620689655,2.0,0.0,0.0
IgG4-related retroperitoneal fibrosis,32797,3,1,22,2,20,21,1,20,2.0,1.0,0.09090909090909091,2.0,0.047619047619047616,1.0
Idiopathic bronchiectasis,32537,3,4,16,4,12,16,1,15,1.0,0.25,0.25,1.0,0.0625,0.25
Recurrent respiratory papillomatosis,31921,9,1,18,1,17,25,1,24,1.0,1.0,0.05555555555555555,1.0,0.04,1.0
Primary membranoproliferative glomerulonephritis,94687,17,1,23,0,23,30,0,30,0.0,0.0,0.0,0.0,0.0,0.0
Medial condensing osteitis of the clavicle,32297,6,0,16,0,16,17,0,17,0.0,0.0,0.0,0.0,0.0,0.0
Graft versus host disease,97057,20,1,26,1,25,22,1,21,1.0,1.0,0.038461538461538464,1.0,0.045454545454545456,1.0
Acquired purpura fulminans,39484,15,0,30,0,30,26,0,26,0.0,0.0,0.0,0.0,0.0,0.0
T-B+ severe combined immunodeficiency due to JAK3 deficiency,31572,1,4,23,2,21,32,0,32,0.5,0.0,0.08695652173913043,0.5,0.0,0.0
FRAXE intellectual disability,31304,2,0,16,0,16,32,0,32,0.0,0.0,0.0,0.0,0.0,0.0
Hyperinsulinism-hyperammonemia syndrome,28314,14,2,30,0,30,24,0,24,0.0,0.0,0.0,0.0,0.0,0.0
CK syndrome,27705,0,29,19,9,10,25,0,25,0.3103448275862069,0.0,0.47368421052631576,0.3103448275862069,0.0,0.0
Acute monoblastic/monocytic leukemia,29863,3,1,17,0,17,28,0,28,0.0,0.0,0.0,0.0,0.0,0.0
Congenital factor X deficiency,30586,3,4,17,4,13,23,2,21,1.0,0.5,0.23529411764705882,1.0,0.08695652173913043,0.5
Optic pathway glioma,33318,3,0,18,0,18,35,0,35,0.0,0.0,0.0,0.0,0.0,0.0
Adult idiopathic neutropenia,27740,3,2,15,2,13,35,1,34,1.0,0.5,0.13333333333333333,1.0,0.02857142857142857,0.5
Hereditary elliptocytosis,32434,3,1,19,2,17,23,2,21,2.0,2.0,0.10526315789473684,2.0,0.08695652173913043,2.0
Idiopathic aplastic anemia,27664,10,2,22,2,20,17,1,16,1.0,0.5,0.09090909090909091,1.0,0.058823529411764705,0.5
Fetal and neonatal alloimmune thrombocytopenia,37629,17,1,24,0,24,24,0,24,0.0,0.0,0.0,0.0,0.0,0.0
Lysinuric protein intolerance,29923,2,1,25,0,25,21,0,21,0.0,0.0,0.0,0.0,0.0,0.0
Hereditary spherocytosis,27542,4,1,17,0,17,26,0,26,0.0,0.0,0.0,0.0,0.0,0.0
Sarcosinemia,30971,0,2,18,1,17,33,0,33,0.5,0.0,0.05555555555555555,0.5,0.0,0.0
Cystathioninuria,29708,1,1,9,0,9,10,0,10,0.0,0.0,0.0,0.0,0.0,0.0
Congenital factor II deficiency,27656,5,3,24,2,22,17,0,17,0.6666666666666666,0.0,0.08333333333333333,0.6666666666666666,0.0,0.0
Non-involuting congenital hemangioma,32222,0,1,23,1,22,8,2,6,1.0,2.0,0.043478260869565216,1.0,0.25,2.0
Kasabach-Merritt phenomenon,28851,5,3,18,3,15,28,2,26,1.0,0.6666666666666666,0.16666666666666666,1.0,0.07142857142857142,0.6666666666666666
Polyarteritis nodosa,32986,3,1,21,1,20,24,0,24,1.0,0.0,0.047619047619047616,1.0,0.0,0.0
Rapidly involuting congenital hemangioma,32222,1,1,18,1,17,12,2,10,1.0,2.0,0.05555555555555555,1.0,0.16666666666666666,2.0
Acute myelomonocytic leukemia,84319,19,3,25,4,21,22,1,21,1.3333333333333333,0.3333333333333333,0.16,1.3333333333333333,0.045454545454545456,0.3333333333333333
Acute erythroid leukemia,32256,2,0,21,0,21,23,0,23,0.0,0.0,0.0,0.0,0.0,0.0
Brugada syndrome,28198,5,0,18,0,18,29,0,29,0.0,0.0,0.0,0.0,0.0,0.0
Hypocalcemic vitamin D-dependent rickets,31053,2,31,23,13,10,26,4,22,0.41935483870967744,0.12903225806451613,0.5652173913043478,0.41935483870967744,0.15384615384615385,0.12903225806451613
Acquired methemoglobinemia,30126,15,1,21,0,21,22,0,22,0.0,0.0,0.0,0.0,0.0,0.0
Familial glucocorticoid deficiency,27648,1,9,28,8,20,22,1,21,0.8888888888888888,0.1111111111111111,0.2857142857142857,0.8888888888888888,0.045454545454545456,0.1111111111111111
Beta-ketothiolase deficiency,30683,2,8,17,5,12,26,0,26,0.625,0.0,0.29411764705882354,0.625,0.0,0.0
Autoimmune lymphoproliferative syndrome,28015,4,4,119,7,112,30,1,29,1.75,0.25,0.058823529411764705,1.75,0.03333333333333333,0.25
Secondary hypoparathyroidism due to impaired parathormon secretion,31288,6,1,19,0,19,20,0,20,0.0,0.0,0.0,0.0,0.0,0.0
Tufted angioma,30820,3,0,17,0,17,27,0,27,0.0,0.0,0.0,0.0,0.0,0.0
Hereditary thrombophilia due to congenital antithrombin deficiency,30094,5,2,17,2,15,26,0,26,1.0,0.0,0.11764705882352941,1.0,0.0,0.0
Castleman disease,98712,15,1,23,0,23,20,0,20,0.0,0.0,0.0,0.0,0.0,0.0
MODY,31184,3,0,33,0,33,17,0,17,0.0,0.0,0.0,0.0,0.0,0.0
Primary myelofibrosis,27610,5,1,20,1,19,32,0,32,1.0,0.0,0.05,1.0,0.0,0.0
Acute promyelocytic leukemia,29361,7,0,18,0,18,34,0,34,0.0,0.0,0.0,0.0,0.0,0.0
Dystonia-parkinsonism-hypermanganesemia syndrome,28480,4,0,23,0,23,29,0,29,0.0,0.0,0.0,0.0,0.0,0.0
Familial dilated cardiomyopathy with conduction defect due to LMNA mutation,32609,11,2,21,1,20,21,1,20,0.5,0.5,0.047619047619047616,0.5,0.047619047619047616,0.5
Verrucous hemangioma,33276,3,1,13,0,13,20,0,20,0.0,0.0,0.0,0.0,0.0,0.0
Double outlet right ventricle,33375,4,2,25,2,23,30,1,29,1.0,0.5,0.08,1.0,0.03333333333333333,0.5
Tricuspid atresia,32760,6,3,16,2,14,19,1,18,0.6666666666666666,0.3333333333333333,0.125,0.6666666666666666,0.05263157894736842,0.3333333333333333
Primary hyperoxaluria,29946,5,2,19,1,18,21,1,20,0.5,0.5,0.05263157894736842,0.5,0.047619047619047616,0.5
Congenital muscular dystrophy with intellectual disability,29208,1,5,87,4,83,24,1,23,0.8,0.2,0.04597701149425287,0.8,0.041666666666666664,0.2
Idiopathic hypereosinophilic syndrome,28414,7,1,76,1,75,26,0,26,1.0,0.0,0.013157894736842105,1.0,0.0,0.0
Hyperammonemia due to N-acetylglutamate synthase deficiency,29034,3,1,17,1,16,28,1,27,1.0,1.0,0.058823529411764705,1.0,0.03571428571428571,1.0
9p13 microdeletion syndrome,32409,1,8,19,3,16,19,0,19,0.375,0.0,0.15789473684210525,0.375,0.0,0.0
3q27.3 microdeletion syndrome,33028,2,16,19,9,10,29,0,29,0.5625,0.0,0.47368421052631576,0.5625,0.0,0.0
Congenital factor XIII deficiency,27869,5,3,19,1,18,15,0,15,0.3333333333333333,0.0,0.05263157894736842,0.3333333333333333,0.0,0.0
3-methylglutaconic aciduria type 9,28809,5,18,112,18,94,27,2,25,1.0,0.1111111111111111,0.16071428571428573,1.0,0.07407407407407407,0.1111111111111111
3-methylglutaconic aciduria-neonatal cataract-neurologic involvement-congenital neutropenia syndrome,29807,4,6,40,4,36,32,2,30,0.6666666666666666,0.3333333333333333,0.1,0.6666666666666666,0.0625,0.3333333333333333
Subcutaneous panniculitis-like T-cell lymphoma,29698,4,2,16,2,14,18,0,18,1.0,0.0,0.125,1.0,0.0,0.0
3-hydroxy-3-methylglutaric aciduria,28809,10,4,51,1,50,35,0,35,0.25,0.0,0.0196078431372549,0.25,0.0,0.0
Incessant infant ventricular tachycardia,27703,4,6,21,6,15,23,1,22,1.0,0.16666666666666666,0.2857142857142857,1.0,0.043478260869565216,0.16666666666666666
Combined immunodeficiency due to ZAP70 deficiency,27177,0,4,23,3,20,19,0,19,0.75,0.0,0.13043478260869565,0.75,0.0,0.0
Heparin-induced thrombocytopenia,32563,3,3,15,3,12,23,0,23,1.0,0.0,0.2,1.0,0.0,0.0
Hereditary fructose intolerance,27426,6,2,16,1,15,18,1,17,0.5,0.5,0.0625,0.5,0.05555555555555555,0.5
"Fructose-1,6-bisphosphatase deficiency",30542,1,4,17,4,13,18,2,16,1.0,0.5,0.23529411764705882,1.0,0.1111111111111111,0.5
Immunodeficiency by defective expression of MHC class II,31044,0,4,21,1,20,19,1,18,0.25,0.25,0.047619047619047616,0.25,0.05263157894736842,0.25
T-B+ severe combined immunodeficiency due to gamma chain deficiency,30284,5,8,32,5,27,28,1,27,0.625,0.125,0.15625,0.625,0.03571428571428571,0.125
Gitelman syndrome,31556,6,1,17,0,17,28,1,27,0.0,1.0,0.0,0.0,0.03571428571428571,1.0
Neurodevelopmental delay-seizures-ophthalmic anomalies-osteopenia-cerebellar atrophy syndrome,28046,3,2,16,1,15,31,0,31,0.5,0.0,0.0625,0.5,0.0,0.0
Autosomal dominant severe congenital neutropenia,33449,2,3,17,3,14,27,1,26,1.0,0.3333333333333333,0.17647058823529413,1.0,0.037037037037037035,0.3333333333333333
Severe combined immunodeficiency due to DCLRE1C deficiency,29553,0,0,17,0,17,23,0,23,0.0,0.0,0.0,0.0,0.0,0.0
Mohr-Tranebjaerg syndrome,31824,1,0,21,0,21,31,0,31,0.0,0.0,0.0,0.0,0.0,0.0
Congenital muscular dystrophy with cerebellar involvement,30361,4,4,18,0,18,30,0,30,0.0,0.0,0.0,0.0,0.0,0.0
Female restricted epilepsy with intellectual disability,29601,2,1,16,0,16,25,0,25,0.0,0.0,0.0,0.0,0.0,0.0
Hyperekplexia-epilepsy syndrome,98352,12,0,21,0,21,40,0,40,0.0,0.0,0.0,0.0,0.0,0.0
Mosaic trisomy 1 syndrome,33389,0,0,36,0,36,25,0,25,0.0,0.0,0.0,0.0,0.0,0.0
PMM2-CDG,28471,3,3,17,0,17,26,0,26,0.0,0.0,0.0,0.0,0.0,0.0
Adenylosuccinate synthetase-like 1-related distal myopathy,27734,0,3,19,1,18,20,0,20,0.3333333333333333,0.0,0.05263157894736842,0.3333333333333333,0.0,0.0
Miyoshi myopathy,27704,0,0,14,0,14,19,0,19,0.0,0.0,0.0,0.0,0.0,0.0
Distal deletion 12q syndrome,32653,0,0,18,0,18,11,0,11,0.0,0.0,0.0,0.0,0.0,0.0
Distal myopathy with posterior leg and anterior hand involvement,28689,0,5,17,0,17,14,1,13,0.0,0.2,0.0,0.0,0.07142857142857142,0.2
Oculopharyngodistal myopathy,31614,5,7,18,2,16,29,2,27,0.2857142857142857,0.2857142857142857,0.1111111111111111,0.2857142857142857,0.06896551724137931,0.2857142857142857
"Late-onset distal myopathy, Markesbery-Griggs type",28689,4,0,18,0,18,27,0,27,0.0,0.0,0.0,0.0,0.0,0.0
Desminopathy,38446,15,3,18,0,18,28,0,28,0.0,0.0,0.0,0.0,0.0,0.0
Juvenile polyposis syndrome,31795,2,4,14,1,13,20,0,20,0.25,0.0,0.07142857142857142,0.25,0.0,0.0
Turcot syndrome with polyposis,32298,2,6,17,3,14,26,1,25,0.5,0.16666666666666666,0.17647058823529413,0.5,0.038461538461538464,0.16666666666666666
Generalized juvenile polyposis/juvenile polyposis coli,31795,2,1,17,1,16,18,0,18,1.0,0.0,0.058823529411764705,1.0,0.0,0.0
Juvenile polyposis of infancy,31795,3,4,17,1,16,28,3,25,0.25,0.75,0.058823529411764705,0.25,0.10714285714285714,0.75
Corticobasal syndrome,33381,5,3,16,2,14,19,2,17,0.6666666666666666,0.6666666666666666,0.125,0.6666666666666666,0.10526315789473684,0.6666666666666666
Progressive supranuclear palsy-pure akinesia with gait freezing syndrome,27637,2,3,18,3,15,20,2,18,1.0,0.6666666666666666,0.16666666666666666,1.0,0.1,0.6666666666666666
Progressive supranuclear palsy-corticobasal syndrome,27828,4,7,26,8,18,27,1,26,1.1428571428571428,0.14285714285714285,0.3076923076923077,1.1428571428571428,0.037037037037037035,0.14285714285714285
Progressive supranuclear palsy-progressive non-fluent aphasia syndrome,33466,4,7,17,4,13,18,1,17,0.5714285714285714,0.14285714285714285,0.23529411764705882,0.5714285714285714,0.05555555555555555,0.14285714285714285
Fatty acid hydroxylase-associated neurodegeneration,32709,3,4,28,3,25,29,1,28,0.75,0.25,0.10714285714285714,0.75,0.034482758620689655,0.25
Atypical progressive supranuclear palsy syndrome,27828,2,1,26,1,25,21,1,20,1.0,1.0,0.038461538461538464,1.0,0.047619047619047616,1.0
Progressive supranuclear palsy-predominant parkinsonism syndrome,27642,3,4,24,4,20,25,2,23,1.0,0.5,0.16666666666666666,1.0,0.08,0.5
Classic progressive supranuclear palsy syndrome,27828,5,3,27,2,25,31,1,30,0.6666666666666666,0.3333333333333333,0.07407407407407407,0.6666666666666666,0.03225806451612903,0.3333333333333333
Familial colorectal cancer Type X,27819,1,6,17,2,15,28,4,24,0.3333333333333333,0.6666666666666666,0.11764705882352941,0.3333333333333333,0.14285714285714285,0.6666666666666666
Autosomal recessive complex spastic paraplegia due to Kennedy pathway dysfunction,33076,1,10,19,9,10,22,0,22,0.9,0.0,0.47368421052631576,0.9,0.0,0.0
Autosomal dominant spastic paraplegia type 10,30156,2,3,26,3,23,28,0,28,1.0,0.0,0.11538461538461539,1.0,0.0,0.0
Autosomal recessive spastic paraplegia type 77,27668,0,1,15,1,14,16,0,16,1.0,0.0,0.06666666666666667,1.0,0.0,0.0
"X-linked intellectual disability, Hedera type",27603,2,2,28,2,26,33,1,32,1.0,0.5,0.07142857142857142,1.0,0.030303030303030304,0.5
Ataxia-oculomotor apraxia type 4,27817,2,1,19,2,17,3,1,2,2.0,1.0,0.10526315789473684,2.0,0.3333333333333333,1.0
Episodic ataxia type 3,27813,4,2,19,1,18,27,1,26,0.5,0.5,0.05263157894736842,0.5,0.037037037037037035,0.5
Autosomal recessive spastic paraplegia type 32,39424,15,3,30,1,29,29,1,28,0.3333333333333333,0.3333333333333333,0.03333333333333333,0.3333333333333333,0.034482758620689655,0.3333333333333333
Autosomal dominant polycystic kidney disease,28262,2,5,17,2,15,27,1,26,0.4,0.2,0.11764705882352941,0.4,0.037037037037037035,0.2
Idiopathic achalasia,27364,2,1,16,1,15,16,1,15,1.0,1.0,0.0625,1.0,0.0625,1.0
Iminoglycinuria,27825,2,3,27,2,25,31,0,31,0.6666666666666666,0.0,0.07407407407407407,0.6666666666666666,0.0,0.0
Meningococcal meningitis,84189,15,6,20,2,18,29,3,26,0.3333333333333333,0.5,0.1,0.3333333333333333,0.10344827586206896,0.5
Mucolipidosis type II,27333,0,13,18,2,16,26,1,25,0.15384615384615385,0.07692307692307693,0.1111111111111111,0.15384615384615385,0.038461538461538464,0.07692307692307693
Adenine phosphoribosyltransferase deficiency,29957,0,1,17,0,17,37,0,37,0.0,0.0,0.0,0.0,0.0,0.0
SUNCT syndrome,32399,3,3,17,4,13,45,0,45,1.3333333333333333,0.0,0.23529411764705882,1.3333333333333333,0.0,0.0
Dentinogenesis imperfecta,38671,5,2,18,0,18,7,0,7,0.0,0.0,0.0,0.0,0.0,0.0
Meconium aspiration syndrome,33075,2,0,16,0,16,18,0,18,0.0,0.0,0.0,0.0,0.0,0.0
Enlarged parietal foramina,27853,2,1,21,0,21,23,0,23,0.0,0.0,0.0,0.0,0.0,0.0
Acute interstitial pneumonia,33385,4,11,17,3,14,23,1,22,0.2727272727272727,0.09090909090909091,0.17647058823529413,0.2727272727272727,0.043478260869565216,0.09090909090909091
Familial isolated restrictive cardiomyopathy,32672,2,1,16,1,15,28,0,28,1.0,0.0,0.0625,1.0,0.0,0.0
Leprechaunism,94931,13,8,24,0,24,24,1,23,0.0,0.125,0.0,0.0,0.041666666666666664,0.125
Achondroplasia,28484,1,5,20,6,14,27,1,26,1.2,0.2,0.3,1.2,0.037037037037037035,0.2
Amelogenesis imperfecta,28782,6,2,20,2,18,7,2,5,1.0,1.0,0.1,1.0,0.2857142857142857,1.0
Sepsis in premature infants,30892,7,5,17,3,14,23,1,22,0.6,0.2,0.17647058823529413,0.6,0.043478260869565216,0.2
Posterior polymorphous corneal dystrophy,28828,4,2,17,2,15,21,0,21,1.0,0.0,0.11764705882352941,1.0,0.0,0.0
Infantile Krabbe disease,33182,6,13,61,12,49,23,3,20,0.9230769230769231,0.23076923076923078,0.19672131147540983,0.9230769230769231,0.13043478260869565,0.23076923076923078
Late-infantile/juvenile Krabbe disease,33145,3,2,18,0,18,26,0,26,0.0,0.0,0.0,0.0,0.0,0.0
Adult Krabbe disease,33153,1,2,40,2,38,11,0,11,1.0,0.0,0.05,1.0,0.0,0.0
Limbal stem cell deficiency,32509,6,0,15,0,15,19,0,19,0.0,0.0,0.0,0.0,0.0,0.0
Primary Sjögren syndrome,28764,5,2,71,2,69,22,0,22,1.0,0.0,0.028169014084507043,1.0,0.0,0.0
Oculocutaneous albinism type 1,84278,17,14,33,3,30,33,3,30,0.21428571428571427,0.21428571428571427,0.09090909090909091,0.21428571428571427,0.09090909090909091,0.21428571428571427
Moderate hemophilia A,27361,7,3,26,3,23,34,2,32,1.0,0.6666666666666666,0.11538461538461539,1.0,0.058823529411764705,0.6666666666666666
Bleeding disorder in hemophilia A carriers,27498,10,2,22,2,20,30,0,30,1.0,0.0,0.09090909090909091,1.0,0.0,0.0
Localized junctional epidermolysis bullosa,27638,4,2,27,1,26,19,2,17,0.5,1.0,0.037037037037037035,0.5,0.10526315789473684,1.0
Progressive multifocal leukoencephalopathy,28636,6,8,19,0,19,32,0,32,0.0,0.0,0.0,0.0,0.0,0.0
Generalized pseudohypoaldosteronism type 1,28487,2,6,17,3,14,34,1,33,0.5,0.16666666666666666,0.17647058823529413,0.5,0.029411764705882353,0.16666666666666666
C3 glomerulopathy,30821,10,1,15,1,14,17,1,16,1.0,1.0,0.06666666666666667,1.0,0.058823529411764705,1.0
Snakebite envenomation,32792,1,1,16,1,15,23,0,23,1.0,0.0,0.0625,1.0,0.0,0.0
Tall stature-intellectual disability-renal anomalies syndrome,28796,2,0,18,0,18,30,0,30,0.0,0.0,0.0,0.0,0.0,0.0
Combined oxidative phosphorylation defect type 7,38594,19,3,26,0,26,27,0,27,0.0,0.0,0.0,0.0,0.0,0.0
Congenital labioscrotal agenesis-cerebellar malformation-corneal dystrophy-facial dysmorphism syndrome,32682,2,11,17,4,13,24,1,23,0.36363636363636365,0.09090909090909091,0.23529411764705882,0.36363636363636365,0.041666666666666664,0.09090909090909091
Severe neurodevelopmental disorder with feeding difficulties-stereotypic hand movement-bilateral cataract,29669,3,7,18,0,18,36,0,36,0.0,0.0,0.0,0.0,0.0,0.0
Polyhydramnios-megalencephaly-symptomatic epilepsy syndrome,29767,1,8,21,6,15,1,1,0,0.75,0.125,0.2857142857142857,0.75,1.0,0.125
Childhood-onset motor and cognitive regression syndrome with extrapyramidal movement disorder,30027,4,8,22,6,16,28,5,23,0.75,0.625,0.2727272727272727,0.75,0.17857142857142858,0.625
Early-onset progressive encephalopathy-hearing loss-pons hypoplasia-brain atrophy syndrome,30113,5,0,19,0,19,26,0,26,0.0,0.0,0.0,0.0,0.0,0.0
Gabriele-de Vries syndrome,30722,1,6,24,1,23,31,2,29,0.16666666666666666,0.3333333333333333,0.041666666666666664,0.16666666666666666,0.06451612903225806,0.3333333333333333
CDKL5-deficiency disorder,38814,18,1,32,0,32,25,0,25,0.0,0.0,0.0,0.0,0.0,0.0
Mucopolysaccharidosis-like syndrome with congenital heart defects and hematopoietic disorders,31580,5,10,17,2,15,33,3,30,0.2,0.3,0.11764705882352941,0.2,0.09090909090909091,0.3
Intellectual disability-seizures-abnormal gait-facial dysmorphism syndrome,38365,14,7,20,1,19,38,2,36,0.14285714285714285,0.2857142857142857,0.05,0.14285714285714285,0.05263157894736842,0.2857142857142857
Congenital progressive bone marrow failure-B-cell immunodeficiency-skeletal dysplasia syndrome,32406,3,2,18,0,18,31,1,30,0.0,0.5,0.0,0.0,0.03225806451612903,0.5
Prader-Willi syndrome,32961,5,10,54,4,50,34,5,29,0.4,0.5,0.07407407407407407,0.4,0.14705882352941177,0.5
Tuberous sclerosis complex,31194,7,8,24,4,20,22,1,21,0.5,0.125,0.16666666666666666,0.5,0.045454545454545456,0.125
Infantile hypotonia-oculomotor anomalies-hyperkinetic movements-developmental delay syndrome,29711,1,6,18,4,14,29,0,29,0.6666666666666666,0.0,0.2222222222222222,0.6666666666666666,0.0,0.0
Mucopolysaccharidosis type 2,27436,10,6,19,3,16,22,3,19,0.5,0.5,0.15789473684210525,0.5,0.13636363636363635,0.5
Dravet syndrome,84256,20,3,36,0,36,40,1,39,0.0,0.3333333333333333,0.0,0.0,0.025,0.3333333333333333
Beta-thalassemia intermedia,33434,4,4,21,3,18,29,1,28,0.75,0.25,0.14285714285714285,0.75,0.034482758620689655,0.25
Methylcobalamin deficiency type cblE,27539,1,3,17,0,17,21,0,21,0.0,0.0,0.0,0.0,0.0,0.0
Rabson-Mendenhall syndrome,28382,0,0,18,0,18,21,0,21,0.0,0.0,0.0,0.0,0.0,0.0
"Alpha-mannosidosis, infantile form",99138,11,10,26,2,24,37,1,36,0.2,0.1,0.07692307692307693,0.2,0.02702702702702703,0.1
Severe Canavan disease,30772,2,11,16,1,15,25,1,24,0.09090909090909091,0.09090909090909091,0.0625,0.09090909090909091,0.04,0.09090909090909091
Glycogen storage disease due to muscle glycogen phosphorylase deficiency,27292,4,5,28,0,28,24,0,24,0.0,0.0,0.0,0.0,0.0,0.0
Glycogen storage disease due to liver glycogen phosphorylase deficiency,32796,3,2,17,0,17,19,1,18,0.0,0.5,0.0,0.0,0.05263157894736842,0.5
"Alpha-mannosidosis, adult form",99138,16,2,29,0,29,40,0,40,0.0,0.0,0.0,0.0,0.0,0.0
Glycogen storage disease due to glycogen branching enzyme deficiency,98357,15,6,27,2,25,30,2,28,0.3333333333333333,0.3333333333333333,0.07407407407407407,0.3333333333333333,0.06666666666666667,0.3333333333333333
Microcephaly-intellectual disability-sensorineural hearing loss-epilepsy-abnormal muscle tone syndrome,31287,3,5,19,1,18,26,2,24,0.2,0.4,0.05263157894736842,0.2,0.07692307692307693,0.4
Progressive spondyloepimetaphyseal dysplasia-short stature-short fourth metatarsals-intellectual disability syndrome,31488,3,30,28,12,16,25,5,20,0.4,0.16666666666666666,0.42857142857142855,0.4,0.2,0.16666666666666666
Intellectual disability-muscle weakness-short stature-facial dysmorphism syndrome,32255,3,0,18,0,18,28,0,28,0.0,0.0,0.0,0.0,0.0,0.0
Acatalasemia,32009,0,1,17,0,17,29,0,29,0.0,0.0,0.0,0.0,0.0,0.0
Microcephaly-corpus callosum hypoplasia-intellectual disability-facial dysmorphism syndrome,29511,1,2,39,2,37,21,2,19,1.0,1.0,0.05128205128205128,1.0,0.09523809523809523,1.0
Intellectual disability-macrocephaly-hypotonia-behavioral abnormalities syndrome,31131,2,6,20,1,19,25,1,24,0.16666666666666666,0.16666666666666666,0.05,0.16666666666666666,0.04,0.16666666666666666
Seizures-scoliosis-macrocephaly syndrome,31388,2,4,17,3,14,26,1,25,0.75,0.25,0.17647058823529413,0.75,0.038461538461538464,0.25
Intellectual disability-epilepsy-extrapyramidal syndrome,29601,2,6,21,2,19,30,1,29,0.3333333333333333,0.16666666666666666,0.09523809523809523,0.3333333333333333,0.03333333333333333,0.16666666666666666
WAC-related facial dysmorphism-developmental delay-behavioral abnormalities syndrome,30416,2,5,17,1,16,31,3,28,0.2,0.6,0.058823529411764705,0.2,0.0967741935483871,0.6
X-linked intellectual disability-cerebellar hypoplasia-spondylo-epiphyseal dysplasia syndrome,33433,4,3,55,4,51,27,0,27,1.3333333333333333,0.0,0.07272727272727272,1.3333333333333333,0.0,0.0
Craniofacial dysplasia-short stature-ectodermal anomalies-intellectual disability syndrome,29947,5,6,42,6,36,28,1,27,1.0,0.16666666666666666,0.14285714285714285,1.0,0.03571428571428571,0.16666666666666666
Corpus callosum agenesis-macrocephaly-hypertelorism syndrome,33432,10,3,26,3,23,37,1,36,1.0,0.3333333333333333,0.11538461538461539,1.0,0.02702702702702703,0.3333333333333333
PYCR2-related microcephaly-progressive leukoencephalopathy,32474,0,7,21,4,17,28,0,28,0.5714285714285714,0.0,0.19047619047619047,0.5714285714285714,0.0,0.0
16p12.1p12.3 triplication syndrome,32260,0,0,18,0,18,27,0,27,0.0,0.0,0.0,0.0,0.0,0.0
Pierpont syndrome,30736,0,10,18,2,16,34,0,34,0.2,0.0,0.1111111111111111,0.2,0.0,0.0
PMP22-RAI1 contiguous gene duplication syndrome,30406,1,6,26,3,23,19,0,19,0.5,0.0,0.11538461538461539,0.5,0.0,0.0
Palatal anomalies-widely spaced teeth-facial dysmorphism-developmental delay syndrome,31752,2,0,50,0,50,21,0,21,0.0,0.0,0.0,0.0,0.0,0.0
Recurrent metabolic encephalomyopathic crises-rhabdomyolysis-cardiac arrhythmia-intellectual disability syndrome,29006,2,7,18,1,17,17,1,16,0.14285714285714285,0.14285714285714285,0.05555555555555555,0.14285714285714285,0.058823529411764705,0.14285714285714285
Global developmental delay-visual anomalies-progressive cerebellar atrophy-truncal hypotonia syndrome,32864,1,7,19,1,18,29,0,29,0.14285714285714285,0.0,0.05263157894736842,0.14285714285714285,0.0,0.0
TELO2-related intellectual disability-neurodevelopmental disorder,27209,2,5,28,2,26,24,0,24,0.4,0.0,0.07142857142857142,0.4,0.0,0.0
9q33.3q34.11 microdeletion syndrome,32429,4,15,99,5,94,27,1,26,0.3333333333333333,0.06666666666666667,0.050505050505050504,0.3333333333333333,0.037037037037037035,0.06666666666666667
"Camptodactyly syndrome, Guadalajara type 3",27865,0,0,65,0,65,12,0,12,0.0,0.0,0.0,0.0,0.0,0.0
Transketolase deficiency,30944,0,4,20,4,16,28,0,28,1.0,0.0,0.2,1.0,0.0,0.0
Severe growth deficiency-strabismus-extensive dermal melanocytosis-intellectual disability syndrome,29388,4,4,39,4,35,38,0,38,1.0,0.0,0.10256410256410256,1.0,0.0,0.0
13q12.3 microdeletion syndrome,32429,2,0,16,0,16,21,0,21,0.0,0.0,0.0,0.0,0.0,0.0
Intellectual disability-coarse face-macrocephaly-cerebellar hypotrophy syndrome,38540,17,7,19,2,17,29,2,27,0.2857142857142857,0.2857142857142857,0.10526315789473684,0.2857142857142857,0.06896551724137931,0.2857142857142857
Severe hemophilia A,27361,5,2,26,2,24,33,0,33,1.0,0.0,0.07692307692307693,1.0,0.0,0.0
Macrocephaly-developmental delay syndrome,29174,4,0,17,0,17,38,0,38,0.0,0.0,0.0,0.0,0.0,0.0
Primary microcephaly-mild intellectual disability-young-onset diabetes syndrome,32976,3,6,27,5,22,28,2,26,0.8333333333333334,0.3333333333333333,0.18518518518518517,0.8333333333333334,0.07142857142857142,0.3333333333333333
FOXP1 Syndrome,39034,9,4,28,0,28,32,0,32,0.0,0.0,0.0,0.0,0.0,0.0
Severe intellectual disability-short stature-behavioral abnormalities-facial dysmorphism syndrome,31212,4,4,18,1,17,31,1,30,0.25,0.25,0.05555555555555555,0.25,0.03225806451612903,0.25
Hypotonia-speech impairment-severe cognitive delay syndrome,33544,2,9,50,10,40,27,1,26,1.1111111111111112,0.1111111111111111,0.2,1.1111111111111112,0.037037037037037035,0.1111111111111111
14q24.1q24.3 microdeletion syndrome,32429,5,0,99,0,99,29,0,29,0.0,0.0,0.0,0.0,0.0,0.0
9q31.1q31.3 microdeletion syndrome,32429,5,0,101,0,101,34,0,34,0.0,0.0,0.0,0.0,0.0,0.0
Optic atrophy-intellectual disability syndrome,31888,3,0,19,0,19,29,0,29,0.0,0.0,0.0,0.0,0.0,0.0
Intellectual disability-obesity-prognathism-eye and skin anomalies syndrome,29848,4,0,20,0,20,48,0,48,0.0,0.0,0.0,0.0,0.0,0.0
Microcephaly-thin corpus callosum-intellectual disability syndrome,29190,3,0,24,0,24,25,0,25,0.0,0.0,0.0,0.0,0.0,0.0
Temple-Baraitser syndrome,28286,1,0,25,0,25,34,0,34,0.0,0.0,0.0,0.0,0.0,0.0
AHDC1-related intellectual disability-obstructive sleep apnea-mild dysmorphism syndrome,28954,1,5,19,4,15,17,2,15,0.8,0.4,0.21052631578947367,0.8,0.11764705882352941,0.4
PDE4D haploinsufficiency syndrome,31595,4,15,19,2,17,38,1,37,0.13333333333333333,0.06666666666666667,0.10526315789473684,0.13333333333333333,0.02631578947368421,0.06666666666666667
Combined oxidative phosphorylation defect type 23,38594,10,2,25,1,24,16,1,15,0.5,0.5,0.04,0.5,0.0625,0.5
PCNA-related progressive neurodegenerative photosensitivity syndrome,30743,2,7,17,5,12,44,1,43,0.7142857142857143,0.14285714285714285,0.29411764705882354,0.7142857142857143,0.022727272727272728,0.14285714285714285
Retinitis pigmentosa-juvenile cataract-short stature-intellectual disability syndrome,29989,3,9,28,7,21,27,2,25,0.7777777777777778,0.2222222222222222,0.25,0.7777777777777778,0.07407407407407407,0.2222222222222222
FBLN1-related developmental delay-central nervous system anomaly-syndactyly syndrome,32938,1,0,15,0,15,21,0,21,0.0,0.0,0.0,0.0,0.0,0.0
Early-onset epileptic encephalopathy-cortical blindness-intellectual disability-facial dysmorphism syndrome,28987,2,0,34,0,34,27,0,27,0.0,0.0,0.0,0.0,0.0,0.0
Polyendocrine-polyneuropathy syndrome,27386,1,0,16,0,16,23,0,23,0.0,0.0,0.0,0.0,0.0,0.0
Infantile-onset axonal motor and sensory neuropathy-optic atrophy-neurodegenerative syndrome,33527,0,0,19,0,19,26,0,26,0.0,0.0,0.0,0.0,0.0,0.0
Neurodevelopmental disorder-craniofacial dysmorphism-cardiac defect-skeletal anomalies syndrome,29350,0,13,18,0,18,35,2,33,0.0,0.15384615384615385,0.0,0.0,0.05714285714285714,0.15384615384615385
Congenital insensitivity to pain with severe intellectual disability,33107,0,0,17,0,17,27,0,27,0.0,0.0,0.0,0.0,0.0,0.0
19p13.3 microduplication syndrome,32305,1,5,18,2,16,30,1,29,0.4,0.2,0.1111111111111111,0.4,0.03333333333333333,0.2
Spastic tetraplegia-thin corpus callosum-progressive postnatal microcephaly syndrome,28523,1,3,24,3,21,18,1,17,1.0,0.3333333333333333,0.125,1.0,0.05555555555555555,0.3333333333333333
Cerebellar-facial-dental syndrome,38540,12,11,35,0,35,32,1,31,0.0,0.09090909090909091,0.0,0.0,0.03125,0.09090909090909091
Cognitive impairment-coarse facies-heart defects-obesity-pulmonary involvement-short stature-skeletal dysplasia syndrome,31335,3,10,23,5,18,26,3,23,0.5,0.3,0.21739130434782608,0.5,0.11538461538461539,0.3
Hypohidrosis-enamel hypoplasia-palmoplantar keratoderma-intellectual disability syndrome,27790,3,0,18,0,18,23,0,23,0.0,0.0,0.0,0.0,0.0,0.0
Intellectual disability-strabismus syndrome,31873,4,3,68,3,65,34,2,32,1.0,0.6666666666666666,0.04411764705882353,1.0,0.058823529411764705,0.6666666666666666
CTCF-related neurodevelopmental disorder,32357,0,0,18,0,18,36,0,36,0.0,0.0,0.0,0.0,0.0,0.0
20q11.2 microduplication syndrome,32995,2,0,17,0,17,25,0,25,0.0,0.0,0.0,0.0,0.0,0.0
Classical-like Ehlers-Danlos syndrome type 2,32436,1,11,56,3,53,23,2,21,0.2727272727272727,0.18181818181818182,0.05357142857142857,0.2727272727272727,0.08695652173913043,0.18181818181818182
Kyphoscoliotic Ehlers-Danlos syndrome,33340,7,3,20,3,17,38,1,37,1.0,0.3333333333333333,0.15,1.0,0.02631578947368421,0.3333333333333333
Spondylodysplastic Ehlers-Danlos syndrome,38339,18,2,35,0,35,28,0,28,0.0,0.0,0.0,0.0,0.0,0.0
Myopathic Ehlers-Danlos syndrome,94824,15,2,30,1,29,18,1,17,0.5,0.5,0.03333333333333333,0.5,0.05555555555555555,0.5
Congenital factor V deficiency,31456,4,0,21,0,21,12,0,12,0.0,0.0,0.0,0.0,0.0,0.0
Purine nucleoside phosphorylase deficiency,31390,0,2,20,1,19,21,0,21,0.5,0.0,0.05,0.5,0.0,0.0
Leukocyte adhesion deficiency,28125,0,3,19,0,19,25,3,22,0.0,1.0,0.0,0.0,0.12,1.0
Anterior cutaneous nerve entrapment syndrome,32304,1,3,16,2,14,24,0,24,0.6666666666666666,0.0,0.125,0.6666666666666666,0.0,0.0
Cryptogenic organizing pneumonia,32926,8,2,16,1,15,26,2,24,0.5,1.0,0.0625,0.5,0.07692307692307693,1.0
Dehydrated hereditary stomatocytosis,29701,0,3,17,2,15,28,0,28,0.6666666666666666,0.0,0.11764705882352941,0.6666666666666666,0.0,0.0
Primary non-essential cutis verticis gyrata,32456,0,1,19,1,18,13,0,13,1.0,0.0,0.05263157894736842,1.0,0.0,0.0
THOC6-related developmental delay-microcephaly-facial dysmorphism syndrome,28947,3,8,41,5,36,32,0,32,0.625,0.0,0.12195121951219512,0.625,0.0,0.0
Intellectual disability-facial dysmorphism-hand anomalies syndrome,33549,1,0,23,0,23,33,0,33,0.0,0.0,0.0,0.0,0.0,0.0
Intellectual disability-seizures-hypophosphatasia-ophthalmic-skeletal anomalies syndrome,38365,24,13,32,3,29,32,3,29,0.23076923076923078,0.23076923076923078,0.09375,0.23076923076923078,0.09375,0.23076923076923078
Musculocontractural Ehlers-Danlos syndrome,28883,2,33,27,10,17,29,3,26,0.30303030303030304,0.09090909090909091,0.37037037037037035,0.30303030303030304,0.10344827586206896,0.09090909090909091
Ataxia-intellectual disability-oculomotor apraxia-cerebellar cysts syndrome,27757,2,6,17,1,16,5,1,4,0.16666666666666666,0.16666666666666666,0.058823529411764705,0.16666666666666666,0.2,0.16666666666666666
Histiocytoid cardiomyopathy,32712,2,1,25,2,23,29,1,28,2.0,1.0,0.08,2.0,0.034482758620689655,1.0
Cardiac-valvular Ehlers-Danlos syndrome,32052,3,4,25,3,22,17,2,15,0.75,0.5,0.12,0.75,0.11764705882352941,0.5
Developmental delay-facial dysmorphism syndrome due to MED13L deficiency,28191,2,3,17,0,17,28,2,26,0.0,0.6666666666666666,0.0,0.0,0.07142857142857142,0.6666666666666666
Autosomal dominant Charcot-Marie-Tooth disease type 2Z,29098,2,8,28,3,25,20,1,19,0.375,0.125,0.10714285714285714,0.375,0.05,0.125
Combined deficiency of factor V and factor VIII,31415,10,4,23,0,23,20,0,20,0.0,0.0,0.0,0.0,0.0,0.0
Tetanus,95672,14,5,19,1,18,18,1,17,0.2,0.2,0.05263157894736842,0.2,0.05555555555555555,0.2
Plague,33193,5,3,17,1,16,29,2,27,0.3333333333333333,0.6666666666666666,0.058823529411764705,0.3333333333333333,0.06896551724137931,0.6666666666666666
Rat-bite fever,33329,3,1,16,1,15,16,1,15,1.0,1.0,0.0625,1.0,0.0625,1.0
Nocardiosis,33334,4,1,17,1,16,22,1,21,1.0,1.0,0.058823529411764705,1.0,0.045454545454545456,1.0
Intellectual disability-brachydactyly-Pierre Robin syndrome,32698,3,0,24,0,24,26,0,26,0.0,0.0,0.0,0.0,0.0,0.0
Brooke-Spiegler syndrome,28649,1,1,22,1,21,35,0,35,1.0,0.0,0.045454545454545456,1.0,0.0,0.0
Chronic actinic dermatitis,32235,5,3,18,2,16,13,1,12,0.6666666666666666,0.3333333333333333,0.1111111111111111,0.6666666666666666,0.07692307692307693,0.3333333333333333
Severe combined immunodeficiency due to complete RAG1/2 deficiency,30125,1,6,29,7,22,30,0,30,1.1666666666666667,0.0,0.2413793103448276,1.1666666666666667,0.0,0.0
Preeclampsia,33512,4,5,16,2,14,18,2,16,0.4,0.4,0.125,0.4,0.1111111111111111,0.4
Combined malonic and methylmalonic acidemia,39044,15,4,21,0,21,28,0,28,0.0,0.0,0.0,0.0,0.0,0.0
Kaposiform lymphangiomatosis,33541,2,5,28,4,24,35,4,31,0.8,0.8,0.14285714285714285,0.8,0.11428571428571428,0.8
Atelosteogenesis type I,30049,1,0,16,0,16,26,0,26,0.0,0.0,0.0,0.0,0.0,0.0
Neonatal lupus erythematosus,27752,6,1,22,1,21,29,0,29,1.0,0.0,0.045454545454545456,1.0,0.0,0.0
Secondary non-traumatic avascular necrosis,32646,1,1,11,1,10,21,0,21,1.0,0.0,0.09090909090909091,1.0,0.0,0.0
Microcephalic cortical malformations-short stature due to RTTN deficiency,33395,1,2,66,1,65,24,1,23,0.5,0.5,0.015151515151515152,0.5,0.041666666666666664,0.5
Schuurs-Hoeijmakers syndrome,29025,0,4,59,5,54,4,0,4,1.25,0.0,0.0847457627118644,1.25,0.0,0.0
Aphonia-deafness-retinal dystrophy-bifid halluces-intellectual disability syndrome,32784,1,0,30,0,30,33,0,33,0.0,0.0,0.0,0.0,0.0,0.0
"Microcephalic primordial dwarfism, Dauber type",30346,4,0,39,0,39,44,0,44,0.0,0.0,0.0,0.0,0.0,0.0
Glycogen storage disease due to liver phosphorylase kinase deficiency,32211,2,4,17,1,16,22,1,21,0.25,0.25,0.058823529411764705,0.25,0.045454545454545456,0.25
Isolated posterior meningocele,33600,1,2,27,1,26,19,0,19,0.5,0.0,0.037037037037037035,0.5,0.0,0.0
Autism spectrum disorder due to AUTS2 deficiency,29985,2,3,25,3,22,24,1,23,1.0,0.3333333333333333,0.12,1.0,0.041666666666666664,0.3333333333333333
Pulmonary arteriovenous malformation,32523,4,2,16,1,15,21,0,21,0.5,0.0,0.0625,0.5,0.0,0.0
Glomuvenous malformation,28459,0,2,17,2,15,32,0,32,1.0,0.0,0.11764705882352941,1.0,0.0,0.0
Jervell and Lange-Nielsen syndrome,38598,17,3,32,0,32,21,0,21,0.0,0.0,0.0,0.0,0.0,0.0
Gyrate atrophy of choroid and retina,96982,19,5,24,2,22,30,2,28,0.4,0.4,0.08333333333333333,0.4,0.06666666666666667,0.4
Herpes simplex virus encephalitis,33127,3,4,23,4,19,25,0,25,1.0,0.0,0.17391304347826086,1.0,0.0,0.0
Congenital enterovirus infection,99420,8,1,22,0,22,35,0,35,0.0,0.0,0.0,0.0,0.0,0.0
Multicentric osteolysis-nodulosis-arthropathy spectrum,29152,2,12,33,6,27,30,4,26,0.5,0.3333333333333333,0.18181818181818182,0.5,0.13333333333333333,0.3333333333333333
Cryptococcosis,32601,2,0,16,0,16,21,0,21,0.0,0.0,0.0,0.0,0.0,0.0
Microsporidiosis,32749,4,0,17,0,17,16,0,16,0.0,0.0,0.0,0.0,0.0,0.0
Relapsing fever,32949,5,4,17,2,15,21,1,20,0.5,0.25,0.11764705882352941,0.5,0.047619047619047616,0.25
Short ulna-dysmorphism-hypotonia-intellectual disability syndrome,28248,2,0,24,0,24,46,0,46,0.0,0.0,0.0,0.0,0.0,0.0
19p13.13 microdeletion syndrome,31251,2,3,28,2,26,29,0,29,0.6666666666666666,0.0,0.07142857142857142,0.6666666666666666,0.0,0.0
ANK3-related intellectual disability-sleep disturbance syndrome,30443,2,0,14,0,14,20,0,20,0.0,0.0,0.0,0.0,0.0,0.0
Syndromic diarrhea,99693,15,4,18,0,18,26,0,26,0.0,0.0,0.0,0.0,0.0,0.0
Congenital analbuminemia,31640,1,2,17,3,14,32,1,31,1.5,0.5,0.17647058823529413,1.5,0.03125,0.5
Acquired von Willebrand syndrome,39535,13,0,24,0,24,19,0,19,0.0,0.0,0.0,0.0,0.0,0.0
Hereditary methemoglobinemia,30126,10,2,22,2,20,26,1,25,1.0,0.5,0.09090909090909091,1.0,0.038461538461538464,0.5
Overhydrated hereditary stomatocytosis,28159,0,6,30,7,23,14,0,14,1.1666666666666667,0.0,0.23333333333333334,1.1666666666666667,0.0,0.0
"Blepharophimosis-intellectual disability syndrome, Verloes type",35826,11,0,22,0,22,30,0,30,0.0,0.0,0.0,0.0,0.0,0.0
11p15.4 microduplication syndrome,32497,1,0,17,0,17,20,0,20,0.0,0.0,0.0,0.0,0.0,0.0
Polymicrogyria due to TUBB2B mutation,27528,10,3,16,2,14,27,1,26,0.6666666666666666,0.3333333333333333,0.125,0.6666666666666666,0.037037037037037035,0.3333333333333333
20p13 microdeletion syndrome,32620,2,1,27,2,25,27,1,26,2.0,1.0,0.07407407407407407,2.0,0.037037037037037035,1.0
"Phosphoserine aminotransferase deficiency, infantile/juvenile form",30849,0,7,41,7,34,23,0,23,1.0,0.0,0.17073170731707318,1.0,0.0,0.0
Early-onset epileptic encephalopathy and intellectual disability due to GRIN2A mutation,33426,0,0,25,0,25,24,0,24,0.0,0.0,0.0,0.0,0.0,0.0
Intellectual disability-alacrima-achalasia syndrome,27364,2,6,16,3,13,16,1,15,0.5,0.16666666666666666,0.1875,0.5,0.0625,0.16666666666666666
"Blepharophimosis-intellectual disability syndrome, MKB type",35826,19,0,26,0,26,24,0,24,0.0,0.0,0.0,0.0,0.0,0.0
Kagami-Ogata syndrome,32472,0,21,17,9,8,30,0,30,0.42857142857142855,0.0,0.5294117647058824,0.42857142857142855,0.0,0.0
21q22.11q22.12 microdeletion syndrome,32429,6,1,104,0,104,34,0,34,0.0,0.0,0.0,0.0,0.0,0.0
Infantile spasms-psychomotor retardation-progressive brain atrophy-basal ganglia disease syndrome,32498,4,3,20,2,18,49,1,48,0.6666666666666666,0.3333333333333333,0.1,0.6666666666666666,0.02040816326530612,0.3333333333333333
Recessive intellectual disability-motor dysfunction-multiple joint contractures syndrome,32650,0,4,20,4,16,27,0,27,1.0,0.0,0.2,1.0,0.0,0.0
Pyknoachondrogenesis,29554,0,0,16,0,16,24,0,24,0.0,0.0,0.0,0.0,0.0,0.0
Distal deletion 10q syndrome,29728,4,5,87,6,81,27,1,26,1.2,0.2,0.06896551724137931,1.2,0.037037037037037035,0.2
Isolated tibial hemimelia,30666,0,2,23,2,21,12,0,12,1.0,0.0,0.08695652173913043,1.0,0.0,0.0
Neonatal acute respiratory distress syndrome,39872,6,4,26,2,24,22,1,21,0.5,0.25,0.07692307692307693,0.5,0.045454545454545456,0.25
Congenitally corrected transposition of the great arteries,38925,7,6,23,0,23,20,0,20,0.0,0.0,0.0,0.0,0.0,0.0
Stevens-Johnson syndrome/toxic epidermal necrolysis spectrum,32746,8,5,32,3,29,28,3,25,0.6,0.6,0.09375,0.6,0.10714285714285714,0.6
Intellectual disability-hypotonia-brachycephaly-pyloric stenosis-cryptorchidism syndrome,32599,5,0,16,0,16,20,0,20,0.0,0.0,0.0,0.0,0.0,0.0
2q23.1 microduplication syndrome,31466,3,8,19,1,18,31,1,30,0.125,0.125,0.05263157894736842,0.125,0.03225806451612903,0.125
Distal 17p13.1 microdeletion syndrome,95065,17,0,22,0,22,22,0,22,0.0,0.0,0.0,0.0,0.0,0.0
Mycetoma,32734,0,0,16,0,16,24,0,24,0.0,0.0,0.0,0.0,0.0,0.0
Leptospirosis,33314,5,0,17,0,17,21,0,21,0.0,0.0,0.0,0.0,0.0,0.0
Neonatal intrahepatic cholestasis due to citrin deficiency,29408,6,15,24,4,20,20,5,15,0.26666666666666666,0.3333333333333333,0.16666666666666666,0.26666666666666666,0.25,0.3333333333333333
Brachydactyly type A7,29488,2,0,16,0,16,14,0,14,0.0,0.0,0.0,0.0,0.0,0.0
Multiple acyl-CoA dehydrogenase deficiency,98500,18,0,24,0,24,34,0,34,0.0,0.0,0.0,0.0,0.0,0.0
Isolated biliary atresia,99178,10,3,17,3,14,16,2,14,1.0,0.6666666666666666,0.17647058823529413,1.0,0.125,0.6666666666666666
MAN1B1-CDG,33411,0,4,36,4,32,13,0,13,1.0,0.0,0.1111111111111111,1.0,0.0,0.0
PGM3-CDG,31521,0,7,46,5,41,23,0,23,0.7142857142857143,0.0,0.10869565217391304,0.7142857142857143,0.0,0.0
XYLT1-CDG,32288,1,0,26,0,26,21,0,21,0.0,0.0,0.0,0.0,0.0,0.0
Congenital muscular dystrophy with intellectual disability and severe epilepsy,29208,3,0,87,0,87,29,0,29,0.0,0.0,0.0,0.0,0.0,0.0
Temtamy preaxial brachydactyly syndrome,28256,0,2,23,1,22,30,0,30,0.5,0.0,0.043478260869565216,0.5,0.0,0.0
Alpha-dystroglycan-related limb-girdle muscular dystrophy R16,27315,2,3,14,0,14,24,0,24,0.0,0.0,0.0,0.0,0.0,0.0
SRD5A3-CDG,27783,1,4,18,1,17,27,1,26,0.25,0.25,0.05555555555555555,0.25,0.037037037037037035,0.25
COG1-CDG,28894,1,0,56,0,56,21,0,21,0.0,0.0,0.0,0.0,0.0,0.0
ALG11-CDG,31434,1,7,23,5,18,16,0,16,0.7142857142857143,0.0,0.21739130434782608,0.7142857142857143,0.0,0.0
COG5-CDG,28972,2,3,42,3,39,23,0,23,1.0,0.0,0.07142857142857142,1.0,0.0,0.0
"Spondyloepiphyseal dysplasia tarda, Kohn type",31270,0,0,39,0,39,21,0,21,0.0,0.0,0.0,0.0,0.0,0.0
COG8-CDG,29748,0,0,21,0,21,26,0,26,0.0,0.0,0.0,0.0,0.0,0.0
POMT2-related limb-girdle muscular dystrophy R14,29368,6,3,16,0,16,26,0,26,0.0,0.0,0.0,0.0,0.0,0.0
Temple syndrome,28286,0,7,17,0,17,24,0,24,0.0,0.0,0.0,0.0,0.0,0.0
Polymicrogyria with optic nerve hypoplasia,31794,2,9,18,10,8,32,1,31,1.1111111111111112,0.1111111111111111,0.5555555555555556,1.1111111111111112,0.03125,0.1111111111111111
Hyperphosphatasia-intellectual disability syndrome,27923,2,6,75,2,73,32,0,32,0.3333333333333333,0.0,0.02666666666666667,0.3333333333333333,0.0,0.0
X-linked Charcot-Marie-Tooth disease type 6,27530,7,10,30,2,28,27,2,25,0.2,0.2,0.06666666666666667,0.2,0.07407407407407407,0.2
Alazami syndrome,31536,1,6,17,0,17,48,0,48,0.0,0.0,0.0,0.0,0.0,0.0
Syndromic multisystem autoimmune disease due to Itch deficiency,31599,0,6,18,1,17,10,0,10,0.16666666666666666,0.0,0.05555555555555555,0.16666666666666666,0.0,0.0
Pseudoaminopterin syndrome,31751,0,0,70,0,70,33,0,33,0.0,0.0,0.0,0.0,0.0,0.0
Zechi-Ceide syndrome,32162,0,0,19,0,19,6,0,6,0.0,0.0,0.0,0.0,0.0,0.0
Brain-lung-thyroid syndrome,27955,2,1,33,1,32,14,1,13,1.0,1.0,0.030303030303030304,1.0,0.07142857142857142,1.0
Combined oxidative phosphorylation defect type 27,38594,16,0,29,0,29,29,0,29,0.0,0.0,0.0,0.0,0.0,0.0
SLC39A8-CDG,29977,0,6,17,0,17,23,0,23,0.0,0.0,0.0,0.0,0.0,0.0
T-B+ severe combined immunodeficiency due to CD3delta/CD3epsilon/CD3zeta,32891,1,1,17,2,15,15,1,14,2.0,1.0,0.11764705882352941,2.0,0.06666666666666667,1.0
T-B+ severe combined immunodeficiency due to IL-7Ralpha deficiency,32859,1,1,18,2,16,36,2,34,2.0,2.0,0.1111111111111111,2.0,0.05555555555555555,2.0
Isobutyryl-CoA dehydrogenase deficiency,30332,9,0,22,0,22,20,0,20,0.0,0.0,0.0,0.0,0.0,0.0
Atresia of urethra,32640,2,2,17,1,16,20,1,19,0.5,0.5,0.058823529411764705,0.5,0.05,0.5
Duplication of urethra,32457,3,0,20,0,20,21,0,21,0.0,0.0,0.0,0.0,0.0,0.0
Developmental and epileptic encephalopathy with spike-wave activation in sleep,33205,3,3,18,3,15,28,2,26,1.0,0.6666666666666666,0.16666666666666666,1.0,0.07142857142857142,0.6666666666666666
Short chain acyl-CoA dehydrogenase deficiency,38510,18,0,30,0,30,26,0,26,0.0,0.0,0.0,0.0,0.0,0.0
Glucose-galactose malabsorption,28234,4,5,19,5,14,24,3,21,1.0,0.6,0.2631578947368421,1.0,0.125,0.6
Serotonin syndrome,33091,9,1,21,1,20,27,1,26,1.0,1.0,0.047619047619047616,1.0,0.037037037037037035,1.0
Idiopathic neonatal atrial flutter,32647,2,4,14,6,8,23,1,22,1.5,0.25,0.42857142857142855,1.5,0.043478260869565216,0.25
Galactokinase deficiency,30605,1,4,17,1,16,21,0,21,0.25,0.0,0.058823529411764705,0.25,0.0,0.0
Classic galactosemia,39443,12,4,23,0,23,35,0,35,0.0,0.0,0.0,0.0,0.0,0.0
Proximal renal tubular acidosis,31011,2,2,18,0,18,25,1,24,0.0,0.5,0.0,0.0,0.04,0.5
Generalized arterial calcification of infancy,33393,2,3,27,4,23,35,0,35,1.3333333333333333,0.0,0.14814814814814814,1.3333333333333333,0.0,0.0
Caroli disease,27699,3,1,17,2,15,22,1,21,2.0,1.0,0.11764705882352941,2.0,0.045454545454545456,1.0
Pulmonary nodular lymphoid hyperplasia,29261,4,0,16,0,16,26,0,26,0.0,0.0,0.0,0.0,0.0,0.0
Distal renal tubular acidosis,31011,4,8,17,2,15,19,2,17,0.25,0.25,0.11764705882352941,0.25,0.10526315789473684,0.25
Fanconi-Bickel syndrome,28453,16,8,22,0,22,29,3,26,0.0,0.375,0.0,0.0,0.10344827586206896,0.375
Oligomeganephronia,33501,2,8,26,7,19,27,3,24,0.875,0.375,0.2692307692307692,0.875,0.1111111111111111,0.375
Hereditary hypophosphatemic rickets with hypercalciuria,27464,1,9,33,6,27,20,0,20,0.6666666666666666,0.0,0.18181818181818182,0.6666666666666666,0.0,0.0
Opsoclonus-myoclonus syndrome,33201,2,5,18,5,13,21,3,18,1.0,0.6,0.2777777777777778,1.0,0.14285714285714285,0.6
Primary Fanconi renotubular syndrome,38277,8,11,35,1,34,25,0,25,0.09090909090909091,0.0,0.02857142857142857,0.09090909090909091,0.0,0.0
Tracheobronchopathia osteochondroplastica,29623,7,2,18,1,17,25,0,25,0.5,0.0,0.05555555555555555,0.5,0.0,0.0
Rasmussen subacute encephalitis,33120,1,2,29,3,26,22,0,22,1.5,0.0,0.10344827586206896,1.5,0.0,0.0
Gorham-Stout disease,29373,3,3,26,3,23,18,1,17,1.0,0.3333333333333333,0.11538461538461539,1.0,0.05555555555555555,0.3333333333333333
Pyruvate carboxylase deficiency,31962,5,3,75,2,73,23,1,22,0.6666666666666666,0.3333333333333333,0.02666666666666667,0.6666666666666666,0.043478260869565216,0.3333333333333333
Congenital plasminogen activator inhibitor type 1 deficiency,27824,2,7,17,3,14,32,0,32,0.42857142857142855,0.0,0.17647058823529413,0.42857142857142855,0.0,0.0
Oculocutaneous albinism type 3,84278,8,0,28,0,28,32,0,32,0.0,0.0,0.0,0.0,0.0,0.0
Asbestos intoxication,33056,3,0,16,0,16,20,0,20,0.0,0.0,0.0,0.0,0.0,0.0
Mosaic trisomy 16 syndrome,33435,4,1,17,0,17,43,0,43,0.0,0.0,0.0,0.0,0.0,0.0
Hereditary xanthinuria,33353,4,2,18,2,16,19,0,19,1.0,0.0,0.1111111111111111,1.0,0.0,0.0
Pontocerebellar hypoplasia type 2,27716,7,10,33,5,28,25,0,25,0.5,0.0,0.15151515151515152,0.5,0.0,0.0
Localized scleroderma,33228,5,1,20,1,19,38,1,37,1.0,1.0,0.05,1.0,0.02631578947368421,1.0
Ring chromosome 21 syndrome,32369,2,1,16,1,15,26,1,25,1.0,1.0,0.0625,1.0,0.038461538461538464,1.0
Pentosuria,31585,1,2,20,3,17,36,0,36,1.5,0.0,0.15,1.5,0.0,0.0
Pterin-4 alpha-carbinolamine dehydratase deficiency,30189,1,2,16,2,14,20,0,20,1.0,0.0,0.125,1.0,0.0,0.0
Mosaic trisomy 20 syndrome,27822,2,1,17,0,17,28,0,28,0.0,0.0,0.0,0.0,0.0,0.0
Sweet syndrome,28845,4,6,17,3,14,23,2,21,0.5,0.3333333333333333,0.17647058823529413,0.5,0.08695652173913043,0.3333333333333333
X-linked hypophosphatemia,27285,0,6,17,0,17,28,1,27,0.0,0.16666666666666666,0.0,0.0,0.03571428571428571,0.16666666666666666
Systemic sclerosis,94641,11,7,18,3,15,25,3,22,0.42857142857142855,0.42857142857142855,0.16666666666666666,0.42857142857142855,0.12,0.42857142857142855
SATB2-associated syndrome due to a pathogenic variant,39006,21,4,36,1,35,39,1,38,0.25,0.25,0.027777777777777776,0.25,0.02564102564102564,0.25
SATB2-associated syndrome due to a chromosomal rearrangement,38194,18,2,31,0,31,36,0,36,0.0,0.0,0.0,0.0,0.0,0.0
Prader-Willi syndrome due to imprinting mutation,32961,5,0,53,0,53,41,0,41,0.0,0.0,0.0,0.0,0.0,0.0
Prader-Willi syndrome due to translocation,32961,6,4,54,2,52,23,1,22,0.5,0.25,0.037037037037037035,0.5,0.043478260869565216,0.25
Silver-Russell syndrome due to 7p11.2p13 microduplication,32175,3,0,28,0,28,32,0,32,0.0,0.0,0.0,0.0,0.0,0.0
Silver-Russell syndrome due to a point mutation,32863,2,9,18,5,13,30,0,30,0.5555555555555556,0.0,0.2777777777777778,0.5555555555555556,0.0,0.0
Silver-Russell syndrome due to maternal uniparental disomy of chromosome 11,32180,1,0,19,0,19,19,0,19,0.0,0.0,0.0,0.0,0.0,0.0
Silver-Russell syndrome due to maternal uniparental disomy of chromosome 7,32180,1,4,19,1,18,18,0,18,0.25,0.0,0.05263157894736842,0.25,0.0,0.0
Alveolar echinococcosis,32435,2,4,18,0,18,26,1,25,0.0,0.25,0.0,0.0,0.038461538461538464,0.25
Tularemia,95763,18,0,29,0,29,25,0,25,0.0,0.0,0.0,0.0,0.0,0.0
Silver-Russell syndrome due to 11p15 microduplication,32181,2,0,17,0,17,33,0,33,0.0,0.0,0.0,0.0,0.0,0.0
Silver-Russell syndrome due to an imprinting defect of 11p15,32179,3,6,17,4,13,35,1,34,0.6666666666666666,0.16666666666666666,0.23529411764705882,0.6666666666666666,0.02857142857142857,0.16666666666666666
"Glycogen storage disease due to acid maltase deficiency, infantile onset",32861,3,17,17,8,9,30,4,26,0.47058823529411764,0.23529411764705882,0.47058823529411764,0.47058823529411764,0.13333333333333333,0.23529411764705882
Glycogen storage disease due to acid maltase deficiency,94893,14,5,23,1,22,26,1,25,0.2,0.2,0.043478260869565216,0.2,0.038461538461538464,0.2
Cysticercosis,30926,10,1,24,0,24,27,0,27,0.0,0.0,0.0,0.0,0.0,0.0
Autosomal dominant Charcot-Marie-Tooth disease type 2E,99891,10,8,17,1,16,28,2,26,0.125,0.25,0.058823529411764705,0.125,0.07142857142857142,0.25
Charcot-Marie-Tooth disease type 4D,27530,6,4,24,0,24,25,0,25,0.0,0.0,0.0,0.0,0.0,0.0
Ectodermal dysplasia-skin fragility syndrome,32141,1,3,17,0,17,29,0,29,0.0,0.0,0.0,0.0,0.0,0.0
"Autosomal dominant generalized epidermolysis bullosa simplex, intermediate form",27434,3,4,24,3,21,14,2,12,0.75,0.5,0.125,0.75,0.14285714285714285,0.5
Charcot-Marie-Tooth disease type 1F,30728,0,7,17,3,14,18,0,18,0.42857142857142855,0.0,0.17647058823529413,0.42857142857142855,0.0,0.0
Capillary malformation-arteriovenous malformation,28829,0,1,17,1,16,23,0,23,1.0,0.0,0.058823529411764705,1.0,0.0,0.0
"Spondyloepimetaphyseal dysplasia, Handigodu type",33300,3,3,17,2,15,41,0,41,0.6666666666666666,0.0,0.11764705882352941,0.6666666666666666,0.0,0.0
Hemimegalencephaly,32312,1,3,17,1,16,27,0,27,0.3333333333333333,0.0,0.058823529411764705,0.3333333333333333,0.0,0.0
Pulmonary capillary hemangiomatosis,38758,18,6,22,0,22,23,0,23,0.0,0.0,0.0,0.0,0.0,0.0
Immune-mediated necrotizing myopathy,32963,0,6,20,6,14,18,0,18,1.0,0.0,0.3,1.0,0.0,0.0
Mal de débarquement,27838,10,0,16,0,16,22,0,22,0.0,0.0,0.0,0.0,0.0,0.0
Autosomal recessive generalized epidermolysis bullosa simplex,38011,6,0,6,0,6,23,0,23,0.0,0.0,0.0,0.0,0.0,0.0
Autosomal dominant epilepsy with auditory features,27649,1,3,16,3,13,36,1,35,1.0,0.3333333333333333,0.1875,1.0,0.027777777777777776,0.3333333333333333
Polyrrhinia,32486,0,0,13,0,13,15,0,15,0.0,0.0,0.0,0.0,0.0,0.0
Scleromyxedema,27681,0,3,16,1,15,34,0,34,0.3333333333333333,0.0,0.0625,0.3333333333333333,0.0,0.0
Trisomy 10p syndrome,33475,1,4,50,3,47,28,2,26,0.75,0.5,0.06,0.75,0.07142857142857142,0.5
Hereditary renal hypouricemia,28528,17,3,26,1,25,23,1,22,0.3333333333333333,0.3333333333333333,0.038461538461538464,0.3333333333333333,0.043478260869565216,0.3333333333333333
Renal hypoplasia,32923,5,0,17,0,17,21,0,21,0.0,0.0,0.0,0.0,0.0,0.0
Robinow syndrome,29073,1,2,17,2,15,41,1,40,1.0,0.5,0.11764705882352941,1.0,0.024390243902439025,0.5
Non-syndromic posterior hypospadias,32912,2,1,16,1,15,14,2,12,1.0,2.0,0.0625,1.0,0.14285714285714285,2.0
Variant ABeta2M amyloidosis,33133,1,0,17,0,17,32,0,32,0.0,0.0,0.0,0.0,0.0,0.0
Congenital tufting enteropathy,38695,18,4,27,1,26,24,1,23,0.25,0.25,0.037037037037037035,0.25,0.041666666666666664,0.25
Pauci-immune glomerulonephritis,27729,5,8,30,8,22,22,2,20,1.0,0.25,0.26666666666666666,1.0,0.09090909090909091,0.25
Roussy-Lévy syndrome,31973,0,0,17,0,17,31,0,31,0.0,0.0,0.0,0.0,0.0,0.0
Autosomal dominant Charcot-Marie-Tooth disease type 2Y,29098,1,0,24,0,24,18,0,18,0.0,0.0,0.0,0.0,0.0,0.0
Abnormal origin of right or left pulmonary artery from the aorta,31649,10,2,21,0,21,16,0,16,0.0,0.0,0.0,0.0,0.0,0.0
Thiel-Behnke corneal dystrophy,29290,9,3,17,3,14,23,0,23,1.0,0.0,0.17647058823529413,1.0,0.0,0.0
Autosomal dominant nocturnal frontal lobe epilepsy,27354,3,1,18,0,18,28,0,28,0.0,0.0,0.0,0.0,0.0,0.0
Lattice corneal dystrophy type I,28275,5,6,17,8,9,22,4,18,1.3333333333333333,0.6666666666666666,0.47058823529411764,1.3333333333333333,0.18181818181818182,0.6666666666666666
X-linked Charcot-Marie-Tooth disease type 3,27530,4,0,22,0,22,20,0,20,0.0,0.0,0.0,0.0,0.0,0.0
X-linked Charcot-Marie-Tooth disease type 2,27530,2,0,30,0,30,15,0,15,0.0,0.0,0.0,0.0,0.0,0.0
Bothnia retinal dystrophy,27827,2,6,17,6,11,24,2,22,1.0,0.3333333333333333,0.35294117647058826,1.0,0.08333333333333333,0.3333333333333333
Leigh syndrome,33401,2,7,23,2,21,27,0,27,0.2857142857142857,0.0,0.08695652173913043,0.2857142857142857,0.0,0.0
Regional odontodysplasia,32323,4,0,17,0,17,14,0,14,0.0,0.0,0.0,0.0,0.0,0.0
Acute disseminated encephalomyelitis,32501,7,4,51,4,47,31,0,31,1.0,0.0,0.0784313725490196,1.0,0.0,0.0
Brachytelephalangic chondrodysplasia punctata,38558,17,4,42,0,42,33,0,33,0.0,0.0,0.0,0.0,0.0,0.0
Pseudopseudohypoparathyroidism,27647,4,0,19,0,19,30,0,30,0.0,0.0,0.0,0.0,0.0,0.0
GM1 gangliosidosis type 1,27167,2,13,16,5,11,34,2,32,0.38461538461538464,0.15384615384615385,0.3125,0.38461538461538464,0.058823529411764705,0.15384615384615385
Glycogen storage disease due to glucose-6-phosphatase deficiency type Ib,27295,7,12,25,7,18,23,3,20,0.5833333333333334,0.25,0.28,0.5833333333333334,0.13043478260869565,0.25
Tubulointerstitial nephritis and uveitis syndrome,31617,5,6,18,1,17,23,0,23,0.16666666666666666,0.0,0.05555555555555555,0.16666666666666666,0.0,0.0
Lupus erythematosus tumidus,27789,0,3,13,3,10,38,1,37,1.0,0.3333333333333333,0.23076923076923078,1.0,0.02631578947368421,0.3333333333333333
Charcot-Marie-Tooth disease type 1E,99891,16,6,29,1,28,27,1,26,0.16666666666666666,0.16666666666666666,0.034482758620689655,0.16666666666666666,0.037037037037037035,0.16666666666666666
Inflammatory pseudotumor of the liver,27702,4,2,10,1,9,19,0,19,0.5,0.0,0.1,0.5,0.0,0.0
"Hereditary motor and sensory neuropathy, Okinawa type",31920,1,8,43,8,35,26,0,26,1.0,0.0,0.18604651162790697,1.0,0.0,0.0
Non-syndromic genetic deafness,32254,1,0,13,0,13,24,0,24,0.0,0.0,0.0,0.0,0.0,0.0
Bartter syndrome type 4,27629,2,8,34,1,33,35,1,34,0.125,0.125,0.029411764705882353,0.125,0.02857142857142857,0.125
Renal nutcracker syndrome,33362,3,0,18,0,18,11,0,11,0.0,0.0,0.0,0.0,0.0,0.0
Immunodeficiency due to selective anti-polysaccharide antibody deficiency,27759,6,5,18,5,13,40,2,38,1.0,0.4,0.2777777777777778,1.0,0.05,0.4
Intrahepatic cholestasis of pregnancy,30714,2,2,16,3,13,12,2,10,1.5,1.0,0.1875,1.5,0.16666666666666666,1.0
Infantile neuroaxonal dystrophy,33527,0,3,21,0,21,27,0,27,0.0,0.0,0.0,0.0,0.0,0.0
Pantothenate kinase-associated neurodegeneration,28116,5,8,105,11,94,19,1,18,1.375,0.125,0.10476190476190476,1.375,0.05263157894736842,0.125
Tako-Tsubo cardiomyopathy,27751,4,1,16,0,16,23,0,23,0.0,0.0,0.0,0.0,0.0,0.0
Isolated focal cortical dysplasia,28599,1,5,16,5,11,19,1,18,1.0,0.2,0.3125,1.0,0.05263157894736842,0.2
Pruritic urticarial papules and plaques of pregnancy,27756,5,4,17,5,12,18,3,15,1.25,0.75,0.29411764705882354,1.25,0.16666666666666666,0.75
Acrokeratosis verruciformis of Hopf,27270,2,5,16,5,11,27,2,25,1.0,0.4,0.3125,1.0,0.07407407407407407,0.4
"Hereditary bullous dystrophy, macular type",31784,1,0,20,0,20,30,0,30,0.0,0.0,0.0,0.0,0.0,0.0
Elastosis perforans serpiginosa,30716,5,2,14,2,12,26,0,26,1.0,0.0,0.14285714285714285,1.0,0.0,0.0
Isolated congenital onychodysplasia,29598,0,5,25,0,25,13,1,12,0.0,0.2,0.0,0.0,0.07692307692307693,0.2
Tropical endomyocardial fibrosis,33141,4,5,26,5,21,32,2,30,1.0,0.4,0.19230769230769232,1.0,0.0625,0.4
Oguchi disease,27726,4,3,20,3,17,33,0,33,1.0,0.0,0.15,1.0,0.0,0.0
Cancer-associated retinopathy,32583,1,0,16,0,16,24,0,24,0.0,0.0,0.0,0.0,0.0,0.0
Cerebral visual impairment,94880,16,0,21,0,21,19,0,19,0.0,0.0,0.0,0.0,0.0,0.0
Proton-pump inhibitor-responsive esophageal eosinophilia,84163,14,2,18,0,18,20,0,20,0.0,0.0,0.0,0.0,0.0,0.0
Congenital adrenal hyperplasia due to cytochrome P450 oxidoreductase deficiency,31352,4,2,30,0,30,26,0,26,0.0,0.0,0.0,0.0,0.0,0.0
Symptomatic form of fragile X syndrome in female carriers,98561,18,0,37,0,37,27,0,27,0.0,0.0,0.0,0.0,0.0,0.0
Oncogenic osteomalacia,98450,14,6,30,2,28,24,1,23,0.3333333333333333,0.16666666666666666,0.06666666666666667,0.3333333333333333,0.041666666666666664,0.16666666666666666
Selective IgM deficiency,96370,11,4,37,4,33,27,4,23,1.0,1.0,0.10810810810810811,1.0,0.14814814814814814,1.0
Acute encephalopathy with biphasic seizures and late reduced diffusion,94659,14,1,22,0,22,17,0,17,0.0,0.0,0.0,0.0,0.0,0.0
Burning mouth syndrome,39709,8,1,26,1,25,12,1,11,1.0,1.0,0.038461538461538464,1.0,0.08333333333333333,1.0
Severe early-childhood-onset retinal dystrophy,38728,16,0,21,0,21,22,0,22,0.0,0.0,0.0,0.0,0.0,0.0
New-onset refractory status epilepticus,98472,8,4,23,1,22,22,0,22,0.25,0.0,0.043478260869565216,0.25,0.0,0.0
Persistent idiopathic facial pain,98506,6,2,23,0,23,18,1,17,0.0,0.5,0.0,0.0,0.05555555555555555,0.5
Refractory celiac disease,84045,14,3,21,0,21,26,0,26,0.0,0.0,0.0,0.0,0.0,0.0
IgG4-related pachymeningitis,98562,13,2,27,0,27,29,0,29,0.0,0.0,0.0,0.0,0.0,0.0
Epithelial recurrent erosion dystrophy,31238,0,5,20,3,17,36,0,36,0.6,0.0,0.15,0.6,0.0,0.0
Mendelian susceptibility to mycobacterial diseases due to complete IL12RB1 deficiency,30220,6,4,22,2,20,26,0,26,0.5,0.0,0.09090909090909091,0.5,0.0,0.0
Fixed drug eruption,98285,14,3,23,1,22,24,1,23,0.3333333333333333,0.3333333333333333,0.043478260869565216,0.3333333333333333,0.041666666666666664,0.3333333333333333
Isolated absence of upper arm and forearm with hand present,39389,3,1,28,0,28,38,0,38,0.0,0.0,0.0,0.0,0.0,0.0
Autoerythrocyte sensitization syndrome,98416,6,2,30,0,30,22,0,22,0.0,0.0,0.0,0.0,0.0,0.0
Intermittent hydrarthrosis,36157,10,1,27,1,26,21,1,20,1.0,1.0,0.037037037037037035,1.0,0.047619047619047616,1.0
Coffin-Siris syndrome,27378,0,8,119,4,115,20,0,20,0.5,0.0,0.03361344537815126,0.5,0.0,0.0
Nail-patella syndrome,29780,2,2,24,0,24,29,0,29,0.0,0.0,0.0,0.0,0.0,0.0
Angelman syndrome,29997,3,19,35,10,25,18,2,16,0.5263157894736842,0.10526315789473684,0.2857142857142857,0.5263157894736842,0.1111111111111111,0.10526315789473684
Proximal 16p11.2 microdeletion syndrome,28865,3,3,20,1,19,26,0,26,0.3333333333333333,0.0,0.05,0.3333333333333333,0.0,0.0
IgG4-related aortitis,98563,16,2,32,0,32,26,0,26,0.0,0.0,0.0,0.0,0.0,0.0
IgG4-related kidney disease,98562,16,3,22,0,22,26,0,26,0.0,0.0,0.0,0.0,0.0,0.0
Autosomal dominant optic atrophy plus syndrome,31888,3,2,18,1,17,29,2,27,0.5,1.0,0.05555555555555555,0.5,0.06896551724137931,1.0
Proximal spinal muscular atrophy,28247,0,2,19,3,16,16,0,16,1.5,0.0,0.15789473684210525,1.5,0.0,0.0
Tay-Sachs disease,94924,21,6,26,1,25,27,1,26,0.16666666666666666,0.16666666666666666,0.038461538461538464,0.16666666666666666,0.037037037037037035,0.16666666666666666
Pyridoxine-dependent epilepsy,32707,4,1,21,2,19,21,1,20,2.0,1.0,0.09523809523809523,2.0,0.047619047619047616,1.0
Opitz GBBB syndrome,28702,2,4,19,0,19,37,0,37,0.0,0.0,0.0,0.0,0.0,0.0
Cerebrotendinous xanthomatosis,33508,1,3,18,0,18,22,0,22,0.0,0.0,0.0,0.0,0.0,0.0
Allan-Herndon-Dudley syndrome,28090,0,2,48,1,47,17,0,17,0.5,0.0,0.020833333333333332,0.5,0.0,0.0
Congenital adrenal hyperplasia due to 11-beta-hydroxylase deficiency,28999,1,11,17,2,15,15,3,12,0.18181818181818182,0.2727272727272727,0.11764705882352941,0.18181818181818182,0.2,0.2727272727272727
Classic congenital adrenal hyperplasia due to 21-hydroxylase deficiency,30111,4,5,20,0,20,26,0,26,0.0,0.0,0.0,0.0,0.0,0.0
Congenital adrenal hyperplasia due to 17-alpha-hydroxylase deficiency,29496,0,8,21,1,20,22,1,21,0.125,0.125,0.047619047619047616,0.125,0.045454545454545456,0.125
Autosomal recessive spastic paraplegia type 11,39424,16,10,23,1,22,32,1,31,0.1,0.1,0.043478260869565216,0.1,0.03125,0.1
Familial adenomatous polyposis,29041,0,6,17,3,14,35,2,33,0.5,0.3333333333333333,0.17647058823529413,0.5,0.05714285714285714,0.3333333333333333
Myoclonic-astatic epilepsy,33113,0,2,21,0,21,15,0,15,0.0,0.0,0.0,0.0,0.0,0.0
Familial focal epilepsy with variable foci,28855,1,2,17,2,15,37,0,37,1.0,0.0,0.11764705882352941,1.0,0.0,0.0
Charcot-Marie-Tooth disease type 4C,27530,4,8,20,0,20,28,2,26,0.0,0.25,0.0,0.0,0.07142857142857142,0.25
Adrenomyeloneuropathy,32783,0,9,21,7,14,28,1,27,0.7777777777777778,0.1111111111111111,0.3333333333333333,0.7777777777777778,0.03571428571428571,0.1111111111111111
Reversible cerebral vasoconstriction syndrome,33346,0,2,3,0,3,34,0,34,0.0,0.0,0.0,0.0,0.0,0.0
Acute zonal occult outer retinopathy,33483,4,0,20,0,20,32,0,32,0.0,0.0,0.0,0.0,0.0,0.0
Landau-Kleffner syndrome,31969,3,8,16,3,13,19,3,16,0.375,0.375,0.1875,0.375,0.15789473684210525,0.375
15q11.2 microdeletion syndrome,32429,1,0,16,0,16,17,0,17,0.0,0.0,0.0,0.0,0.0,0.0
Congenital lipoid adrenal hyperplasia due to STAR deficency,28115,3,3,26,1,25,21,0,21,0.3333333333333333,0.0,0.038461538461538464,0.3333333333333333,0.0,0.0
Marchiafava-Bignami disease,33363,4,4,16,0,16,30,0,30,0.0,0.0,0.0,0.0,0.0,0.0
Epidermolysis bullosa simplex with circinate migratory erythema,27687,3,0,16,0,16,12,0,12,0.0,0.0,0.0,0.0,0.0,0.0
Lower motor neuron syndrome with late-adult onset,27736,4,1,16,0,16,19,0,19,0.0,0.0,0.0,0.0,0.0,0.0
Glossopharyngeal neuralgia,33352,3,0,21,0,21,23,0,23,0.0,0.0,0.0,0.0,0.0,0.0
Superficial siderosis,32713,0,3,23,2,21,23,0,23,0.6666666666666666,0.0,0.08695652173913043,0.6666666666666666,0.0,0.0
Familial hemophagocytic lymphohistiocytosis,29161,7,12,51,8,43,32,6,26,0.6666666666666666,0.5,0.1568627450980392,0.6666666666666666,0.1875,0.5
Blepharophimosis-ptosis-epicanthus inversus syndrome plus,27485,3,4,17,2,15,20,4,16,0.5,1.0,0.11764705882352941,0.5,0.2,1.0
Autosomal dominant keratitis,28824,10,1,20,1,19,15,0,15,1.0,0.0,0.05,1.0,0.0,0.0
Fibrous dysplasia of bone,38425,11,6,27,7,20,30,2,28,1.1666666666666667,0.3333333333333333,0.25925925925925924,1.1666666666666667,0.06666666666666667,0.3333333333333333
Exstrophy-epispadias complex,38726,8,0,17,0,17,24,0,24,0.0,0.0,0.0,0.0,0.0,0.0
Glycogen storage disease due to aldolase A deficiency,29225,3,2,18,0,18,29,0,29,0.0,0.0,0.0,0.0,0.0,0.0
Dyggve-Melchior-Clausen disease,27562,0,4,18,1,17,10,0,10,0.25,0.0,0.05555555555555555,0.25,0.0,0.0
Idiopathic steroid-resistant nephrotic syndrome,39544,15,4,24,3,21,16,3,13,0.75,0.75,0.125,0.75,0.1875,0.75
Autosomal recessive otospondylomegaepiphyseal dysplasia,35450,5,8,34,1,33,26,0,26,0.125,0.0,0.029411764705882353,0.125,0.0,0.0
Progressive pseudorheumatoid dysplasia,30070,0,7,17,1,16,32,1,31,0.14285714285714285,0.14285714285714285,0.058823529411764705,0.14285714285714285,0.03125,0.14285714285714285
Glycogen storage disease due to lactate dehydrogenase M-subunit deficiency,33023,10,0,20,0,20,23,0,23,0.0,0.0,0.0,0.0,0.0,0.0
Mueller-Weiss syndrome,30327,0,1,27,0,27,35,0,35,0.0,0.0,0.0,0.0,0.0,0.0
Idiopathic steroid-sensitive nephrotic syndrome with secondary steroid resistance,33491,16,2,20,1,19,20,1,19,0.5,0.5,0.05,0.5,0.05,0.5
Systemic mastocytosis with associated hematologic neoplasm,32837,9,4,21,0,21,19,0,19,0.0,0.0,0.0,0.0,0.0,0.0
Aggressive systemic mastocytosis,32834,3,1,19,0,19,17,0,17,0.0,0.0,0.0,0.0,0.0,0.0
Partial androgen insensitivity syndrome,28616,7,7,20,1,19,26,0,26,0.14285714285714285,0.0,0.05,0.14285714285714285,0.0,0.0
Complete androgen insensitivity syndrome,31630,2,13,18,5,13,29,0,29,0.38461538461538464,0.0,0.2777777777777778,0.38461538461538464,0.0,0.0
Osteochondrosis of the metatarsal bone,39722,12,0,17,0,17,31,0,31,0.0,0.0,0.0,0.0,0.0,0.0
Primary triglyceride deposit cardiomyovasculopathy,38564,18,5,21,0,21,24,0,24,0.0,0.0,0.0,0.0,0.0,0.0
Hypothyroidism due to deficient transcription factors involved in pituitary development or function,32711,2,3,16,0,16,29,0,29,0.0,0.0,0.0,0.0,0.0,0.0
Indolent systemic mastocytosis,32834,5,5,21,0,21,20,0,20,0.0,0.0,0.0,0.0,0.0,0.0
Congenital tricuspid valve dysplasia,33663,5,0,21,0,21,18,0,18,0.0,0.0,0.0,0.0,0.0,0.0
IgA pemphigus,99686,7,3,14,1,13,22,1,21,0.3333333333333333,0.3333333333333333,0.07142857142857142,0.3333333333333333,0.045454545454545456,0.3333333333333333
Primary biliary cholangitis/primary sclerosing cholangitis and autoimmune hepatitis overlap syndrome,99692,17,2,23,0,23,30,0,30,0.0,0.0,0.0,0.0,0.0,0.0
Osteochondrosis of the tarsal bone,39722,9,0,27,0,27,26,0,26,0.0,0.0,0.0,0.0,0.0,0.0
Isolated thyroid-stimulating hormone deficiency,30196,1,7,18,0,18,17,0,17,0.0,0.0,0.0,0.0,0.0,0.0
Resistance to thyrotropin-releasing hormone syndrome,32345,3,0,16,0,16,25,0,25,0.0,0.0,0.0,0.0,0.0,0.0
Livedoid vasculopathy,99643,0,3,9,0,9,14,0,14,0.0,0.0,0.0,0.0,0.0,0.0
Infection-related hemolytic uremic syndrome,99684,16,6,27,4,23,20,5,15,0.6666666666666666,0.8333333333333334,0.14814814814814814,0.6666666666666666,0.25,0.8333333333333334
Idiopathic congenital hypothyroidism,38624,8,2,20,0,20,20,0,20,0.0,0.0,0.0,0.0,0.0,0.0
Familial thyroid dyshormonogenesis,30902,4,2,16,0,16,19,0,19,0.0,0.0,0.0,0.0,0.0,0.0
Hypothyroidism due to TSH receptor mutations,29150,2,3,17,1,16,21,0,21,0.3333333333333333,0.0,0.058823529411764705,0.3333333333333333,0.0,0.0
Necrobiosis lipoidica,84213,14,2,25,1,24,16,1,15,0.5,0.5,0.04,0.5,0.0625,0.5
CAR T cell therapy-associated cytokine release syndrome,32520,1,5,18,0,18,18,2,16,0.0,0.4,0.0,0.0,0.1111111111111111,0.4
KRT1-related diffuse nonepidermolytic keratoderma,28842,7,2,15,0,15,17,0,17,0.0,0.0,0.0,0.0,0.0,0.0
Mirizzi syndrome,99822,13,0,13,0,13,13,0,13,0.0,0.0,0.0,0.0,0.0,0.0
Aquagenic palmoplantar keratoderma,30262,10,1,12,1,11,10,0,10,1.0,0.0,0.08333333333333333,1.0,0.0,0.0
Extracranial carotid artery aneurysm,99882,10,0,26,0,26,27,0,27,0.0,0.0,0.0,0.0,0.0,0.0
Female infertility due to oocyte meiotic arrest,99878,16,2,24,2,22,28,0,28,1.0,0.0,0.08333333333333333,1.0,0.0,0.0
Obesity-colitis-hypothyroidism-cardiac hypertrophy-developmental delay syndrome,32798,11,0,24,0,24,54,0,54,0.0,0.0,0.0,0.0,0.0,0.0
Caroli syndrome,27699,7,2,34,1,33,25,0,25,0.5,0.0,0.029411764705882353,0.5,0.0,0.0
Primary condylar hyperplasia,98598,3,1,16,1,15,10,1,9,1.0,1.0,0.0625,1.0,0.1,1.0
Severe primary trimethylaminuria,28676,8,2,18,0,18,28,0,28,0.0,0.0,0.0,0.0,0.0,0.0
Exercise-induced malignant hyperthermia,83838,16,2,22,0,22,27,0,27,0.0,0.0,0.0,0.0,0.0,0.0
Catastrophic antiphospholipid syndrome,98579,11,2,12,1,11,25,1,24,0.5,0.5,0.08333333333333333,0.5,0.04,0.5
Neonatal alloimmune neutropenia,98581,17,2,32,0,32,35,0,35,0.0,0.0,0.0,0.0,0.0,0.0
Isolated splenogonadal fusion,98575,1,1,25,0,25,38,0,38,0.0,0.0,0.0,0.0,0.0,0.0
Multifocal lymphangioendotheliomatosis-thrombocytopenia syndrome,98578,11,5,30,1,29,19,0,19,0.2,0.0,0.03333333333333333,0.2,0.0,0.0
IgG4-related submandibular gland disease,98564,13,4,23,1,22,19,1,18,0.25,0.25,0.043478260869565216,0.25,0.05263157894736842,0.25
IgG4-related ophthalmic disease,39512,20,0,27,0,27,27,0,27,0.0,0.0,0.0,0.0,0.0,0.0
Rheumatoid factor-negative polyarticular juvenile idiopathic arthritis,32699,6,0,18,0,18,24,0,24,0.0,0.0,0.0,0.0,0.0,0.0
Oligoarticular juvenile idiopathic arthritis,98152,11,3,24,0,24,23,0,23,0.0,0.0,0.0,0.0,0.0,0.0
Enthesitis-related juvenile idiopathic arthritis,32728,6,3,17,1,16,31,4,27,0.3333333333333333,1.3333333333333333,0.058823529411764705,0.3333333333333333,0.12903225806451613,1.3333333333333333
Porphyria cutanea tarda,33179,3,6,16,2,14,15,2,13,0.3333333333333333,0.3333333333333333,0.125,0.3333333333333333,0.13333333333333333,0.3333333333333333
Porphyria due to ALA dehydratase deficiency,30913,1,1,17,0,17,22,0,22,0.0,0.0,0.0,0.0,0.0,0.0
Hepatoerythropoietic porphyria,36330,16,4,31,0,31,36,1,35,0.0,0.25,0.0,0.0,0.027777777777777776,0.25
Congenital erythropoietic porphyria,29134,8,8,22,1,21,39,1,38,0.125,0.125,0.045454545454545456,0.125,0.02564102564102564,0.125
Leprosy,33293,2,1,39,2,37,29,0,29,2.0,0.0,0.05128205128205128,2.0,0.0,0.0
African trypanosomiasis,32503,0,6,18,1,17,29,0,29,0.16666666666666666,0.0,0.05555555555555555,0.16666666666666666,0.0,0.0
Scorpion envenomation,33066,0,4,17,3,14,24,2,22,0.75,0.5,0.17647058823529413,0.75,0.08333333333333333,0.5
DNM1L-related encephalopathy due to mitochondrial and peroxisomal fission defect,29090,2,1,18,1,17,20,0,20,1.0,0.0,0.05555555555555555,1.0,0.0,0.0
Shigellosis,32999,6,4,24,3,21,23,2,21,0.75,0.5,0.125,0.75,0.08695652173913043,0.5
Trichinellosis,32815,0,0,16,0,16,17,0,17,0.0,0.0,0.0,0.0,0.0,0.0
Amoebiasis due to Entamoeba histolytica,32326,5,0,23,0,23,19,0,19,0.0,0.0,0.0,0.0,0.0,0.0
Listeriosis,33297,4,1,17,1,16,24,1,23,1.0,1.0,0.058823529411764705,1.0,0.041666666666666664,1.0
Tick-borne encephalitis,32422,4,1,17,0,17,30,0,30,0.0,0.0,0.0,0.0,0.0,0.0
Cholera,32626,6,1,16,0,16,17,2,15,0.0,2.0,0.0,0.0,0.11764705882352941,2.0
Q fever,32959,4,1,16,0,16,23,0,23,0.0,0.0,0.0,0.0,0.0,0.0
Lymphatic filariasis,32524,2,4,17,5,12,34,1,33,1.25,0.25,0.29411764705882354,1.25,0.029411764705882353,0.25
Aspergillosis,33216,6,2,35,2,33,24,1,23,1.0,0.5,0.05714285714285714,1.0,0.041666666666666664,0.5
Amoebiasis due to free-living amoebae,32327,2,0,19,0,19,22,0,22,0.0,0.0,0.0,0.0,0.0,0.0
Primary ciliary dyskinesia,32022,10,0,17,0,17,17,0,17,0.0,0.0,0.0,0.0,0.0,0.0
Brucellosis,32932,5,1,19,0,19,20,0,20,0.0,0.0,0.0,0.0,0.0,0.0
Acute lung injury,32483,5,0,16,0,16,14,0,14,0.0,0.0,0.0,0.0,0.0,0.0
Angiostrongyliasis,32338,6,3,23,2,21,24,1,23,0.6666666666666666,0.3333333333333333,0.08695652173913043,0.6666666666666666,0.041666666666666664,0.3333333333333333
Cardiogenic shock,29525,9,4,22,2,20,20,1,19,0.5,0.25,0.09090909090909091,0.5,0.05,0.25
Avian influenza,33079,7,5,19,4,15,21,3,18,0.8,0.6,0.21052631578947367,0.8,0.14285714285714285,0.6
Cockayne syndrome,27995,3,12,81,10,71,26,1,25,0.8333333333333334,0.08333333333333333,0.12345679012345678,0.8333333333333334,0.038461538461538464,0.08333333333333333
Neurofibromatosis type 1 due to NF1 mutation or intragenic deletion,27275,0,2,17,0,17,36,1,35,0.0,0.5,0.0,0.0,0.027777777777777776,0.5
Scedosporiosis,32793,2,4,16,4,12,25,1,24,1.0,0.25,0.25,1.0,0.04,0.25
Pneumocystosis,33210,3,5,16,5,11,20,2,18,1.0,0.4,0.3125,1.0,0.1,0.4
Alport syndrome,28039,2,3,19,1,18,28,1,27,0.3333333333333333,0.3333333333333333,0.05263157894736842,0.3333333333333333,0.03571428571428571,0.3333333333333333
Chromomycosis,32764,0,2,16,2,14,12,1,11,1.0,0.5,0.125,1.0,0.08333333333333333,0.5
Rotor syndrome,27728,4,3,17,4,13,28,1,27,1.3333333333333333,0.3333333333333333,0.23529411764705882,1.3333333333333333,0.03571428571428571,0.3333333333333333
Sotos syndrome,31089,1,3,17,2,15,35,0,35,0.6666666666666666,0.0,0.11764705882352941,0.6666666666666666,0.0,0.0
Classical Ehlers-Danlos syndrome,94824,12,7,24,0,24,33,2,31,0.0,0.2857142857142857,0.0,0.0,0.06060606060606061,0.2857142857142857
Bacterial toxic-shock syndrome,32395,3,3,14,1,13,22,1,21,0.3333333333333333,0.3333333333333333,0.07142857142857142,0.3333333333333333,0.045454545454545456,0.3333333333333333
Rett syndrome,28856,1,10,47,10,37,28,1,27,1.0,0.1,0.2127659574468085,1.0,0.03571428571428571,0.1
Steinert myotonic dystrophy,27540,5,7,58,7,51,26,2,24,1.0,0.2857142857142857,0.1206896551724138,1.0,0.07692307692307693,0.2857142857142857
Poliomyelitis,33284,8,2,27,4,23,23,3,20,2.0,1.5,0.14814814814814814,2.0,0.13043478260869565,1.5
MELAS,30419,3,13,18,2,16,23,3,20,0.15384615384615385,0.23076923076923078,0.1111111111111111,0.15384615384615385,0.13043478260869565,0.23076923076923078
Methanol poisoning,33019,2,1,18,1,17,30,0,30,1.0,0.0,0.05555555555555555,1.0,0.0,0.0
Homocystinuria due to methylene tetrahydrofolate reductase deficiency,31682,1,10,18,3,15,25,1,24,0.3,0.1,0.16666666666666666,0.3,0.04,0.1
Cocaine intoxication,32933,4,0,18,0,18,23,0,23,0.0,0.0,0.0,0.0,0.0,0.0
Ethylene glycol poisoning,33020,3,2,17,1,16,17,1,16,0.5,0.5,0.058823529411764705,0.5,0.058823529411764705,0.5
Lead poisoning,32274,4,0,16,0,16,36,0,36,0.0,0.0,0.0,0.0,0.0,0.0
Chikungunya,32982,7,3,17,2,15,32,3,29,0.6666666666666666,1.0,0.11764705882352941,0.6666666666666666,0.09375,1.0
Autosomal recessive polycystic kidney disease,28262,5,5,24,6,18,34,2,32,1.2,0.4,0.25,1.2,0.058823529411764705,0.4
Zika virus disease,33321,8,2,23,1,22,27,0,27,0.5,0.0,0.043478260869565216,0.5,0.0,0.0
"Atrial septal defect, ostium secundum type",32487,4,1,19,0,19,21,0,21,0.0,0.0,0.0,0.0,0.0,0.0
MFF-related encephalopathy due to mitochondrial and peroxisomal fission defect,29090,0,0,24,0,24,33,0,33,0.0,0.0,0.0,0.0,0.0,0.0
"Atrial septal defect, coronary sinus type",32438,7,2,16,0,16,25,0,25,0.0,0.0,0.0,0.0,0.0,0.0
"Atrial septal defect, sinus venosus type",32439,4,1,16,0,16,20,0,20,0.0,0.0,0.0,0.0,0.0,0.0
"Atrial septal defect, ostium primum type",32440,3,0,17,0,17,19,0,19,0.0,0.0,0.0,0.0,0.0,0.0
15q24 microdeletion syndrome,32429,3,1,16,0,16,22,0,22,0.0,0.0,0.0,0.0,0.0,0.0
SIN3-related intellectual disability syndrome due to a point mutation,32771,0,3,20,3,17,26,0,26,1.0,0.0,0.15,1.0,0.0,0.0
Diffuse alveolar hemorrhage,32934,5,1,24,1,23,24,0,24,1.0,0.0,0.041666666666666664,1.0,0.0,0.0
Acute liver failure,32928,3,4,17,1,16,23,1,22,0.25,0.25,0.058823529411764705,0.25,0.043478260869565216,0.25
Acquired aneurysmal subarachnoid hemorrhage,32930,2,1,19,1,18,25,0,25,1.0,0.0,0.05263157894736842,1.0,0.0,0.0
Huntington disease,38307,17,3,20,0,20,21,0,21,0.0,0.0,0.0,0.0,0.0,0.0
Multiple endocrine neoplasia type 1,28426,7,5,30,1,29,25,1,24,0.2,0.2,0.03333333333333333,0.2,0.04,0.2
Full NF2-related schwannomatosis,27477,0,1,16,0,16,30,0,30,0.0,0.0,0.0,0.0,0.0,0.0
Necrotizing enterocolitis,33306,2,1,16,1,15,19,0,19,1.0,0.0,0.0625,1.0,0.0,0.0
Central retinal vein occlusion,95670,18,3,20,0,20,25,0,25,0.0,0.0,0.0,0.0,0.0,0.0
Uremic pruritus,31981,2,4,15,2,13,24,1,23,0.5,0.25,0.13333333333333333,0.5,0.041666666666666664,0.25
Congenital generalized lipodystrophy,38009,11,5,41,0,41,29,0,29,0.0,0.0,0.0,0.0,0.0,0.0
Cyclic neutropenia,29352,4,4,20,3,17,19,0,19,0.75,0.0,0.15,0.75,0.0,0.0
Self-limited infantile epilepsy,99969,7,2,34,0,34,21,0,21,0.0,0.0,0.0,0.0,0.0,0.0
Glutaryl-CoA dehydrogenase deficiency,31606,1,3,19,1,18,19,0,19,0.3333333333333333,0.0,0.05263157894736842,0.3333333333333333,0.0,0.0
Atypical Rett syndrome,27725,7,16,47,17,30,28,6,22,1.0625,0.375,0.3617021276595745,1.0625,0.21428571428571427,0.375
Spondyloperipheral dysplasia-short ulna syndrome,28561,1,0,31,0,31,26,0,26,0.0,0.0,0.0,0.0,0.0,0.0
Rothmund-Thomson syndrome,27814,5,3,103,3,100,27,0,27,1.0,0.0,0.02912621359223301,1.0,0.0,0.0
Pseudoachondroplasia,27298,1,2,61,3,58,31,0,31,1.5,0.0,0.04918032786885246,1.5,0.0,0.0
Semilobar holoprosencephaly,32634,1,7,33,1,32,42,1,41,0.14285714285714285,0.14285714285714285,0.030303030303030304,0.14285714285714285,0.023809523809523808,0.14285714285714285
Rubinstein-Taybi syndrome due to 16p13.3 microdeletion,28368,2,3,20,2,18,30,2,28,0.6666666666666666,0.6666666666666666,0.1,0.6666666666666666,0.06666666666666667,0.6666666666666666
Rubinstein-Taybi syndrome due to EP300 haploinsufficiency,31755,3,16,49,9,40,29,3,26,0.5625,0.1875,0.1836734693877551,0.5625,0.10344827586206896,0.1875
Midline interhemispheric variant of holoprosencephaly,32633,1,7,16,1,15,29,0,29,0.14285714285714285,0.0,0.0625,0.14285714285714285,0.0,0.0
Alobar holoprosencephaly,32634,1,7,18,1,17,31,1,30,0.14285714285714285,0.14285714285714285,0.05555555555555555,0.14285714285714285,0.03225806451612903,0.14285714285714285
Lobar holoprosencephaly,32634,1,2,22,0,22,37,0,37,0.0,0.0,0.0,0.0,0.0,0.0
Rubinstein-Taybi syndrome due to CREBBP mutations,27993,4,17,35,7,28,30,3,27,0.4117647058823529,0.17647058823529413,0.2,0.4117647058823529,0.1,0.17647058823529413
Shwachman-Diamond syndrome,30543,1,7,17,2,15,29,3,26,0.2857142857142857,0.42857142857142855,0.11764705882352941,0.2857142857142857,0.10344827586206896,0.42857142857142855
Achromatopsia,28348,4,8,16,7,9,27,2,25,0.875,0.25,0.4375,0.875,0.07407407407407407,0.25
Hereditary coproporphyria,27842,6,3,45,3,42,24,1,23,1.0,0.3333333333333333,0.06666666666666667,1.0,0.041666666666666664,0.3333333333333333
PURA-related severe neonatal hypotonia-seizures-encephalopathy syndrome,29245,5,6,21,2,19,29,3,26,0.3333333333333333,0.5,0.09523809523809523,0.3333333333333333,0.10344827586206896,0.5
Infantile convulsions and choreoathetosis,27409,7,1,21,1,20,33,0,33,1.0,0.0,0.047619047619047616,1.0,0.0,0.0
Mowat-Wilson syndrome due to a ZEB2 point mutation,32708,3,5,29,1,28,32,1,31,0.2,0.2,0.034482758620689655,0.2,0.03125,0.2
Colobomatous microphthalmia-obesity-hypogenitalism-intellectual disability syndrome,30814,6,0,16,0,16,17,0,17,0.0,0.0,0.0,0.0,0.0,0.0
Mowat-Wilson syndrome due to monosomy 2q22,31695,2,5,17,1,16,42,2,40,0.2,0.4,0.058823529411764705,0.2,0.047619047619047616,0.4
Septopreoptic holoprosencephaly,32278,1,0,20,0,20,36,0,36,0.0,0.0,0.0,0.0,0.0,0.0
Moyamoya angiopathy-short stature-facial dysmorphism-hypergonadotropic hypogonadism syndrome,29135,3,1,17,0,17,30,0,30,0.0,0.0,0.0,0.0,0.0,0.0
Combined immunodeficiency with facio-oculo-skeletal anomalies,27997,1,0,31,0,31,47,0,47,0.0,0.0,0.0,0.0,0.0,0.0
RNF13-related severe early-onset epileptic encephalopathy,98472,18,0,26,0,26,25,0,25,0.0,0.0,0.0,0.0,0.0,0.0
Pancreatic agenesis-holoprosencephaly syndrome,31432,0,0,18,0,18,29,0,29,0.0,0.0,0.0,0.0,0.0,0.0
Severe generalized junctional epidermolysis bullosa,27638,3,11,20,6,14,20,3,17,0.5454545454545454,0.2727272727272727,0.3,0.5454545454545454,0.15,0.2727272727272727
Infantile multisystem neurologic-endocrine-pancreatic disease,29775,2,8,47,7,40,25,0,25,0.875,0.0,0.14893617021276595,0.875,0.0,0.0
Diamond-Blackfan anemia,27452,6,2,34,1,33,26,0,26,0.5,0.0,0.029411764705882353,0.5,0.0,0.0
"Carnitine palmitoyl transferase II deficiency, myopathic form",30379,2,6,18,5,13,19,1,18,0.8333333333333334,0.16666666666666666,0.2777777777777778,0.8333333333333334,0.05263157894736842,0.16666666666666666
Chédiak-Higashi syndrome,33060,1,8,16,2,14,9,0,9,0.25,0.0,0.125,0.25,0.0,0.0
"Carnitine palmitoyl transferase II deficiency, neonatal form",30701,2,6,18,0,18,28,0,28,0.0,0.0,0.0,0.0,0.0,0.0
Carnitine palmitoyltransferase II deficiency,27251,2,3,17,0,17,31,2,29,0.0,0.6666666666666666,0.0,0.0,0.06451612903225806,0.6666666666666666
Bloom syndrome,28619,0,7,24,4,20,35,1,34,0.5714285714285714,0.14285714285714285,0.16666666666666666,0.5714285714285714,0.02857142857142857,0.14285714285714285
"Carnitine palmitoyl transferase II deficiency, severe infantile form",30701,1,1,18,0,18,21,0,21,0.0,0.0,0.0,0.0,0.0,0.0
Zygomycosis,32249,1,0,25,0,25,16,0,16,0.0,0.0,0.0,0.0,0.0,0.0
Staphylococcal necrotizing pneumonia,32393,4,9,16,8,8,17,2,15,0.8888888888888888,0.2222222222222222,0.5,0.8888888888888888,0.11764705882352941,0.2222222222222222
Boutonneuse fever,33543,6,4,24,2,22,26,3,23,0.5,0.75,0.08333333333333333,0.5,0.11538461538461539,0.75
Japanese encephalitis,33372,3,3,17,1,16,31,1,30,0.3333333333333333,0.3333333333333333,0.058823529411764705,0.3333333333333333,0.03225806451612903,0.3333333333333333
Congenital stationary night blindness,27390,3,4,25,6,19,27,2,25,1.5,0.5,0.24,1.5,0.07407407407407407,0.5
Multiple endocrine neoplasia type 2,28426,8,1,25,0,25,33,1,32,0.0,1.0,0.0,0.0,0.030303030303030304,1.0
Pearson syndrome,29112,2,8,17,1,16,38,1,37,0.125,0.125,0.058823529411764705,0.125,0.02631578947368421,0.125
Li-Fraumeni syndrome,30516,3,1,17,0,17,20,0,20,0.0,0.0,0.0,0.0,0.0,0.0
Cerebral autosomal dominant arteriopathy-subcortical infarcts-leukoencephalopathy,35890,20,4,35,1,34,30,0,30,0.25,0.0,0.02857142857142857,0.25,0.0,0.0
Familial or sporadic hemiplegic migraine,33302,0,6,18,1,17,9,0,9,0.16666666666666666,0.0,0.05555555555555555,0.16666666666666666,0.0,0.0
Alström syndrome,30145,1,12,19,2,17,25,2,23,0.16666666666666666,0.16666666666666666,0.10526315789473684,0.16666666666666666,0.08,0.16666666666666666
Autosomal recessive cerebelloparenchymal disorder type 3,28611,7,9,22,3,19,21,3,18,0.3333333333333333,0.3333333333333333,0.13636363636363635,0.3333333333333333,0.14285714285714285,0.3333333333333333
Fusariosis,32664,2,1,19,0,19,17,0,17,0.0,0.0,0.0,0.0,0.0,0.0
Pulmonary non-tuberculous mycobacterial infection,33377,7,1,15,1,14,23,0,23,1.0,0.0,0.06666666666666667,1.0,0.0,0.0
Self-limited neonatal epilepsy,33100,0,5,16,4,12,22,1,21,0.8,0.2,0.25,0.8,0.045454545454545456,0.2
Kniest dysplasia,28026,1,16,44,11,33,29,1,28,0.6875,0.0625,0.25,0.6875,0.034482758620689655,0.0625
Spinal muscular atrophy-progressive myoclonic epilepsy syndrome,27253,2,6,18,5,13,23,1,22,0.8333333333333334,0.16666666666666666,0.2777777777777778,0.8333333333333334,0.043478260869565216,0.16666666666666666
Lethal ataxia with deafness and optic atrophy,31740,4,14,16,2,14,25,3,22,0.14285714285714285,0.21428571428571427,0.125,0.14285714285714285,0.12,0.21428571428571427
"Metaphyseal chondrodysplasia, Schmid type",31897,0,8,18,5,13,12,0,12,0.625,0.0,0.2777777777777778,0.625,0.0,0.0
Frontometaphyseal dysplasia,29683,0,13,66,12,54,4,0,4,0.9230769230769231,0.0,0.18181818181818182,0.9230769230769231,0.0,0.0
Lissencephaly type 1 due to doublecortin gene mutation,29958,4,4,27,2,25,25,0,25,0.5,0.0,0.07407407407407407,0.5,0.0,0.0
Facial dysmorphism-developmental delay-behavioral abnormalities syndrome due to WAC point mutation,30416,2,6,22,2,20,17,1,16,0.3333333333333333,0.16666666666666666,0.09090909090909091,0.3333333333333333,0.058823529411764705,0.16666666666666666
Cockayne syndrome type 1,27995,4,12,29,3,26,37,2,35,0.25,0.16666666666666666,0.10344827586206896,0.25,0.05405405405405406,0.16666666666666666
Facial dysmorphism-developmental delay-behavioral abnormalities syndrome due to 10p11.21p12.31 microdeletion,33024,3,9,17,6,11,21,3,18,0.6666666666666666,0.3333333333333333,0.35294117647058826,0.6666666666666666,0.14285714285714285,0.3333333333333333
Intellectual disability syndrome due to a DYRK1A point mutation,33278,1,7,23,4,19,26,2,24,0.5714285714285714,0.2857142857142857,0.17391304347826086,0.5714285714285714,0.07692307692307693,0.2857142857142857
Cockayne syndrome type 2,27995,6,6,17,1,16,33,3,30,0.16666666666666666,0.5,0.058823529411764705,0.16666666666666666,0.09090909090909091,0.5
"Spondyloepimetaphyseal dysplasia congenita, Strudwick type",31270,7,2,25,0,25,27,0,27,0.0,0.0,0.0,0.0,0.0,0.0
Spondyloepiphyseal dysplasia congenita,38339,13,6,29,2,27,32,2,30,0.3333333333333333,0.3333333333333333,0.06896551724137931,0.3333333333333333,0.0625,0.3333333333333333
Dystrophic epidermolysis bullosa pruriginosa,27640,0,2,19,0,19,5,1,4,0.0,0.5,0.0,0.0,0.2,0.5
Autosomal recessive cutis laxa type 1,27841,5,6,23,5,18,31,0,31,0.8333333333333334,0.0,0.21739130434782608,0.8333333333333334,0.0,0.0
"Autosomal recessive generalized dystrophic epidermolysis bullosa, intermediate form",27641,2,7,24,5,19,22,3,19,0.7142857142857143,0.42857142857142855,0.20833333333333334,0.7142857142857143,0.13636363636363635,0.42857142857142855
Multiple epiphyseal dysplasia type 1,28099,0,0,111,0,111,5,0,5,0.0,0.0,0.0,0.0,0.0,0.0
Multiple epiphyseal dysplasia type 5,28099,0,2,121,2,119,13,0,13,1.0,0.0,0.01652892561983471,1.0,0.0,0.0
Congenital sialidosis type 2,33392,0,0,37,0,37,2,0,2,0.0,0.0,0.0,0.0,0.0,0.0
DYRK1A-related intellectual disability syndrome due to 21q22.13q22.2 microdeletion,33291,2,6,24,3,21,24,1,23,0.5,0.16666666666666666,0.125,0.5,0.041666666666666664,0.16666666666666666
Ocular cystinosis,27613,7,4,16,4,12,18,2,16,1.0,0.5,0.25,1.0,0.1111111111111111,0.5
Unilateral focal polymicrogyria,28089,2,8,17,3,14,18,3,15,0.375,0.375,0.17647058823529413,0.375,0.16666666666666666,0.375
Unilateral hemispheric polymicrogyria,31034,1,8,16,1,15,30,4,26,0.125,0.5,0.0625,0.125,0.13333333333333333,0.5
Bilateral generalized polymicrogyria,27528,7,3,17,0,17,26,0,26,0.0,0.0,0.0,0.0,0.0,0.0
"Localized dystrophic epidermolysis bullosa, acral form",94830,10,0,25,0,25,24,0,24,0.0,0.0,0.0,0.0,0.0,0.0
Neuroferritinopathy,31590,7,5,44,4,40,24,1,23,0.8,0.2,0.09090909090909091,0.8,0.041666666666666664,0.2
Juvenile nephropathic cystinosis,27421,2,1,81,1,80,14,0,14,1.0,0.0,0.012345679012345678,1.0,0.0,0.0
Gaucher disease-ophthalmoplegia-cardiovascular calcification syndrome,31032,6,0,59,0,59,46,0,46,0.0,0.0,0.0,0.0,0.0,0.0
Subependymal nodular heterotopia,32223,1,0,20,0,20,27,0,27,0.0,0.0,0.0,0.0,0.0,0.0
Sub-cortical nodular heterotopia,32232,1,4,17,3,14,14,1,13,0.75,0.25,0.17647058823529413,0.75,0.07142857142857142,0.25
Cockayne syndrome type 3,27995,5,5,17,0,17,33,0,33,0.0,0.0,0.0,0.0,0.0,0.0
Bilateral frontal polymicrogyria,27722,6,3,19,4,15,24,0,24,1.3333333333333333,0.0,0.21052631578947367,1.3333333333333333,0.0,0.0
Bilateral parasagittal parieto-occipital polymicrogyria,28089,4,4,18,2,16,25,0,25,0.5,0.0,0.1111111111111111,0.5,0.0,0.0
Bilateral frontoparietal polymicrogyria,27722,6,7,20,2,18,24,1,23,0.2857142857142857,0.14285714285714285,0.1,0.2857142857142857,0.041666666666666664,0.14285714285714285
Bilateral perisylvian polymicrogyria,27528,8,2,17,0,17,30,0,30,0.0,0.0,0.0,0.0,0.0,0.0
Lissencephaly due to LIS1 mutation,31829,1,3,18,0,18,18,0,18,0.0,0.0,0.0,0.0,0.0,0.0
Autosomal recessive cutis laxa type 2A,27841,2,9,32,6,26,17,1,16,0.6666666666666666,0.1111111111111111,0.1875,0.6666666666666666,0.058823529411764705,0.1111111111111111
Neonatal inflammatory skin and bowel disease,29248,3,0,19,0,19,12,0,12,0.0,0.0,0.0,0.0,0.0,0.0
Lamb-Shaffer syndrome,30622,0,5,17,3,14,16,0,16,0.6,0.0,0.17647058823529413,0.6,0.0,0.0
Growth delay-intellectual disability-hepatopathy syndrome,29710,2,6,21,8,13,26,3,23,1.3333333333333333,0.5,0.38095238095238093,1.3333333333333333,0.11538461538461539,0.5
GNB5-related intellectual disability-cardiac arrhythmia syndrome,28481,2,2,19,2,17,29,0,29,1.0,0.0,0.10526315789473684,1.0,0.0,0.0
SYNGAP1-related developmental and epileptic encephalopathy,32579,3,5,27,6,21,24,1,23,1.2,0.2,0.2222222222222222,1.2,0.041666666666666664,0.2
Cobblestone lissencephaly without muscular or ocular involvement,27730,2,0,16,0,16,26,0,26,0.0,0.0,0.0,0.0,0.0,0.0
Muscle-eye-brain disease with bilateral multicystic leucodystrophy,32226,0,0,17,0,17,33,0,33,0.0,0.0,0.0,0.0,0.0,0.0
Isolated lissencephaly type 1 without known genetic defects,32992,1,0,17,0,17,36,0,36,0.0,0.0,0.0,0.0,0.0,0.0
"Autosomal recessive generalized dystrophic epidermolysis bullosa, severe form",27641,1,12,16,5,11,16,3,13,0.4166666666666667,0.25,0.3125,0.4166666666666667,0.1875,0.25
"Localized dystrophic epidermolysis bullosa, pretibial form",27640,1,3,31,2,29,13,3,10,0.6666666666666666,1.0,0.06451612903225806,0.6666666666666666,0.23076923076923078,1.0
Recessive dystrophic epidermolysis bullosa inversa,27641,4,1,30,1,29,16,1,15,1.0,1.0,0.03333333333333333,1.0,0.0625,1.0
Self-improving dystrophic epidermolysis bullosa,27640,0,1,18,1,17,8,1,7,1.0,1.0,0.05555555555555555,1.0,0.125,1.0
"Autosomal recessive ataxia, Beauce type",30231,4,4,38,7,31,15,4,11,1.75,1.0,0.18421052631578946,1.75,0.26666666666666666,1.0
"X-linked intellectual disability, Porteous type",28944,3,2,19,1,18,33,0,33,0.5,0.0,0.05263157894736842,0.5,0.0,0.0
Isolated anencephaly,29207,0,0,21,0,21,15,0,15,0.0,0.0,0.0,0.0,0.0,0.0
"X-linked intellectual disability, Sutherland-Haan type",38443,19,2,22,1,21,32,1,31,0.5,0.5,0.045454545454545456,0.5,0.03125,0.5
Juvenile sialidosis type 2,33195,0,4,32,5,27,6,0,6,1.25,0.0,0.15625,1.25,0.0,0.0
Isolated exencephaly,29207,4,0,26,0,26,30,0,30,0.0,0.0,0.0,0.0,0.0,0.0
Variegate porphyria,29457,4,5,44,5,39,25,1,24,1.0,0.2,0.11363636363636363,1.0,0.04,0.2
Spondyloenchondrodysplasia,38339,13,3,21,0,21,45,1,44,0.0,0.3333333333333333,0.0,0.0,0.022222222222222223,0.3333333333333333
FOXG1 syndrome,39034,14,8,29,1,28,29,1,28,0.125,0.125,0.034482758620689655,0.125,0.034482758620689655,0.125
Global developmental delay-alopecia-macrocephaly-facial dysmorphism-structural brain anomalies syndrome,32887,3,0,19,0,19,39,0,39,0.0,0.0,0.0,0.0,0.0,0.0
Combined oxidative phosphorylation defect type 39,38594,17,0,22,0,22,29,0,29,0.0,0.0,0.0,0.0,0.0,0.0
Primary hypomagnesemia-refractory seizures-intellectual disability syndrome,32060,12,0,24,0,24,26,0,26,0.0,0.0,0.0,0.0,0.0,0.0
WARS2-related combined oxidative phosphorylation defect,39041,17,4,27,0,27,27,0,27,0.0,0.0,0.0,0.0,0.0,0.0
17q21.31 microdeletion syndrome,32429,6,7,100,8,92,28,3,25,1.1428571428571428,0.42857142857142855,0.08,1.1428571428571428,0.10714285714285714,0.42857142857142855
Koolen-De Vries syndrome due to a point mutation,32595,4,7,98,8,90,34,0,34,1.1428571428571428,0.0,0.08163265306122448,1.1428571428571428,0.0,0.0
Angelman syndrome due to a point mutation,33073,3,0,20,0,20,26,0,26,0.0,0.0,0.0,0.0,0.0,0.0
Angelman syndrome due to imprinting defect in 15q11-q13,33074,1,0,20,0,20,21,0,21,0.0,0.0,0.0,0.0,0.0,0.0
Angelman syndrome due to maternal 15q11q13 deletion,32657,2,7,19,2,17,20,1,19,0.2857142857142857,0.14285714285714285,0.10526315789473684,0.2857142857142857,0.05,0.14285714285714285
Angelman syndrome due to paternal uniparental disomy of chromosome 15,32658,1,0,19,0,19,25,0,25,0.0,0.0,0.0,0.0,0.0,0.0
Rothmund-Thomson syndrome type 2,27814,3,4,48,3,45,31,0,31,0.75,0.0,0.0625,0.75,0.0,0.0
"Methylmalonic acidemia with homocystinuria, type cblC",33171,6,6,17,1,16,28,0,28,0.16666666666666666,0.0,0.058823529411764705,0.16666666666666666,0.0,0.0
Rothmund-Thomson syndrome type 1,27814,4,2,27,1,26,33,0,33,0.5,0.0,0.037037037037037035,0.5,0.0,0.0
Temple syndrome due to paternal 14q32.2 microdeletion,32465,2,6,18,6,12,28,2,26,1.0,0.3333333333333333,0.3333333333333333,1.0,0.07142857142857142,0.3333333333333333
Temple syndrome due to paternal 14q32.2 hypomethylation,32461,2,7,19,6,13,51,1,50,0.8571428571428571,0.14285714285714285,0.3157894736842105,0.8571428571428571,0.0196078431372549,0.14285714285714285
B3GALT6-related spondylodysplastic Ehlers-Danlos syndrome,31142,2,19,33,3,30,23,2,21,0.15789473684210525,0.10526315789473684,0.09090909090909091,0.15789473684210525,0.08695652173913043,0.10526315789473684
Temple syndrome due to maternal uniparental disomy of chromosome 14,29482,4,6,45,6,39,26,1,25,1.0,0.16666666666666666,0.13333333333333333,1.0,0.038461538461538464,0.16666666666666666
Prader-Willi syndrome due to paternal deletion of 15q11q13 type 2,32961,5,5,18,1,17,50,3,47,0.2,0.6,0.05555555555555555,0.2,0.06,0.6
Prader-Willi syndrome due to paternal deletion of 15q11q13 type 1,32961,5,4,18,1,17,34,2,32,0.25,0.5,0.05555555555555555,0.25,0.058823529411764705,0.5
Prader-Willi syndrome due to paternal 15q11q13 deletion,32961,4,4,17,1,16,33,1,32,0.25,0.25,0.058823529411764705,0.25,0.030303030303030304,0.25
Neurodevelopmental disorder-craniofacial dysmorphism-cardiac defect-skeletal anomalies syndrome due to a point mutation,29350,0,2,18,0,18,35,0,35,0.0,0.0,0.0,0.0,0.0,0.0
Neurodevelopmental disorder-craniofacial dysmorphism-cardiac defect-skeletal anomalies syndrome due to 9q21.3 microdeletion,33183,2,2,17,1,16,19,1,18,0.5,0.5,0.058823529411764705,0.5,0.05263157894736842,0.5
PURA-related severe neonatal hypotonia-seizures-encephalopathy syndrome due to a point mutation,29245,4,4,17,2,15,31,2,29,0.5,0.5,0.11764705882352941,0.5,0.06451612903225806,0.5
Severe neonatal hypotonia-seizures-encephalopathy syndrome due to 5q31.3 microdeletion,33289,2,0,19,0,19,29,0,29,0.0,0.0,0.0,0.0,0.0,0.0
Distal triplication 15q syndrome,33436,1,4,17,2,15,38,0,38,0.5,0.0,0.11764705882352941,0.5,0.0,0.0
Kleefstra syndrome due to a point mutation,32549,4,3,23,2,21,27,2,25,0.6666666666666666,0.6666666666666666,0.08695652173913043,0.6666666666666666,0.07407407407407407,0.6666666666666666
Kagami-Ogata syndrome due to maternal 14q32.2 hypermethylation,32462,3,7,18,5,13,44,0,44,0.7142857142857143,0.0,0.2777777777777778,0.7142857142857143,0.0,0.0
Familial infantile myoclonic epilepsy,29656,0,2,17,3,14,15,1,14,1.5,0.5,0.17647058823529413,1.5,0.06666666666666667,0.5
Methylmalonic acidemia with homocystinuria type cblF,33171,7,7,22,1,21,34,0,34,0.14285714285714285,0.0,0.045454545454545456,0.14285714285714285,0.0,0.0
Kagami-Ogata syndrome due to maternal 14q32.2 microdeletion,32472,1,5,17,3,14,34,0,34,0.6,0.0,0.17647058823529413,0.6,0.0,0.0
Kagami-Ogata syndrome due to paternal uniparental disomy of chromosome 14,32472,1,6,17,2,15,34,0,34,0.3333333333333333,0.0,0.11764705882352941,0.3333333333333333,0.0,0.0
Autosomal spastic paraplegia type 18,30156,2,11,20,1,19,19,0,19,0.09090909090909091,0.0,0.05,0.09090909090909091,0.0,0.0
Autosomal dominant generalized dystrophic epidermolysis bullosa,27641,3,2,22,3,19,22,3,19,1.5,1.5,0.13636363636363635,1.5,0.13636363636363635,1.5
Retinal vasculopathy with cerebral leukoencephalopathy and systemic manifestations,28728,0,3,19,0,19,20,0,20,0.0,0.0,0.0,0.0,0.0,0.0
Pyruvate dehydrogenase E2 deficiency,29463,1,4,27,1,26,33,0,33,0.25,0.0,0.037037037037037035,0.25,0.0,0.0
"Mucopolysaccharidosis type 2, attenuated form",27436,9,11,19,3,16,31,4,27,0.2727272727272727,0.36363636363636365,0.15789473684210525,0.2727272727272727,0.12903225806451613,0.36363636363636365
Pyruvate dehydrogenase E1-alpha deficiency,30558,2,4,20,0,20,30,0,30,0.0,0.0,0.0,0.0,0.0,0.0
Multiple epiphyseal dysplasia due to collagen 9 anomaly,32964,1,1,22,1,21,27,0,27,1.0,0.0,0.045454545454545456,1.0,0.0,0.0
EAST syndrome,30292,0,16,17,8,9,33,0,33,0.5,0.0,0.47058823529411764,0.5,0.0,0.0
Pelizaeus-Merzbacher disease in female carriers,32449,2,0,17,0,17,33,0,33,0.0,0.0,0.0,0.0,0.0,0.0
Null syndrome,32447,2,4,18,4,14,47,0,47,1.0,0.0,0.2222222222222222,1.0,0.0,0.0
X-linked intellectual disability with isolated growth hormone deficiency,33232,3,4,22,4,18,25,2,23,1.0,0.5,0.18181818181818182,1.0,0.08,0.5
"Mucopolysaccharidosis type 2, severe form",27436,9,13,20,2,18,21,5,16,0.15384615384615385,0.38461538461538464,0.1,0.15384615384615385,0.23809523809523808,0.38461538461538464
"Lissencephaly syndrome, Norman-Roberts type",29674,2,6,41,4,37,34,1,33,0.6666666666666666,0.16666666666666666,0.0975609756097561,0.6666666666666666,0.029411764705882353,0.16666666666666666
"Pelizaeus-Merzbacher disease, connatal form",32449,2,7,17,3,14,30,1,29,0.42857142857142855,0.14285714285714285,0.17647058823529413,0.42857142857142855,0.03333333333333333,0.14285714285714285
"Pelizaeus-Merzbacher disease, classic form",32148,12,9,26,1,25,28,3,25,0.1111111111111111,0.3333333333333333,0.038461538461538464,0.1111111111111111,0.10714285714285714,0.3333333333333333
"Pelizaeus-Merzbacher disease, transitional form",32148,11,2,26,0,26,32,0,32,0.0,0.0,0.0,0.0,0.0,0.0
"HSD10 disease, infantile type",32958,1,4,51,3,48,18,0,18,0.75,0.0,0.058823529411764705,0.75,0.0,0.0
Achondrogenesis type 2,27350,2,2,33,3,30,34,1,33,1.5,0.5,0.09090909090909091,1.5,0.029411764705882353,0.5
Leukocyte adhesion deficiency type II,28125,0,8,19,3,16,24,1,23,0.375,0.125,0.15789473684210525,0.375,0.041666666666666664,0.125
"HSD10 disease, neonatal type",32958,0,7,17,4,13,14,0,14,0.5714285714285714,0.0,0.23529411764705882,0.5714285714285714,0.0,0.0
17q11 microdeletion syndrome,32429,4,4,99,0,99,25,0,25,0.0,0.0,0.0,0.0,0.0,0.0
Juvenile amyotrophic lateral sclerosis,31996,5,6,43,8,35,25,1,24,1.3333333333333333,0.16666666666666666,0.18604651162790697,1.3333333333333333,0.04,0.16666666666666666
X-linked cerebral adrenoleukodystrophy,30664,3,8,24,2,22,33,0,33,0.25,0.0,0.08333333333333333,0.25,0.0,0.0
X-linked complicated spastic paraplegia type 1,38818,12,1,22,0,22,14,0,14,0.0,0.0,0.0,0.0,0.0,0.0
Pyruvate dehydrogenase E1-beta deficiency,30558,2,0,20,0,20,24,0,24,0.0,0.0,0.0,0.0,0.0,0.0
Pyruvate dehydrogenase phosphatase deficiency,28544,1,1,19,1,18,22,0,22,1.0,0.0,0.05263157894736842,1.0,0.0,0.0
Pyruvate dehydrogenase E3-binding protein deficiency,29726,2,3,19,0,19,25,0,25,0.0,0.0,0.0,0.0,0.0,0.0
Mucolipidosis type III alpha/beta,27333,0,4,18,2,16,19,0,19,0.5,0.0,0.1111111111111111,0.5,0.0,0.0
Aromatic L-amino acid decarboxylase deficiency,29414,0,3,21,1,20,35,0,35,0.3333333333333333,0.0,0.047619047619047616,0.3333333333333333,0.0,0.0
High-grade dysplasia in patients with Barrett esophagus,96748,15,1,21,0,21,22,0,22,0.0,0.0,0.0,0.0,0.0,0.0
AIDS wasting syndrome,94952,10,0,25,0,25,32,0,32,0.0,0.0,0.0,0.0,0.0,0.0
Pouchitis,97049,13,0,19,0,19,20,0,20,0.0,0.0,0.0,0.0,0.0,0.0
Full schwannomatosis,27477,2,1,26,0,26,24,0,24,0.0,0.0,0.0,0.0,0.0,0.0
Isolated corpus callosum agenesis,29786,6,1,29,1,28,32,0,32,1.0,0.0,0.034482758620689655,1.0,0.0,0.0
Interatrial communication,38046,10,2,27,1,26,19,0,19,0.5,0.0,0.037037037037037035,0.5,0.0,0.0
Multicystic dysplastic kidney,95053,10,2,23,1,22,21,0,21,0.5,0.0,0.043478260869565216,0.5,0.0,0.0
Weiss-Kruszka Syndrome,30327,0,1,22,0,22,34,0,34,0.0,0.0,0.0,0.0,0.0,0.0
Congenital syphilis,84178,8,0,23,0,23,22,0,22,0.0,0.0,0.0,0.0,0.0,0.0
Spinal cord injury,84275,12,1,25,0,25,25,0,25,0.0,0.0,0.0,0.0,0.0,0.0
Hepatitis delta,97156,14,0,24,0,24,22,0,22,0.0,0.0,0.0,0.0,0.0,0.0
Patent urachus,94583,11,2,21,0,21,26,0,26,0.0,0.0,0.0,0.0,0.0,0.0
Gelatinous drop-like corneal dystrophy,28604,12,2,19,2,17,17,2,15,1.0,1.0,0.10526315789473684,1.0,0.11764705882352941,1.0
Sympathetic ophthalmia,84096,17,1,24,1,23,23,1,22,1.0,1.0,0.041666666666666664,1.0,0.043478260869565216,1.0
Congenital fibrosis of extraocular muscles,29189,20,10,29,4,25,26,3,23,0.4,0.3,0.13793103448275862,0.4,0.11538461538461539,0.3
Autosomal dominant adult-onset proximal spinal muscular atrophy,28247,0,0,20,0,20,25,0,25,0.0,0.0,0.0,0.0,0.0,0.0
Kleine-Levin syndrome,29682,12,3,23,4,19,29,3,26,1.3333333333333333,1.0,0.17391304347826086,1.3333333333333333,0.10344827586206896,1.0
Acute radiation syndrome,95048,19,1,19,0,19,31,0,31,0.0,0.0,0.0,0.0,0.0,0.0
Congenital heart block,29836,5,2,16,1,15,22,0,22,0.5,0.0,0.0625,0.5,0.0,0.0
Hydroa vacciniforme,38905,0,5,1,0,1,21,1,20,0.0,0.2,0.0,0.0,0.047619047619047616,0.2
Acute generalized exanthematous pustulosis,98282,5,2,25,0,25,16,0,16,0.0,0.0,0.0,0.0,0.0,0.0
Generalized pustular psoriasis,95091,9,7,32,4,28,33,3,30,0.5714285714285714,0.42857142857142855,0.125,0.5714285714285714,0.09090909090909091,0.42857142857142855
Subacute cutaneous lupus erythematosus,84252,4,1,30,0,30,22,0,22,0.0,0.0,0.0,0.0,0.0,0.0
High altitude pulmonary edema,28417,10,3,21,3,18,23,3,20,1.0,1.0,0.14285714285714285,1.0,0.13043478260869565,1.0
Multifocal atrial tachycardia,84050,13,2,19,2,17,19,1,18,1.0,0.5,0.10526315789473684,1.0,0.05263157894736842,0.5
Fuchs heterochromic iridocyclitis,98202,10,4,26,0,26,20,0,20,0.0,0.0,0.0,0.0,0.0,0.0
ALECT2 amyloidosis,98538,8,2,30,0,30,23,0,23,0.0,0.0,0.0,0.0,0.0,0.0
Cerebral Amyloid Angiopathy,29399,9,1,18,1,17,23,0,23,1.0,0.0,0.05555555555555555,1.0,0.0,0.0
Hereditary ATTR amyloidosis,37798,20,0,30,0,30,27,0,27,0.0,0.0,0.0,0.0,0.0,0.0
ITM2B amyloidosis,30929,2,0,17,0,17,23,0,23,0.0,0.0,0.0,0.0,0.0,0.0
Paraneoplastic sensory ganglionopathy,97534,21,0,35,0,35,26,0,26,0.0,0.0,0.0,0.0,0.0,0.0
Morvan syndrome,97658,17,0,25,0,25,24,0,24,0.0,0.0,0.0,0.0,0.0,0.0
Post-transplant lymphoproliferative disease,84332,20,0,27,0,27,22,0,22,0.0,0.0,0.0,0.0,0.0,0.0
AH amyloidosis,33591,0,1,10,0,10,26,0,26,0.0,0.0,0.0,0.0,0.0,0.0
Visual snow syndrome,98517,14,1,23,0,23,22,0,22,0.0,0.0,0.0,0.0,0.0,0.0
Cat-scratch disease,84076,10,3,14,2,12,18,3,15,0.6666666666666666,1.0,0.14285714285714285,0.6666666666666666,0.16666666666666666,1.0
Submucosal cleft palate,94758,9,0,18,0,18,24,0,24,0.0,0.0,0.0,0.0,0.0,0.0
Soft and hard cleft palate,28138,9,0,27,0,27,26,0,26,0.0,0.0,0.0,0.0,0.0,0.0
Menke-Hennekam syndrome,31425,1,2,18,1,17,41,0,41,0.5,0.0,0.05555555555555555,0.5,0.0,0.0
X-linked lymphoproliferative disease due to XIAP deficiency,30730,3,1,19,1,18,36,1,35,1.0,1.0,0.05263157894736842,1.0,0.027777777777777776,1.0
GATA2 deficiency spectrum,39053,12,10,31,0,31,30,0,30,0.0,0.0,0.0,0.0,0.0,0.0
Hereditary angioedema with C1Inh deficiency,28441,4,0,9,0,9,29,0,29,0.0,0.0,0.0,0.0,0.0,0.0
Pellagra,27367,9,1,17,0,17,26,0,26,0.0,0.0,0.0,0.0,0.0,0.0
Congenital infiltrating lipomatosis of the face,28575,2,1,16,0,16,30,1,29,0.0,1.0,0.0,0.0,0.03333333333333333,1.0
Idiopathic small fibers neuropathy,39080,11,1,25,0,25,41,0,41,0.0,0.0,0.0,0.0,0.0,0.0
Antiphospholipid syndrome,30256,8,1,16,0,16,25,1,24,0.0,1.0,0.0,0.0,0.04,1.0
Immunoglobulin A nephropathy,28827,3,0,18,0,18,17,0,17,0.0,0.0,0.0,0.0,0.0,0.0
TAFRO syndrome,98574,9,5,9,0,9,10,0,10,0.0,0.0,0.0,0.0,0.0,0.0
CLOVES syndrome,27909,1,2,16,1,15,27,0,27,0.5,0.0,0.0625,0.5,0.0,0.0
IgG4-related systemic disease,39127,12,0,32,0,32,23,0,23,0.0,0.0,0.0,0.0,0.0,0.0
Undifferentiated connective tissue syndrome,98675,20,0,26,0,26,31,0,31,0.0,0.0,0.0,0.0,0.0,0.0
Primary membranous glomerulonephritis,94687,10,0,19,0,19,28,0,28,0.0,0.0,0.0,0.0,0.0,0.0
Immune-mediated thrombotic thrombocytopenic purpura,29935,4,3,18,2,16,24,3,21,0.6666666666666666,1.0,0.1111111111111111,0.6666666666666666,0.125,1.0
Macrodactyly of fingers,98332,4,1,14,0,14,22,0,22,0.0,0.0,0.0,0.0,0.0,0.0
Segmental progressive overgrowth syndrome with fibroadipose hyperplasia,98376,1,1,15,0,15,43,1,42,0.0,1.0,0.0,0.0,0.023255813953488372,1.0
MYT1L-related developmental delay-intellectual disability-obesity syndrome,30178,4,5,48,4,44,31,3,28,0.8,0.6,0.08333333333333333,0.8,0.0967741935483871,0.6
Macrodactyly of toes,98334,2,2,4,0,4,19,0,19,0.0,0.0,0.0,0.0,0.0,0.0
Focal stiff limb syndrome,98552,12,0,20,0,20,32,0,32,0.0,0.0,0.0,0.0,0.0,0.0
Sternal cleft,32538,0,3,14,1,13,29,2,27,0.3333333333333333,0.6666666666666666,0.07142857142857142,0.3333333333333333,0.06896551724137931,0.6666666666666666
Isolated proximal femoral focal deficiency,27536,2,4,27,2,25,20,2,18,0.5,0.5,0.07407407407407407,0.5,0.1,0.5
Langerhans cell histiocytosis,36458,14,2,25,1,24,35,1,34,0.5,0.5,0.04,0.5,0.02857142857142857,0.5
Body integrity dysphoria,95275,8,0,29,0,29,26,0,26,0.0,0.0,0.0,0.0,0.0,0.0
Paraneoplastic cerebellar degeneration,99919,14,0,16,0,16,14,0,14,0.0,0.0,0.0,0.0,0.0,0.0
Hyperphenylalaninemia due to tetrahydrobiopterin deficiency,38743,19,1,27,1,26,31,1,30,1.0,1.0,0.037037037037037035,1.0,0.03225806451612903,1.0
Non-syndromic unicoronal craniosynostosis,27344,1,0,19,0,19,30,0,30,0.0,0.0,0.0,0.0,0.0,0.0
Ring chromosome 20 syndrome,97976,18,2,29,0,29,28,0,28,0.0,0.0,0.0,0.0,0.0,0.0
Glycogen storage disease due to muscle phosphorylase kinase deficiency,32211,2,1,18,0,18,23,0,23,0.0,0.0,0.0,0.0,0.0,0.0
Sitosterolemia,28490,2,0,17,0,17,32,0,32,0.0,0.0,0.0,0.0,0.0,0.0
Ring chromosome 18 syndrome,97974,18,0,23,0,23,26,0,26,0.0,0.0,0.0,0.0,0.0,0.0
Hereditary angioedema with normal C1Inh,38991,21,1,26,0,26,33,0,33,0.0,0.0,0.0,0.0,0.0,0.0
Subacute sclerosing leukoencephalitis,28636,7,3,19,0,19,19,0,19,0.0,0.0,0.0,0.0,0.0,0.0
Severe disseminated cytomegalovirus infection in immunocompetent patients,98445,22,2,32,0,32,31,0,31,0.0,0.0,0.0,0.0,0.0,0.0
Discoid lupus erythematosus,84030,21,0,28,0,28,30,0,30,0.0,0.0,0.0,0.0,0.0,0.0
Pediatric acute respiratory distress syndrome,38762,7,1,22,2,20,19,1,18,2.0,1.0,0.09090909090909091,2.0,0.05263157894736842,1.0
Idiopathic bilateral vestibulopathy,98027,15,2,25,1,24,27,1,26,0.5,0.5,0.04,0.5,0.037037037037037035,0.5
Cleft hard palate,28138,4,0,11,0,11,34,0,34,0.0,0.0,0.0,0.0,0.0,0.0
Oculo-auriculo-vertebral spectrum,29829,1,3,17,0,17,26,0,26,0.0,0.0,0.0,0.0,0.0,0.0
Resistance to thyroid hormone due to a mutation in thyroid hormone receptor beta,38315,2,4,5,0,5,21,0,21,0.0,0.0,0.0,0.0,0.0,0.0
Holmes-Adie syndrome,30340,2,1,24,1,23,31,0,31,1.0,0.0,0.041666666666666664,1.0,0.0,0.0
Hemifacial hyperplasia,28014,3,2,19,2,17,35,1,34,1.0,0.5,0.10526315789473684,1.0,0.02857142857142857,0.5
Isolated tracheoesophageal fistula,83963,14,0,21,0,21,17,0,17,0.0,0.0,0.0,0.0,0.0,0.0
X-linked adrenal hypoplasia congenita,27878,6,3,18,1,17,31,1,30,0.3333333333333333,0.3333333333333333,0.05555555555555555,0.3333333333333333,0.03225806451612903,0.3333333333333333
Nevus of Ito,94967,5,1,18,0,18,16,1,15,0.0,1.0,0.0,0.0,0.0625,1.0
Apnea of prematurity,98872,19,1,26,1,25,23,1,22,1.0,1.0,0.038461538461538464,1.0,0.043478260869565216,1.0
Autoimmune limbic encephalitis,98243,17,0,25,0,25,28,0,28,0.0,0.0,0.0,0.0,0.0,0.0
Methotrexate toxicity,99694,16,0,35,0,35,30,0,30,0.0,0.0,0.0,0.0,0.0,0.0
Univentricular heart,98819,9,2,18,0,18,28,0,28,0.0,0.0,0.0,0.0,0.0,0.0
Fatal familial insomnia,31404,4,4,19,3,16,35,1,34,0.75,0.25,0.15789473684210525,0.75,0.02857142857142857,0.25
Cytomegalovirus disease in patients with impaired cell mediated immunity deemed at risk,98445,16,0,17,0,17,19,0,19,0.0,0.0,0.0,0.0,0.0,0.0
"Dyssegmental dysplasia, Silverman-Handmaker type",31173,1,0,18,0,18,30,0,30,0.0,0.0,0.0,0.0,0.0,0.0
Schimke immuno-osseous dysplasia,38670,4,7,29,1,28,30,1,29,0.14285714285714285,0.14285714285714285,0.034482758620689655,0.14285714285714285,0.03333333333333333,0.14285714285714285
Spondyloepiphyseal dysplasia tarda,31270,0,10,29,0,29,23,1,22,0.0,0.1,0.0,0.0,0.043478260869565216,0.1
"Brachydactylous dwarfism, Mseleni type",29239,1,11,17,1,16,31,1,30,0.09090909090909091,0.09090909090909091,0.058823529411764705,0.09090909090909091,0.03225806451612903,0.09090909090909091
Parenteral nutrition-associated cholestasis,38577,18,0,21,0,21,26,0,26,0.0,0.0,0.0,0.0,0.0,0.0
Dihydropyrimidine dehydrogenase deficiency,31257,0,2,16,0,16,18,0,18,0.0,0.0,0.0,0.0,0.0,0.0
Alternating hemiplegia of childhood,39246,15,3,20,0,20,31,0,31,0.0,0.0,0.0,0.0,0.0,0.0
Bronchogenic cyst,94624,11,1,15,0,15,23,0,23,0.0,0.0,0.0,0.0,0.0,0.0
Congenital factor XII deficiency,30298,7,2,29,1,28,18,0,18,0.5,0.0,0.034482758620689655,0.5,0.0,0.0
"Spondyloepimetaphyseal dysplasia, Missouri type",38339,2,0,32,0,32,33,0,33,0.0,0.0,0.0,0.0,0.0,0.0
"Spondyloepimetaphyseal dysplasia, Shohat type",38339,17,0,28,0,28,42,0,42,0.0,0.0,0.0,0.0,0.0,0.0
Fatal infantile lactic acidosis with methylmalonic aciduria,27243,9,7,49,1,48,33,1,32,0.14285714285714285,0.14285714285714285,0.02040816326530612,0.14285714285714285,0.030303030303030304,0.14285714285714285
Chronic beryllium disease,83795,15,3,23,1,22,17,1,16,0.3333333333333333,0.3333333333333333,0.043478260869565216,0.3333333333333333,0.058823529411764705,0.3333333333333333
Hydrops fetalis,33587,11,0,20,0,20,26,0,26,0.0,0.0,0.0,0.0,0.0,0.0
Progressive deafness with stapes fixation,31891,8,2,24,2,22,20,0,20,1.0,0.0,0.08333333333333333,1.0,0.0,0.0
Common arterial trunk,28716,0,6,32,1,31,31,2,29,0.16666666666666666,0.3333333333333333,0.03125,0.16666666666666666,0.06451612903225806,0.3333333333333333
Atrial standstill,28629,3,5,10,4,6,26,1,25,0.8,0.2,0.4,0.8,0.038461538461538464,0.2
"Spondyloepimetaphyseal dysplasia with joint laxity, leptodactylic type",31270,6,5,23,4,19,31,5,26,0.8,1.0,0.17391304347826086,0.8,0.16129032258064516,1.0
Neurogenic arthrogryposis multiplex congenita,31166,1,2,17,0,17,30,1,29,0.0,0.5,0.0,0.0,0.03333333333333333,0.5
Saccharopinuria,28325,2,2,22,0,22,29,0,29,0.0,0.0,0.0,0.0,0.0,0.0
D-glyceric aciduria,30677,1,3,16,1,15,30,1,29,0.3333333333333333,0.3333333333333333,0.0625,0.3333333333333333,0.03333333333333333,0.3333333333333333
Congenital microcoria,28258,14,4,24,0,24,43,1,42,0.0,0.25,0.0,0.0,0.023255813953488372,0.25
Essential fructosuria,29513,8,5,17,2,15,20,0,20,0.4,0.0,0.11764705882352941,0.4,0.0,0.0
Hyperlysinemia,29302,3,0,18,0,18,28,0,28,0.0,0.0,0.0,0.0,0.0,0.0
Infantile-onset X-linked spinal muscular atrophy,30356,1,7,36,4,32,34,0,34,0.5714285714285714,0.0,0.1111111111111111,0.5714285714285714,0.0,0.0
Multiple epiphyseal dysplasia type 4,28099,0,3,121,3,118,10,0,10,1.0,0.0,0.024793388429752067,1.0,0.0,0.0
"Spondylometaphyseal dysplasia, Kozlowski type",31451,1,5,28,2,26,36,1,35,0.4,0.2,0.07142857142857142,0.4,0.027777777777777776,0.2
Spondylometaphyseal dysplasia-cone-rod dystrophy syndrome,27381,1,20,37,12,25,37,2,35,0.6,0.1,0.32432432432432434,0.6,0.05405405405405406,0.1
Fixed subaortic stenosis,38779,11,0,19,0,19,15,0,15,0.0,0.0,0.0,0.0,0.0,0.0
Aortic arch interruption,94903,10,3,27,1,26,28,0,28,0.3333333333333333,0.0,0.037037037037037035,0.3333333333333333,0.0,0.0
Isolated right ventricular hypoplasia,29542,14,4,16,2,14,23,2,21,0.5,0.5,0.125,0.5,0.08695652173913043,0.5
Coronary arterial fistula,98070,14,0,23,0,23,24,0,24,0.0,0.0,0.0,0.0,0.0,0.0
Cardiac diverticulum,33710,4,0,19,0,19,20,0,20,0.0,0.0,0.0,0.0,0.0,0.0
Hemoglobin E disease,94921,2,6,23,2,21,23,4,19,0.3333333333333333,0.6666666666666666,0.08695652173913043,0.3333333333333333,0.17391304347826086,0.6666666666666666
Idiopathic camptocormia,97932,0,0,14,0,14,15,0,15,0.0,0.0,0.0,0.0,0.0,0.0
Hereditary steroid-resistant nephrotic syndrome,38873,17,2,29,4,25,18,3,15,2.0,1.5,0.13793103448275862,2.0,0.16666666666666666,1.5
Congenitally uncorrected transposition of the great arteries,38925,7,7,23,2,21,26,1,25,0.2857142857142857,0.14285714285714285,0.08695652173913043,0.2857142857142857,0.038461538461538464,0.14285714285714285
Porokeratosis plantaris palmaris et disseminata,30735,8,0,17,0,17,16,0,16,0.0,0.0,0.0,0.0,0.0,0.0
Axial spondylometaphyseal dysplasia,38339,7,15,17,0,17,26,2,24,0.0,0.13333333333333333,0.0,0.0,0.07692307692307693,0.13333333333333333
"Spondylometaphyseal dysplasia, Schmidt type",31621,3,3,18,2,16,44,3,41,0.6666666666666666,1.0,0.1111111111111111,0.6666666666666666,0.06818181818181818,1.0
"Spondylometaphyseal dysplasia, 'corner fracture' type",29065,2,6,24,2,22,39,2,37,0.3333333333333333,0.3333333333333333,0.08333333333333333,0.3333333333333333,0.05128205128205128,0.3333333333333333
Marburg hemorrhagic fever,32353,6,5,17,1,16,24,0,24,0.2,0.0,0.058823529411764705,0.2,0.0,0.0
Familial exudative vitreoretinopathy,33668,8,2,17,1,16,27,0,27,0.5,0.0,0.058823529411764705,0.5,0.0,0.0
Punctate palmoplantar keratoderma type 1,30262,14,4,16,4,12,16,4,12,1.0,1.0,0.25,1.0,0.25,1.0
Idiopathic chronic eosinophilic pneumonia,33206,9,2,17,1,16,19,0,19,0.5,0.0,0.058823529411764705,0.5,0.0,0.0
Microlissencephaly,38724,13,8,28,3,25,37,1,36,0.375,0.125,0.10714285714285714,0.375,0.02702702702702703,0.125
Arachnoid cyst,38459,13,0,20,0,20,29,0,29,0.0,0.0,0.0,0.0,0.0,0.0
Eales disease,98513,16,0,30,0,30,25,0,25,0.0,0.0,0.0,0.0,0.0,0.0
Crimean-Congo hemorrhagic fever,32347,8,4,15,2,13,29,1,28,0.5,0.25,0.13333333333333333,0.5,0.034482758620689655,0.25
Hereditary sensory and autonomic neuropathy type 1,27625,3,6,33,4,29,27,2,25,0.6666666666666666,0.3333333333333333,0.12121212121212122,0.6666666666666666,0.07407407407407407,0.3333333333333333
Andersen-Tawil syndrome,30353,0,3,43,1,42,29,1,28,0.3333333333333333,0.3333333333333333,0.023255813953488372,0.3333333333333333,0.034482758620689655,0.3333333333333333
Glutaric acidemia type 3,29395,15,2,29,0,29,33,0,33,0.0,0.0,0.0,0.0,0.0,0.0
Imerslund-Gräsbeck syndrome,27327,7,6,24,1,23,24,0,24,0.16666666666666666,0.0,0.041666666666666664,0.16666666666666666,0.0,0.0
Familial idiopathic dilatation of the right atrium,98017,14,2,23,1,22,21,0,21,0.5,0.0,0.043478260869565216,0.5,0.0,0.0
Urachal cyst,94604,8,0,19,0,19,13,0,13,0.0,0.0,0.0,0.0,0.0,0.0
Yellow fever,32350,5,5,16,1,15,24,1,23,0.2,0.2,0.0625,0.2,0.041666666666666664,0.2
Bietti crystalline dystrophy,29132,2,0,20,0,20,29,0,29,0.0,0.0,0.0,0.0,0.0,0.0
Formiminoglutamic aciduria,29436,5,3,25,0,25,20,2,18,0.0,0.6666666666666666,0.0,0.0,0.1,0.6666666666666666
Postinfectious vasculitis,98608,10,0,15,0,15,32,0,32,0.0,0.0,0.0,0.0,0.0,0.0
Hereditary geniospasm,29238,11,2,22,1,21,20,0,20,0.5,0.0,0.045454545454545456,0.5,0.0,0.0
Schilder disease,95018,1,0,29,0,29,31,0,31,0.0,0.0,0.0,0.0,0.0,0.0
Sorsby pseudoinflammatory fundus dystrophy,29952,8,4,20,1,19,23,1,22,0.25,0.25,0.05,0.25,0.043478260869565216,0.25
Iridocorneal endothelial syndrome,39584,18,0,23,0,23,24,0,24,0.0,0.0,0.0,0.0,0.0,0.0
Pulmonary alveolar microlithiasis,31555,9,0,21,0,21,22,0,22,0.0,0.0,0.0,0.0,0.0,0.0
MPI-CDG,28759,0,7,17,2,15,39,0,39,0.2857142857142857,0.0,0.11764705882352941,0.2857142857142857,0.0,0.0
Rift valley fever,32954,4,3,17,1,16,29,2,27,0.3333333333333333,0.6666666666666666,0.058823529411764705,0.3333333333333333,0.06896551724137931,0.6666666666666666
ALG12-CDG,30614,0,3,17,1,16,22,0,22,0.3333333333333333,0.0,0.058823529411764705,0.3333333333333333,0.0,0.0
ALG6-CDG,31949,8,1,22,0,22,28,0,28,0.0,0.0,0.0,0.0,0.0,0.0
IgG4-related thyroid disease,98622,10,2,17,3,14,20,0,20,1.5,0.0,0.17647058823529413,1.5,0.0,0.0
Hepatoportal sclerosis,98621,15,2,26,0,26,19,0,19,0.0,0.0,0.0,0.0,0.0,0.0
Vaginal atresia,94553,3,1,13,0,13,12,0,12,0.0,0.0,0.0,0.0,0.0,0.0
Late-onset retinal degeneration,31421,5,1,20,0,20,26,0,26,0.0,0.0,0.0,0.0,0.0,0.0
Familial renal glucosuria,30252,6,3,22,2,20,22,1,21,0.6666666666666666,0.3333333333333333,0.09090909090909091,0.6666666666666666,0.045454545454545456,0.3333333333333333
Low phospholipid-associated cholelithiasis,31501,5,2,18,0,18,19,1,18,0.0,0.5,0.0,0.0,0.05263157894736842,0.5
Warty dyskeratoma,98626,2,4,20,3,17,8,2,6,0.75,0.5,0.15,0.75,0.25,0.5
"Congenital lactic acidosis, Saguenay-Lac-Saint-Jean type",28087,5,10,17,5,12,20,2,18,0.5,0.2,0.29411764705882354,0.5,0.1,0.2
Rh deficiency syndrome,28631,5,5,21,3,18,22,0,22,0.6,0.0,0.14285714285714285,0.6,0.0,0.0
ALG2-CDG,31949,7,2,20,0,20,27,0,27,0.0,0.0,0.0,0.0,0.0,0.0
ALG1-CDG,31949,7,4,18,3,15,25,2,23,0.75,0.5,0.16666666666666666,0.75,0.08,0.5
ALG9-CDG,31949,6,3,21,3,18,21,0,21,1.0,0.0,0.14285714285714285,1.0,0.0,0.0
MGAT2-CDG,30985,0,3,18,0,18,27,0,27,0.0,0.0,0.0,0.0,0.0,0.0
Familial drusen,31699,9,5,28,2,26,41,0,41,0.4,0.0,0.07142857142857142,0.4,0.0,0.0
Angioosteohypotrophic syndrome,98631,14,8,38,0,38,38,1,37,0.0,0.125,0.0,0.0,0.02631578947368421,0.125
Loeffler endocarditis,95004,17,4,28,0,28,32,0,32,0.0,0.0,0.0,0.0,0.0,0.0
MORM syndrome,28252,2,4,17,6,11,17,0,17,1.5,0.0,0.35294117647058826,1.5,0.0,0.0
Morgagni-Stewart-Morel syndrome,31919,0,7,35,1,34,17,0,17,0.14285714285714285,0.0,0.02857142857142857,0.14285714285714285,0.0,0.0
DPAGT1-CDG,31900,1,0,16,0,16,21,0,21,0.0,0.0,0.0,0.0,0.0,0.0
MOGS-CDG,27895,1,0,16,0,16,34,0,34,0.0,0.0,0.0,0.0,0.0,0.0
Foix-Alajouanine syndrome,31536,0,7,17,0,17,10,0,10,0.0,0.0,0.0,0.0,0.0,0.0
IgG4-related dacryoadenitis and sialadenitis,98632,8,4,20,4,16,10,3,7,1.0,0.75,0.2,1.0,0.3,0.75
Folinic acid-responsive seizures,94786,9,4,29,2,27,28,2,26,0.5,0.5,0.06896551724137931,0.5,0.07142857142857142,0.5
DPM1-CDG,28471,1,5,16,0,16,16,0,16,0.0,0.0,0.0,0.0,0.0,0.0
Paroxysmal nocturnal hemoglobinuria,27950,7,5,17,1,16,25,3,22,0.2,0.6,0.058823529411764705,0.2,0.12,0.6
Multiple osteochondromas,32248,3,1,29,0,29,30,0,30,0.0,0.0,0.0,0.0,0.0,0.0
Lymphoid interstitial pneumonia,28002,12,1,23,1,22,25,1,24,1.0,1.0,0.043478260869565216,1.0,0.04,1.0
Respiratory bronchiolitis-interstitial lung disease syndrome,98635,13,0,16,0,16,18,0,18,0.0,0.0,0.0,0.0,0.0,0.0
Hyperprolinemia type 2,28903,1,10,16,6,10,24,1,23,0.6,0.1,0.375,0.6,0.041666666666666664,0.1
Atrophoderma vermiculata,30218,9,5,22,0,22,33,0,33,0.0,0.0,0.0,0.0,0.0,0.0
MPDU1-CDG,29713,0,3,17,0,17,29,0,29,0.0,0.0,0.0,0.0,0.0,0.0
Idiopathic trachyonychia,38902,11,1,13,1,12,13,1,12,1.0,1.0,0.07692307692307693,1.0,0.07692307692307693,1.0
Dowling-Degos disease,27573,3,1,15,1,14,16,0,16,1.0,0.0,0.06666666666666667,1.0,0.0,0.0
Bickerstaff brainstem encephalitis,95013,13,8,21,2,19,24,2,22,0.25,0.25,0.09523809523809523,0.25,0.08333333333333333,0.25
COG7-CDG,28972,1,9,43,5,38,19,0,19,0.5555555555555556,0.0,0.11627906976744186,0.5555555555555556,0.0,0.0
Glycogen storage disease due to liver and muscle phosphorylase kinase deficiency,32211,2,4,17,1,16,26,0,26,0.25,0.0,0.058823529411764705,0.25,0.0,0.0
DK1-CDG,27334,0,4,17,0,17,28,0,28,0.0,0.0,0.0,0.0,0.0,0.0
T-cell immunodeficiency with thymic aplasia,38584,6,7,18,1,17,20,2,18,0.14285714285714285,0.2857142857142857,0.05555555555555555,0.14285714285714285,0.1,0.2857142857142857
Senior-Boichis syndrome,39040,9,0,34,0,34,39,0,39,0.0,0.0,0.0,0.0,0.0,0.0
Autosomal recessive hyperinsulinism due to Kir6.2 deficiency,98643,20,5,30,1,29,28,1,27,0.2,0.2,0.03333333333333333,0.2,0.03571428571428571,0.2
Florid cemento-osseous dysplasia,98647,8,5,22,2,20,31,2,29,0.4,0.4,0.09090909090909091,0.4,0.06451612903225806,0.4
ATTRV122I amyloidosis,33159,4,5,17,0,17,21,0,21,0.0,0.0,0.0,0.0,0.0,0.0
Osteopetrosis with renal tubular acidosis,31011,7,3,19,0,19,22,1,21,0.0,0.3333333333333333,0.0,0.0,0.045454545454545456,0.3333333333333333
"Metaphyseal dysplasia, Braun-Tinschert type",97797,8,0,48,0,48,20,0,20,0.0,0.0,0.0,0.0,0.0,0.0
Hereditary amyloidosis with primary renal involvement,98538,16,3,23,0,23,25,1,24,0.0,0.3333333333333333,0.0,0.0,0.04,0.3333333333333333
Hypotrichosis simplex of the scalp,38321,9,2,21,1,20,25,0,25,0.5,0.0,0.047619047619047616,0.5,0.0,0.0
Pycnodysostosis,29524,1,9,20,1,19,28,1,27,0.1111111111111111,0.1111111111111111,0.05,0.1111111111111111,0.03571428571428571,0.1111111111111111
Hemoglobin D disease,94922,6,2,29,1,28,28,0,28,0.5,0.0,0.034482758620689655,0.5,0.0,0.0
Congenital tracheomalacia,33607,8,2,18,1,17,22,0,22,0.5,0.0,0.05555555555555555,0.5,0.0,0.0
Dural sinus malformation,98780,0,0,2,0,2,23,0,23,0.0,0.0,0.0,0.0,0.0,0.0
Charcot-Marie-Tooth disease type 2B1,27530,7,9,34,2,32,25,1,24,0.2222222222222222,0.1111111111111111,0.058823529411764705,0.2222222222222222,0.04,0.1111111111111111
Granular corneal dystrophy type I,31074,11,2,26,0,26,20,0,20,0.0,0.0,0.0,0.0,0.0,0.0
X-linked dominant chondrodysplasia punctata,27823,1,2,43,2,41,37,0,37,1.0,0.0,0.046511627906976744,1.0,0.0,0.0
X-linked centronuclear myopathy,30705,2,2,18,0,18,30,0,30,0.0,0.0,0.0,0.0,0.0,0.0
Ulerythema ophryogenesis,33383,0,6,17,1,16,14,0,14,0.16666666666666666,0.0,0.058823529411764705,0.16666666666666666,0.0,0.0
Blue diaper syndrome,28399,2,1,15,0,15,36,0,36,0.0,0.0,0.0,0.0,0.0,0.0
Persistent hyperplastic primary vitreous,31357,5,6,20,5,15,26,4,22,0.8333333333333334,0.6666666666666666,0.25,0.8333333333333334,0.15384615384615385,0.6666666666666666
Renal dysplasia,39543,9,0,15,0,15,39,0,39,0.0,0.0,0.0,0.0,0.0,0.0
Isolated osteopoikilosis,32799,1,3,25,2,23,28,3,25,0.6666666666666666,1.0,0.08,0.6666666666666666,0.10714285714285714,1.0
Simple cryoglobulinemia,39715,11,3,22,1,21,18,2,16,0.3333333333333333,0.6666666666666666,0.045454545454545456,0.3333333333333333,0.1111111111111111,0.6666666666666666
Chronic pneumonitis of infancy,98690,15,0,18,0,18,23,0,23,0.0,0.0,0.0,0.0,0.0,0.0
Marcus-Gunn syndrome,98803,11,1,13,0,13,33,0,33,0.0,0.0,0.0,0.0,0.0,0.0
Apolipoprotein A-I deficiency,33460,5,4,23,2,21,24,2,22,0.5,0.5,0.08695652173913043,0.5,0.08333333333333333,0.5
Renin-angiotensin-aldosterone system-blocker-induced angioedema,83772,17,3,25,0,25,33,0,33,0.0,0.0,0.0,0.0,0.0,0.0
Idiopathic pulmonary hemosiderosis,29605,11,1,20,1,19,18,0,18,1.0,0.0,0.05,1.0,0.0,0.0
Genetic recurrent myoglobinuria,32122,7,5,19,2,17,28,2,26,0.4,0.4,0.10526315789473684,0.4,0.07142857142857142,0.4
Charcot-Marie-Tooth disease type 4B2,27530,3,9,28,2,26,18,4,14,0.2222222222222222,0.4444444444444444,0.07142857142857142,0.2222222222222222,0.2222222222222222,0.4444444444444444
Charcot-Marie-Tooth disease type 4A,27530,6,9,27,2,25,20,0,20,0.2222222222222222,0.0,0.07407407407407407,0.2222222222222222,0.0,0.0
Fuchs endothelial corneal dystrophy,28626,4,6,13,7,6,20,5,15,1.1666666666666667,0.8333333333333334,0.5384615384615384,1.1666666666666667,0.25,0.8333333333333334
Metaphyseal chondromatosis with D-2-hydroxyglutaric aciduria,94942,17,6,28,0,28,28,0,28,0.0,0.0,0.0,0.0,0.0,0.0
Congenital Gerbode defect,98836,5,2,8,0,8,6,0,6,0.0,0.0,0.0,0.0,0.0,0.0
Cushing disease,28977,2,4,16,0,16,25,0,25,0.0,0.0,0.0,0.0,0.0,0.0
Granular corneal dystrophy type II,31074,13,3,25,1,24,19,0,19,0.3333333333333333,0.0,0.04,0.3333333333333333,0.0,0.0
Cushing syndrome due to bilateral macronodular adrenocortical disease,33101,6,3,19,1,18,29,1,28,0.3333333333333333,0.3333333333333333,0.05263157894736842,0.3333333333333333,0.034482758620689655,0.3333333333333333
Craniofaciofrontodigital syndrome,28512,1,4,18,1,17,43,1,42,0.25,0.25,0.05555555555555555,0.25,0.023255813953488372,0.25
Isolated congenital hypoglossia/aglossia,39017,1,4,3,0,3,29,2,27,0.0,0.5,0.0,0.0,0.06896551724137931,0.5
Diffuse cutaneous mastocytosis,32208,4,5,14,1,13,19,1,18,0.2,0.2,0.07142857142857142,0.2,0.05263157894736842,0.2
Proboscis lateralis,97956,5,2,13,1,12,12,1,11,0.5,0.5,0.07692307692307693,0.5,0.08333333333333333,0.5
Nasolacrimal duct cyst,97955,13,0,17,0,17,27,0,27,0.0,0.0,0.0,0.0,0.0,0.0
Cutaneous mastocytoma,98930,4,1,15,0,15,23,0,23,0.0,0.0,0.0,0.0,0.0,0.0
Pemphigus erythematosus,32580,8,5,21,3,18,20,1,19,0.6,0.2,0.14285714285714285,0.6,0.05,0.2
Pemphigus foliaceus,32581,6,2,20,1,19,25,0,25,0.5,0.0,0.05,0.5,0.0,0.0
Epilepsy with eyelid myoclonia,99971,8,2,18,0,18,32,0,32,0.0,0.0,0.0,0.0,0.0,0.0
Secondary intestinal lymphangiectasia,28962,9,2,22,1,21,21,0,21,0.5,0.0,0.045454545454545456,0.5,0.0,0.0
Legius syndrome,38110,0,1,23,0,23,29,0,29,0.0,0.0,0.0,0.0,0.0,0.0
Acute transverse myelitis,97946,18,0,30,0,30,30,0,30,0.0,0.0,0.0,0.0,0.0,0.0
Trehalase deficiency,29215,0,1,16,0,16,16,0,16,0.0,0.0,0.0,0.0,0.0,0.0
Tropical pancreatitis,31493,8,3,17,1,16,20,0,20,0.3333333333333333,0.0,0.058823529411764705,0.3333333333333333,0.0,0.0
Autosomal recessive Charcot-Marie-Tooth disease with hoarseness,27720,2,15,24,4,20,34,1,33,0.26666666666666666,0.06666666666666667,0.16666666666666666,0.26666666666666666,0.029411764705882353,0.06666666666666667
Chronic diarrhea due to glucoamylase deficiency,97919,15,1,20,0,20,20,0,20,0.0,0.0,0.0,0.0,0.0,0.0
Cerebral autosomal recessive arteriopathy-subcortical infarcts-leukoencephalopathy,35890,15,0,24,0,24,32,0,32,0.0,0.0,0.0,0.0,0.0,0.0
Recurrent infections associated with rare immunoglobulin isotypes deficiency,30569,12,0,20,0,20,26,0,26,0.0,0.0,0.0,0.0,0.0,0.0
Short stature-delayed bone age due to thyroid hormone metabolism deficiency,27585,10,1,17,0,17,23,0,23,0.0,0.0,0.0,0.0,0.0,0.0
Congenital vertical talus,27963,8,6,19,3,16,31,0,31,0.5,0.0,0.15789473684210525,0.5,0.0,0.0
"Dysplasia of head of femur, Meyer type",98019,4,0,8,0,8,22,0,22,0.0,0.0,0.0,0.0,0.0,0.0
Posttransplant acute limbic encephalitis,97999,18,0,25,0,25,24,0,24,0.0,0.0,0.0,0.0,0.0,0.0
Mal de Meleda,29337,1,6,15,0,15,11,0,11,0.0,0.0,0.0,0.0,0.0,0.0
Epidermolytic palmoplantar keratoderma,28842,4,2,12,1,11,7,1,6,0.5,0.5,0.08333333333333333,0.5,0.14285714285714285,0.5
Transgrediens et progrediens palmoplantar keratoderma,30262,8,1,18,0,18,18,1,17,0.0,1.0,0.0,0.0,0.05555555555555555,1.0
Congenital bile acid synthesis defect type 2,28517,8,3,31,1,30,25,0,25,0.3333333333333333,0.0,0.03225806451612903,0.3333333333333333,0.0,0.0
Congenital bile acid synthesis defect type 3,28517,7,0,36,0,36,26,0,26,0.0,0.0,0.0,0.0,0.0,0.0
Congenital bile acid synthesis defect type 4,28517,6,1,40,0,40,28,0,28,0.0,0.0,0.0,0.0,0.0,0.0
Maculopapular cutaneous mastocytosis,32209,5,2,22,0,22,25,0,25,0.0,0.0,0.0,0.0,0.0,0.0
CNTNAP2-related developmental and epileptic encephalopathy,30986,3,6,19,3,16,26,0,26,0.5,0.0,0.15789473684210525,0.5,0.0,0.0
Macrophage activation syndrome,95120,11,17,29,3,26,18,3,15,0.17647058823529413,0.17647058823529413,0.10344827586206896,0.17647058823529413,0.16666666666666666,0.17647058823529413
Acquired hemophagocytic lymphohistiocytosis associated with malignant disease,97990,21,10,27,2,25,28,3,25,0.2,0.3,0.07407407407407407,0.2,0.10714285714285714,0.3
Subacute inflammatory demyelinating polyneuropathy,27761,2,5,24,2,22,23,1,22,0.4,0.2,0.08333333333333333,0.4,0.043478260869565216,0.2
Idiopathic copper-associated cirrhosis,98077,10,2,20,0,20,24,0,24,0.0,0.0,0.0,0.0,0.0,0.0
Phacoanaphylactic uveitis,98078,12,3,18,1,17,18,2,16,0.3333333333333333,0.6666666666666666,0.05555555555555555,0.3333333333333333,0.1111111111111111,0.6666666666666666
Solitary rectal ulcer syndrome,98079,10,1,13,0,13,23,0,23,0.0,0.0,0.0,0.0,0.0,0.0
Isolated nail clubbing,30545,10,1,28,0,28,21,0,21,0.0,0.0,0.0,0.0,0.0,0.0
NMDA receptor encephalitis,98931,14,8,26,1,25,28,1,27,0.125,0.125,0.038461538461538464,0.125,0.03571428571428571,0.125
Posterior-predominant lissencephaly-broad flat pons and medulla-midline crossing defects syndrome,33583,3,7,17,2,15,37,3,34,0.2857142857142857,0.42857142857142855,0.11764705882352941,0.2857142857142857,0.08108108108108109,0.42857142857142855
Camptodactyly-arthropathy-coxa-vara-pericarditis syndrome,31821,11,9,24,2,22,34,2,32,0.2222222222222222,0.2222222222222222,0.08333333333333333,0.2222222222222222,0.058823529411764705,0.2222222222222222
Symptomatic form of muscular dystrophy of Duchenne and Becker in female carriers,84273,11,0,25,0,25,19,0,19,0.0,0.0,0.0,0.0,0.0,0.0
Overlap myositis,94778,14,0,19,0,19,25,0,25,0.0,0.0,0.0,0.0,0.0,0.0
KID syndrome,35643,0,1,25,0,25,30,0,30,0.0,0.0,0.0,0.0,0.0,0.0
Hidrotic ectodermal dysplasia,32947,0,0,17,0,17,46,0,46,0.0,0.0,0.0,0.0,0.0,0.0
Autosomal dominant palmoplantar keratoderma and congenital alopecia,29558,2,6,22,3,19,23,2,21,0.5,0.3333333333333333,0.13636363636363635,0.5,0.08695652173913043,0.3333333333333333
Naegeli-Franceschetti-Jadassohn syndrome,29125,2,2,18,1,17,36,0,36,0.5,0.0,0.05555555555555555,0.5,0.0,0.0
Keratoderma hereditarium mutilans with ichthyosis,27163,2,3,22,0,22,29,1,28,0.0,0.3333333333333333,0.0,0.0,0.034482758620689655,0.3333333333333333
Isolated asymptomatic elevation of creatine phosphokinase,30176,10,1,16,0,16,21,0,21,0.0,0.0,0.0,0.0,0.0,0.0
Hereditary persistence of fetal hemoglobin-sickle cell disease syndrome,98170,3,1,23,0,23,20,1,19,0.0,1.0,0.0,0.0,0.05,1.0
1p31p32 microdeletion syndrome,30367,2,3,19,3,16,31,0,31,1.0,0.0,0.15789473684210525,1.0,0.0,0.0
Leukoencephalopathy with calcifications and cysts,31550,4,3,16,2,14,28,1,27,0.6666666666666666,0.3333333333333333,0.125,0.6666666666666666,0.03571428571428571,0.3333333333333333
Tubulinopathy-associated dysgyria,98588,7,9,27,0,27,22,0,22,0.0,0.0,0.0,0.0,0.0,0.0
Lissencephaly due to TUBA1A mutation,31140,1,3,16,1,15,23,0,23,0.3333333333333333,0.0,0.0625,0.3333333333333333,0.0,0.0
Pontocerebellar hypoplasia type 1,27716,4,9,32,3,29,30,3,27,0.3333333333333333,0.3333333333333333,0.09375,0.3333333333333333,0.1,0.3333333333333333
Alexander disease type II,31783,1,2,17,0,17,11,0,11,0.0,0.0,0.0,0.0,0.0,0.0
Alexander disease type I,31783,1,2,54,0,54,9,0,9,0.0,0.0,0.0,0.0,0.0,0.0
PRUNE1-related neurological syndrome,99981,15,7,22,0,22,25,0,25,0.0,0.0,0.0,0.0,0.0,0.0
Familial atrial fibrillation,27948,1,0,18,0,18,24,0,24,0.0,0.0,0.0,0.0,0.0,0.0
Trichomegaly-retina pigmentary degeneration-dwarfism syndrome,29500,1,1,16,1,15,42,0,42,1.0,0.0,0.0625,1.0,0.0,0.0
FLNA-related X-linked myxomatous valvular dysplasia,30691,1,3,15,2,13,22,1,21,0.6666666666666666,0.3333333333333333,0.13333333333333333,0.6666666666666666,0.045454545454545456,0.3333333333333333
Terminal osseous dysplasia-pigmentary defects syndrome,28996,2,2,18,0,18,31,0,31,0.0,0.0,0.0,0.0,0.0,0.0
Systemic lupus erythematosus,29182,6,7,16,1,15,25,2,23,0.14285714285714285,0.2857142857142857,0.0625,0.14285714285714285,0.08,0.2857142857142857
Congenital limbs-face contractures-hypotonia-developmental delay syndrome,31553,0,3,20,2,18,24,1,23,0.6666666666666666,0.3333333333333333,0.1,0.6666666666666666,0.041666666666666664,0.3333333333333333
Autoimmune lymphoproliferative syndrome due to CTLA4 haploinsuffiency,30768,7,1,17,1,16,37,0,37,1.0,0.0,0.058823529411764705,1.0,0.0,0.0
Toriello-Carey syndrome,30886,0,7,17,3,14,4,0,4,0.42857142857142855,0.0,0.17647058823529413,0.42857142857142855,0.0,0.0
"Renal hypoplasia, bilateral",94999,7,1,23,1,22,14,2,12,1.0,2.0,0.043478260869565216,1.0,0.14285714285714285,2.0
Split-foot malformation-mesoaxial polydactyly syndrome,31005,10,2,20,0,20,16,1,15,0.0,0.5,0.0,0.0,0.0625,0.5
Congenital-onset Steinert myotonic dystrophy,27540,7,4,30,0,30,38,0,38,0.0,0.0,0.0,0.0,0.0,0.0
Phakomatosis pigmentokeratotica,32602,2,2,21,0,21,31,0,31,0.0,0.0,0.0,0.0,0.0,0.0
Pilomatrixoma,30972,6,3,21,0,21,23,0,23,0.0,0.0,0.0,0.0,0.0,0.0
Autosomal recessive myogenic arthrogryposis multiplex congenita,99893,21,9,26,0,26,26,0,26,0.0,0.0,0.0,0.0,0.0,0.0
Woolly hair nevus,94935,10,4,20,0,20,25,0,25,0.0,0.0,0.0,0.0,0.0,0.0
Muscle filaminopathy,27707,1,3,16,1,15,19,0,19,0.3333333333333333,0.0,0.0625,0.3333333333333333,0.0,0.0
7q31 microdeletion syndrome,98160,15,0,30,0,30,28,0,28,0.0,0.0,0.0,0.0,0.0,0.0
Hypertrophic cardiomyopathy with kidney anomalies due to mitochondrial DNA mutation,98414,17,0,25,0,25,26,0,26,0.0,0.0,0.0,0.0,0.0,0.0
14q11.2 microduplication syndrome,98193,19,2,26,1,25,23,1,22,0.5,0.5,0.038461538461538464,0.5,0.043478260869565216,0.5
Double outlet left ventricle,33375,4,4,23,0,23,26,0,26,0.0,0.0,0.0,0.0,0.0,0.0
Self-limited neonatal-infantile epilepsy,33100,0,0,16,0,16,25,0,25,0.0,0.0,0.0,0.0,0.0,0.0
Progressive microcephaly-seizures-cortical blindness-developmental delay syndrome,31022,8,5,21,2,19,27,0,27,0.4,0.0,0.09523809523809523,0.4,0.0,0.0
DIAPH1-related sensorineural hearing loss-thrombocytopenia syndrome,99884,14,3,19,1,18,34,1,33,0.3333333333333333,0.3333333333333333,0.05263157894736842,0.3333333333333333,0.029411764705882353,0.3333333333333333
CADDS,94691,23,2,30,0,30,28,0,28,0.0,0.0,0.0,0.0,0.0,0.0
Severe neonatal-onset encephalopathy with microcephaly,32106,3,4,18,1,17,29,1,28,0.25,0.25,0.05555555555555555,0.25,0.034482758620689655,0.25
STXBP1-related encephalopathy,38791,9,0,21,0,21,21,0,21,0.0,0.0,0.0,0.0,0.0,0.0
Spinocerebellar ataxia with epilepsy,39061,4,0,5,0,5,25,0,25,0.0,0.0,0.0,0.0,0.0,0.0
Macrocephaly-intellectual disability-autism syndrome,30203,4,2,21,2,19,24,1,23,1.0,0.5,0.09523809523809523,1.0,0.041666666666666664,0.5
Activated PI3K-delta syndrome,39078,16,2,26,1,25,38,1,37,0.5,0.5,0.038461538461538464,0.5,0.02631578947368421,0.5
