disease,rag_top_node_id,common_symptoms,total_symptoms,rag_total_symptoms,rag_matches,rag_hallucinations,no_rag_total_symptoms,no_rag_matches,no_rag_hallucinations,rag_accuracy,no_rag_accuracy,rag_precision,rag_recall,no_rag_precision,no_rag_recall
Alexander disease,31783,1,61,54,46,8,15,2,13,0.7540983606557377,0.03278688524590164,0.8518518518518519,0.7540983606557377,0.13333333333333333,0.03278688524590164
Alpha-mannosidosis,99138,21,42,41,1,40,28,2,26,0.023809523809523808,0.047619047619047616,0.024390243902439025,0.023809523809523808,0.07142857142857142,0.047619047619047616
Aspartylglucosaminuria,31742,0,43,17,10,7,24,1,23,0.23255813953488372,0.023255813953488372,0.5882352941176471,0.23255813953488372,0.041666666666666664,0.023255813953488372
Multiple sulfatase deficiency,29444,2,30,16,11,5,22,2,20,0.36666666666666664,0.06666666666666667,0.6875,0.36666666666666664,0.09090909090909091,0.06666666666666667
Beta-mannosidosis,99138,13,6,23,0,23,32,0,32,0.0,0.0,0.0,0.0,0.0,0.0
Canavan disease,30772,3,18,18,11,7,27,5,22,0.6111111111111112,0.2777777777777778,0.6111111111111112,0.6111111111111112,0.18518518518518517,0.2777777777777778
Fucosidosis,27474,1,31,26,19,7,25,1,24,0.6129032258064516,0.03225806451612903,0.7307692307692307,0.6129032258064516,0.04,0.03225806451612903
Glycogen storage disease due to glycogen debranching enzyme deficiency,38668,17,7,27,2,25,24,2,22,0.2857142857142857,0.2857142857142857,0.07407407407407407,0.2857142857142857,0.08333333333333333,0.2857142857142857
Krabbe disease,33153,2,50,41,15,26,29,8,21,0.3,0.16,0.36585365853658536,0.3,0.27586206896551724,0.16
Glycogen storage disease due to muscle phosphofructokinase deficiency,27292,4,6,18,1,17,26,1,25,0.16666666666666666,0.16666666666666666,0.05555555555555555,0.16666666666666666,0.038461538461538464,0.16666666666666666
Mucopolysaccharidosis type 6,27436,10,27,22,6,16,26,5,21,0.2222222222222222,0.18518518518518517,0.2727272727272727,0.2222222222222222,0.19230769230769232,0.18518518518518517
Sialidosis type 1,33195,0,42,33,13,20,2,0,2,0.30952380952380953,0.0,0.3939393939393939,0.30952380952380953,0.0,0.0
Mucolipidosis type IV,27333,0,27,18,3,15,20,1,19,0.1111111111111111,0.037037037037037035,0.16666666666666666,0.1111111111111111,0.05,0.037037037037037035
Mucolipidosis type III,27333,0,36,18,8,10,19,1,18,0.2222222222222222,0.027777777777777776,0.4444444444444444,0.2222222222222222,0.05263157894736842,0.027777777777777776
Mucopolysaccharidosis type 7,27436,9,26,18,3,15,24,3,21,0.11538461538461539,0.11538461538461539,0.16666666666666666,0.11538461538461539,0.125,0.11538461538461539
Recessive X-linked ichthyosis,29420,2,12,18,5,13,23,4,19,0.4166666666666667,0.3333333333333333,0.2777777777777778,0.4166666666666667,0.17391304347826086,0.3333333333333333
Turner syndrome,32829,6,115,33,28,5,29,10,19,0.24347826086956523,0.08695652173913043,0.8484848484848485,0.24347826086956523,0.3448275862068966,0.08695652173913043
Beta-thalassemia,33434,1,21,23,12,11,25,2,23,0.5714285714285714,0.09523809523809523,0.5217391304347826,0.5714285714285714,0.08,0.09523809523809523
Cystic fibrosis,28714,5,35,26,10,16,21,8,13,0.2857142857142857,0.22857142857142856,0.38461538461538464,0.2857142857142857,0.38095238095238093,0.22857142857142856
Alpha-thalassemia,31842,5,23,22,10,12,31,4,27,0.43478260869565216,0.17391304347826086,0.45454545454545453,0.43478260869565216,0.12903225806451613,0.17391304347826086
Facioscapulohumeral dystrophy,31356,10,37,21,4,17,18,2,16,0.10810810810810811,0.05405405405405406,0.19047619047619047,0.10810810810810811,0.1111111111111111,0.05405405405405406
Emery-Dreifuss muscular dystrophy,27674,1,44,20,16,4,21,2,19,0.36363636363636365,0.045454545454545456,0.8,0.36363636363636365,0.09523809523809523,0.045454545454545456
Kearns-Sayre syndrome,28773,3,30,17,13,4,19,6,13,0.43333333333333335,0.2,0.7647058823529411,0.43333333333333335,0.3157894736842105,0.2
Thomsen and Becker disease,27944,0,15,17,0,17,21,3,18,0.0,0.2,0.0,0.0,0.14285714285714285,0.2
MERRF,29913,3,11,16,10,6,25,2,23,0.9090909090909091,0.18181818181818182,0.625,0.9090909090909091,0.08,0.18181818181818182
Central core disease,27799,3,25,24,19,5,21,3,18,0.76,0.12,0.7916666666666666,0.76,0.14285714285714285,0.12
Marfan syndrome,38220,21,68,27,12,15,24,9,15,0.17647058823529413,0.1323529411764706,0.4444444444444444,0.17647058823529413,0.375,0.1323529411764706
Ataxia-telangiectasia,30665,2,37,19,5,14,29,5,24,0.13513513513513514,0.13513513513513514,0.2631578947368421,0.13513513513513514,0.1724137931034483,0.13513513513513514
Down syndrome,32076,3,72,51,38,13,23,6,17,0.5277777777777778,0.08333333333333333,0.7450980392156863,0.5277777777777778,0.2608695652173913,0.08333333333333333
CHARGE syndrome,31003,3,94,92,69,23,34,9,25,0.7340425531914894,0.09574468085106383,0.75,0.7340425531914894,0.2647058823529412,0.09574468085106383
Oculocerebrorenal syndrome of Lowe,29016,0,120,24,3,21,32,4,28,0.025,0.03333333333333333,0.125,0.025,0.125,0.03333333333333333
Retinoblastoma,31883,2,27,21,18,3,25,3,22,0.6666666666666666,0.1111111111111111,0.8571428571428571,0.6666666666666666,0.12,0.1111111111111111
Fragile X syndrome,27967,5,33,23,17,6,27,6,21,0.5151515151515151,0.18181818181818182,0.7391304347826086,0.5151515151515151,0.2222222222222222,0.18181818181818182
Mucopolysaccharidosis type 1,27436,9,57,19,6,13,22,4,18,0.10526315789473684,0.07017543859649122,0.3157894736842105,0.10526315789473684,0.18181818181818182,0.07017543859649122
Williams syndrome,30529,3,187,189,146,43,30,7,23,0.7807486631016043,0.0374331550802139,0.7724867724867724,0.7807486631016043,0.23333333333333334,0.0374331550802139
Wolf-Hirschhorn syndrome,32102,5,95,115,76,39,32,9,23,0.8,0.09473684210526316,0.6608695652173913,0.8,0.28125,0.09473684210526316
Ataxia with vitamin E deficiency,28900,4,37,17,18,-1,16,10,6,0.4864864864864865,0.2702702702702703,1.0588235294117647,0.4864864864864865,0.625,0.2702702702702703
Rheumatic fever,32807,4,36,20,18,2,18,7,11,0.5,0.19444444444444445,0.9,0.5,0.3888888888888889,0.19444444444444445
X-linked agammaglobulinemia,38989,12,35,12,0,12,14,0,14,0.0,0.0,0.0,0.0,0.0,0.0
Wiskott-Aldrich syndrome,27973,3,57,22,9,13,26,6,20,0.15789473684210525,0.10526315789473684,0.4090909090909091,0.15789473684210525,0.23076923076923078,0.10526315789473684
Hypophosphatasia,29033,1,20,36,11,25,32,2,30,0.55,0.1,0.3055555555555556,0.55,0.0625,0.1
Hydrocephalus with stenosis of the aqueduct of Sylvius,94969,17,15,29,2,27,27,1,26,0.13333333333333333,0.06666666666666667,0.06896551724137931,0.13333333333333333,0.037037037037037035,0.06666666666666667
Ornithine transcarbamylase deficiency,31982,2,29,16,10,6,29,4,25,0.3448275862068966,0.13793103448275862,0.625,0.3448275862068966,0.13793103448275862,0.13793103448275862
Kennedy disease,28888,4,13,19,10,9,28,2,26,0.7692307692307693,0.15384615384615385,0.5263157894736842,0.7692307692307693,0.07142857142857142,0.15384615384615385
X-linked retinoschisis,30609,0,16,17,10,7,27,3,24,0.625,0.1875,0.5882352941176471,0.625,0.1111111111111111,0.1875
Hypochondroplasia,98702,14,20,42,2,40,32,2,30,0.1,0.1,0.047619047619047616,0.1,0.0625,0.1
X-linked hypohidrotic ectodermal dysplasia,29412,0,14,31,8,23,32,1,31,0.5714285714285714,0.07142857142857142,0.25806451612903225,0.5714285714285714,0.03125,0.07142857142857142
Blue cone monochromatism,30200,5,12,17,9,8,14,4,10,0.75,0.3333333333333333,0.5294117647058824,0.75,0.2857142857142857,0.3333333333333333
Neurofibromatosis type 1,27275,0,77,17,15,2,31,11,20,0.19480519480519481,0.14285714285714285,0.8823529411764706,0.19480519480519481,0.3548387096774194,0.14285714285714285
Non-acquired isolated growth hormone deficiency,33166,13,19,19,6,13,20,4,16,0.3157894736842105,0.21052631578947367,0.3157894736842105,0.3157894736842105,0.2,0.21052631578947367
Chronic granulomatous disease,97606,10,22,26,2,24,32,5,27,0.09090909090909091,0.22727272727272727,0.07692307692307693,0.09090909090909091,0.15625,0.22727272727272727
Homocystinuria due to cystathionine beta-synthase deficiency,29289,0,62,21,14,7,25,4,21,0.22580645161290322,0.06451612903225806,0.6666666666666666,0.22580645161290322,0.16,0.06451612903225806
Lesch-Nyhan syndrome,30283,11,11,21,3,18,28,4,24,0.2727272727272727,0.36363636363636365,0.14285714285714285,0.2727272727272727,0.14285714285714285,0.36363636363636365
Cystinuria,96566,1,14,1,0,1,12,2,10,0.0,0.14285714285714285,0.0,0.0,0.16666666666666666,0.14285714285714285
Monosomy 5p syndrome,33419,4,27,19,4,15,31,3,28,0.14814814814814814,0.1111111111111111,0.21052631578947367,0.14814814814814814,0.0967741935483871,0.1111111111111111
Hereditary neuropathy with liability to pressure palsies,31538,0,18,17,10,7,30,3,27,0.5555555555555556,0.16666666666666666,0.5882352941176471,0.5555555555555556,0.1,0.16666666666666666
Norrie disease,32083,1,64,54,45,9,20,2,18,0.703125,0.03125,0.8333333333333334,0.703125,0.1,0.03125
Alpha-1-antitrypsin deficiency,30711,5,16,17,13,4,24,7,17,0.8125,0.4375,0.7647058823529411,0.8125,0.2916666666666667,0.4375
Hyperkalemic periodic paralysis,28042,10,29,26,13,13,21,3,18,0.4482758620689655,0.10344827586206896,0.5,0.4482758620689655,0.14285714285714285,0.10344827586206896
Schwartz-Jampel syndrome,31113,2,112,22,17,5,23,4,19,0.15178571428571427,0.03571428571428571,0.7727272727272727,0.15178571428571427,0.17391304347826086,0.03571428571428571
Diastrophic dysplasia,94720,14,64,38,4,34,33,2,31,0.0625,0.03125,0.10526315789473684,0.0625,0.06060606060606061,0.03125
Gorlin syndrome,28966,0,45,25,3,22,24,2,22,0.06666666666666667,0.044444444444444446,0.12,0.06666666666666667,0.08333333333333333,0.044444444444444446
"46,XY difference of sex development due to 17-beta-hydroxysteroid dehydrogenase 3 deficiency",30183,10,8,22,8,14,28,5,23,1.0,0.625,0.36363636363636365,1.0,0.17857142857142858,0.625
Fibrodysplasia ossificans progressiva,30328,1,35,28,22,6,29,2,27,0.6285714285714286,0.05714285714285714,0.7857142857142857,0.6285714285714286,0.06896551724137931,0.05714285714285714
Peutz-Jeghers syndrome,31798,4,33,24,18,6,21,6,15,0.5454545454545454,0.18181818181818182,0.75,0.5454545454545454,0.2857142857142857,0.18181818181818182
Zellweger syndrome,32874,0,55,17,16,1,17,0,17,0.2909090909090909,0.0,0.9411764705882353,0.2909090909090909,0.0,0.0
WAGR syndrome,30855,3,18,16,8,8,24,3,21,0.4444444444444444,0.16666666666666666,0.5,0.4444444444444444,0.125,0.16666666666666666
Waardenburg syndrome type 2,27569,5,12,27,4,23,37,7,30,0.3333333333333333,0.5833333333333334,0.14814814814814814,0.3333333333333333,0.1891891891891892,0.5833333333333334
Waardenburg syndrome type 3,27569,3,22,30,7,23,20,2,18,0.3181818181818182,0.09090909090909091,0.23333333333333334,0.3181818181818182,0.1,0.09090909090909091
Townes-Brocks syndrome,30460,1,66,17,13,4,27,3,24,0.19696969696969696,0.045454545454545456,0.7647058823529411,0.19696969696969696,0.1111111111111111,0.045454545454545456
Waardenburg syndrome type 1,27569,4,32,31,10,21,28,7,21,0.3125,0.21875,0.3225806451612903,0.3125,0.25,0.21875
Crouzon syndrome,31582,1,33,17,12,5,31,5,26,0.36363636363636365,0.15151515151515152,0.7058823529411765,0.36363636363636365,0.16129032258064516,0.15151515151515152
Cowden syndrome,28086,3,57,24,18,6,31,5,26,0.3157894736842105,0.08771929824561403,0.75,0.3157894736842105,0.16129032258064516,0.08771929824561403
Crigler-Najjar syndrome,27412,3,22,17,12,5,32,2,30,0.5454545454545454,0.09090909090909091,0.7058823529411765,0.5454545454545454,0.0625,0.09090909090909091
Coffin-Lowry syndrome,33213,2,81,16,11,5,30,8,22,0.13580246913580246,0.09876543209876543,0.6875,0.13580246913580246,0.26666666666666666,0.09876543209876543
Blepharophimosis-ptosis-epicanthus inversus syndrome,27485,2,9,17,6,11,25,6,19,0.6666666666666666,0.6666666666666666,0.35294117647058826,0.6666666666666666,0.24,0.6666666666666666
Hereditary hemorrhagic telangiectasia,28413,2,36,45,22,23,6,3,3,0.6111111111111112,0.08333333333333333,0.4888888888888889,0.6111111111111112,0.5,0.08333333333333333
Saethre-Chotzen syndrome,31475,0,61,18,17,1,21,4,17,0.2786885245901639,0.06557377049180328,0.9444444444444444,0.2786885245901639,0.19047619047619047,0.06557377049180328
Beckwith-Wiedemann syndrome,98136,13,85,31,9,22,26,7,19,0.10588235294117647,0.08235294117647059,0.2903225806451613,0.10588235294117647,0.2692307692307692,0.08235294117647059
Bartter syndrome,27629,2,2,18,2,16,21,0,21,1.0,0.0,0.1111111111111111,1.0,0.0,0.0
Albers-Schönberg osteopetrosis,27276,3,36,137,36,101,32,8,24,1.0,0.2222222222222222,0.26277372262773724,1.0,0.25,0.2222222222222222
Aicardi syndrome,30689,0,50,16,13,3,15,2,13,0.26,0.04,0.8125,0.26,0.13333333333333333,0.04
Alagille syndrome,98197,16,43,30,2,28,39,4,35,0.046511627906976744,0.09302325581395349,0.06666666666666667,0.046511627906976744,0.10256410256410256,0.09302325581395349
Abetalipoproteinemia,31820,0,63,3,3,0,22,5,17,0.047619047619047616,0.07936507936507936,1.0,0.047619047619047616,0.22727272727272727,0.07936507936507936
Cat-eye syndrome,28973,0,20,17,9,8,32,3,29,0.45,0.15,0.5294117647058824,0.45,0.09375,0.15
Ellis Van Creveld syndrome,32108,1,51,25,18,7,26,5,21,0.35294117647058826,0.09803921568627451,0.72,0.35294117647058826,0.19230769230769232,0.09803921568627451
Treacher-Collins syndrome,32816,2,68,20,19,1,17,7,10,0.27941176470588236,0.10294117647058823,0.95,0.27941176470588236,0.4117647058823529,0.10294117647058823
Cornelia de Lange syndrome,28431,7,100,156,85,71,39,9,30,0.85,0.09,0.5448717948717948,0.85,0.23076923076923078,0.09
Apert syndrome,30316,2,59,16,11,5,34,6,28,0.1864406779661017,0.1016949152542373,0.6875,0.1864406779661017,0.17647058823529413,0.1016949152542373
Lamellar ichthyosis,30696,6,21,14,6,8,22,5,17,0.2857142857142857,0.23809523809523808,0.42857142857142855,0.2857142857142857,0.22727272727272727,0.23809523809523808
Menkes disease,31425,0,55,17,4,13,27,4,23,0.07272727272727272,0.07272727272727272,0.23529411764705882,0.07272727272727272,0.14814814814814814,0.07272727272727272
"Microphthalmia, Lenz type",33303,1,42,17,14,3,30,6,24,0.3333333333333333,0.14285714285714285,0.8235294117647058,0.3333333333333333,0.2,0.14285714285714285
Meckel syndrome,28420,1,45,76,18,58,31,0,31,0.4,0.0,0.23684210526315788,0.4,0.0,0.0
Triose phosphate-isomerase deficiency,30684,3,7,17,6,11,23,1,22,0.8571428571428571,0.14285714285714285,0.35294117647058826,0.8571428571428571,0.043478260869565216,0.14285714285714285
Distal monosomy 7q36 syndrome,33264,2,30,17,16,1,25,5,20,0.5333333333333333,0.16666666666666666,0.9411764705882353,0.5333333333333333,0.2,0.16666666666666666
Distal deletion 9p syndrome,31535,9,27,66,18,48,44,7,37,0.6666666666666666,0.25925925925925924,0.2727272727272727,0.6666666666666666,0.1590909090909091,0.25925925925925924
Trisomy 13 syndrome,98753,6,59,19,4,15,27,4,23,0.06779661016949153,0.06779661016949153,0.21052631578947367,0.06779661016949153,0.14814814814814814,0.06779661016949153
Distal duplication 15q syndrome,38960,11,29,33,3,30,22,2,20,0.10344827586206896,0.06896551724137931,0.09090909090909091,0.10344827586206896,0.09090909090909091,0.06896551724137931
Trisomy 18 syndrome,28757,1,67,18,2,16,40,10,30,0.029850746268656716,0.14925373134328357,0.1111111111111111,0.029850746268656716,0.25,0.14925373134328357
Distal duplication 18q syndrome,32995,1,31,27,4,23,17,1,16,0.12903225806451613,0.03225806451612903,0.14814814814814814,0.12903225806451613,0.058823529411764705,0.03225806451612903
Albinism-deafness syndrome,31604,5,7,22,5,17,27,0,27,0.7142857142857143,0.0,0.22727272727272727,0.7142857142857143,0.0,0.0
Ermine phenotype,27408,2,16,20,13,7,33,1,32,0.8125,0.0625,0.65,0.8125,0.030303030303030304,0.0625
Ocular albinism with late-onset sensorineural deafness,29706,5,6,17,6,11,19,5,14,1.0,0.8333333333333334,0.35294117647058826,1.0,0.2631578947368421,0.8333333333333334
Bruck syndrome,27239,2,14,17,10,7,20,3,17,0.7142857142857143,0.21428571428571427,0.5882352941176471,0.7142857142857143,0.15,0.21428571428571427
Darier disease,31039,3,24,16,12,4,28,5,23,0.5,0.20833333333333334,0.75,0.5,0.17857142857142858,0.20833333333333334
"46,XY difference of sex development due to 5-alpha-reductase 2 deficiency",31923,4,10,17,9,8,36,3,33,0.9,0.3,0.5294117647058824,0.9,0.08333333333333333,0.3
Isolated complex I deficiency,30935,3,37,44,24,20,20,5,15,0.6486486486486487,0.13513513513513514,0.5454545454545454,0.6486486486486487,0.25,0.13513513513513514
Bethlem muscular dystrophy,30345,5,39,30,9,21,31,7,24,0.23076923076923078,0.1794871794871795,0.3,0.23076923076923078,0.22580645161290322,0.1794871794871795
Pentasomy X syndrome,32252,3,22,19,19,0,34,3,31,0.8636363636363636,0.13636363636363635,1.0,0.8636363636363636,0.08823529411764706,0.13636363636363635
Osteogenesis imperfecta-retinopathy-seizures-intellectual disability syndrome,32372,8,8,24,8,16,27,2,25,1.0,0.25,0.3333333333333333,1.0,0.07407407407407407,0.25
Congenital osteogenesis imperfecta-microcephaly-cataracts syndrome,28337,0,21,24,16,8,15,1,14,0.7619047619047619,0.047619047619047616,0.6666666666666666,0.7619047619047619,0.06666666666666667,0.047619047619047616
Large/giant congenital melanocytic nevus,94937,14,21,18,4,14,23,5,18,0.19047619047619047,0.23809523809523808,0.2222222222222222,0.19047619047619047,0.21739130434782608,0.23809523809523808
Trisomy 9p syndrome,32458,1,27,17,16,1,41,3,38,0.5925925925925926,0.1111111111111111,0.9411764705882353,0.5925925925925926,0.07317073170731707,0.1111111111111111
22q11.2 duplication syndrome,30607,4,40,19,8,11,33,4,29,0.2,0.1,0.42105263157894735,0.2,0.12121212121212122,0.1
Tetrasomy 18p syndrome,39347,16,18,27,3,24,32,2,30,0.16666666666666666,0.1111111111111111,0.1111111111111111,0.16666666666666666,0.0625,0.1111111111111111
Incontinentia pigmenti,31045,7,67,37,20,17,33,9,24,0.29850746268656714,0.13432835820895522,0.5405405405405406,0.29850746268656714,0.2727272727272727,0.13432835820895522
Hereditary orotic aciduria,31298,0,16,22,14,8,20,0,20,0.875,0.0,0.6363636363636364,0.875,0.0,0.0
Acrocallosal syndrome,28425,0,18,68,13,55,12,0,12,0.7222222222222222,0.0,0.19117647058823528,0.7222222222222222,0.0,0.0
Succinic semialdehyde dehydrogenase deficiency,28588,1,9,18,7,11,30,1,29,0.7777777777777778,0.1111111111111111,0.3888888888888889,0.7777777777777778,0.03333333333333333,0.1111111111111111
Mevalonic aciduria,31768,0,17,18,7,11,24,0,24,0.4117647058823529,0.0,0.3888888888888889,0.4117647058823529,0.0,0.0
Neonatal adrenoleukodystrophy,32341,1,29,17,17,0,31,2,29,0.5862068965517241,0.06896551724137931,1.0,0.5862068965517241,0.06451612903225806,0.06896551724137931
Alkaptonuria,30238,1,49,16,13,3,21,7,14,0.2653061224489796,0.14285714285714285,0.8125,0.2653061224489796,0.3333333333333333,0.14285714285714285
Nager syndrome,27252,1,29,18,9,9,20,2,18,0.3103448275862069,0.06896551724137931,0.5,0.3103448275862069,0.1,0.06896551724137931
Smith-Magenis syndrome,27606,2,94,24,14,10,30,8,22,0.14893617021276595,0.0851063829787234,0.5833333333333334,0.14893617021276595,0.26666666666666666,0.0851063829787234
Tetrasomy X syndrome,32515,1,17,18,9,9,40,2,38,0.5294117647058824,0.11764705882352941,0.5,0.5294117647058824,0.05,0.11764705882352941
Refsum disease,31275,1,38,20,16,4,27,3,24,0.42105263157894735,0.07894736842105263,0.8,0.42105263157894735,0.1111111111111111,0.07894736842105263
Retinitis pigmentosa-intellectual disability-deafness-hypogonadism syndrome,28195,4,27,28,20,8,42,7,35,0.7407407407407407,0.25925925925925924,0.7142857142857143,0.7407407407407407,0.16666666666666666,0.25925925925925924
Isovaleric acidemia,28466,5,29,18,7,11,28,5,23,0.2413793103448276,0.1724137931034483,0.3888888888888889,0.2413793103448276,0.17857142857142858,0.1724137931034483
Aarskog-Scott syndrome,27534,4,49,65,41,24,32,8,24,0.8367346938775511,0.16326530612244897,0.6307692307692307,0.8367346938775511,0.25,0.16326530612244897
Chronic mucocutaneous candidiasis,29252,1,31,39,3,36,5,1,4,0.0967741935483871,0.03225806451612903,0.07692307692307693,0.0967741935483871,0.2,0.03225806451612903
Caffey disease,27926,1,14,17,10,7,28,1,27,0.7142857142857143,0.07142857142857142,0.5882352941176471,0.7142857142857143,0.03571428571428571,0.07142857142857142
Arthrogryposis-oculomotor limitation-electroretinal anomalies syndrome,27633,3,17,21,9,12,22,3,19,0.5294117647058824,0.17647058823529413,0.42857142857142855,0.5294117647058824,0.13636363636363635,0.17647058823529413
Sheldon-Hall syndrome,33218,0,20,17,16,1,20,0,20,0.8,0.0,0.9411764705882353,0.8,0.0,0.0
Argininemia,29832,0,10,16,6,10,4,0,4,0.6,0.0,0.375,0.6,0.0,0.0
Distal arthrogryposis type 1,99362,15,9,29,1,28,32,2,30,0.1111111111111111,0.2222222222222222,0.034482758620689655,0.1111111111111111,0.0625,0.2222222222222222
Alopecia antibody deficiency,33040,2,11,20,11,9,17,0,17,1.0,0.0,0.55,1.0,0.0,0.0
Aniridia-cerebellar ataxia-intellectual disability syndrome,28593,3,11,17,9,8,21,5,16,0.8181818181818182,0.45454545454545453,0.5294117647058824,0.8181818181818182,0.23809523809523808,0.45454545454545453
Blue rubber bleb nevus,97476,8,13,16,1,15,34,3,31,0.07692307692307693,0.23076923076923078,0.0625,0.07692307692307693,0.08823529411764706,0.23076923076923078
Isolated Dandy-Walker malformation,38226,11,20,24,3,21,31,4,27,0.15,0.2,0.125,0.15,0.12903225806451613,0.2
Dihydropteridine reductase deficiency,28246,0,4,18,3,15,28,0,28,0.75,0.0,0.16666666666666666,0.75,0.0,0.0
Argininosuccinic aciduria,30829,2,51,17,12,5,31,8,23,0.23529411764705882,0.1568627450980392,0.7058823529411765,0.23529411764705882,0.25806451612903225,0.1568627450980392
Carbamoyl-phosphate synthetase 1 deficiency,29186,2,7,18,6,12,25,1,24,0.8571428571428571,0.14285714285714285,0.3333333333333333,0.8571428571428571,0.04,0.14285714285714285
Corpus callosum agenesis-neuronopathy syndrome,31948,2,14,26,7,19,31,2,29,0.5,0.14285714285714285,0.2692307692307692,0.5,0.06451612903225806,0.14285714285714285
Craniosynostosis-Dandy-Walker malformation-hydrocephalus syndrome,31726,6,11,17,11,6,33,4,29,1.0,0.36363636363636365,0.6470588235294118,1.0,0.12121212121212122,0.36363636363636365
Cutis marmorata telangiectatica congenita,30815,1,32,24,18,6,13,2,11,0.5625,0.0625,0.75,0.5625,0.15384615384615385,0.0625
Cohen syndrome,30788,2,64,18,3,15,8,3,5,0.046875,0.046875,0.16666666666666666,0.046875,0.375,0.046875
Cooper-Jabs syndrome,30472,0,26,17,13,4,16,1,15,0.5,0.038461538461538464,0.7647058823529411,0.5,0.0625,0.038461538461538464
Congenital cataract-hypertrophic cardiomyopathy-mitochondrial myopathy syndrome,29649,4,10,17,5,12,27,2,25,0.5,0.2,0.29411764705882354,0.5,0.07407407407407407,0.2
Charlie M syndrome,32176,0,16,17,11,6,21,0,21,0.6875,0.0,0.6470588235294118,0.6875,0.0,0.0
Cholestasis-lymphedema syndrome,28982,5,20,20,17,3,29,7,22,0.85,0.35,0.85,0.85,0.2413793103448276,0.35
Cleidocranial dysplasia,28472,1,55,43,11,32,18,3,15,0.2,0.05454545454545454,0.2558139534883721,0.2,0.16666666666666666,0.05454545454545454
Fetal alcohol syndrome,33152,4,32,17,16,1,30,7,23,0.5,0.21875,0.9411764705882353,0.5,0.23333333333333334,0.21875
Isolated ectopia lentis,29210,10,11,17,2,15,22,2,20,0.18181818181818182,0.18181818181818182,0.11764705882352941,0.18181818181818182,0.09090909090909091,0.18181818181818182
Ebstein malformation of the tricuspid valve,28145,2,27,17,13,4,27,9,18,0.48148148148148145,0.3333333333333333,0.7647058823529411,0.48148148148148145,0.3333333333333333,0.3333333333333333
Dyskeratosis congenita,28228,3,62,18,10,8,32,6,26,0.16129032258064516,0.0967741935483871,0.5555555555555556,0.16129032258064516,0.1875,0.0967741935483871
XY type gonadal dysgenesis-associated anomalies syndrome,28132,4,26,19,13,6,21,3,18,0.5,0.11538461538461539,0.6842105263157895,0.5,0.14285714285714285,0.11538461538461539
Familial dysautonomia,28693,5,37,19,3,16,35,7,28,0.08108108108108109,0.1891891891891892,0.15789473684210525,0.08108108108108109,0.2,0.1891891891891892
Dubowitz syndrome,29628,0,102,19,19,0,11,1,10,0.18627450980392157,0.00980392156862745,1.0,0.18627450980392157,0.09090909090909091,0.00980392156862745
Diencephalic syndrome,33396,0,14,17,12,5,34,2,32,0.8571428571428571,0.14285714285714285,0.7058823529411765,0.8571428571428571,0.058823529411764705,0.14285714285714285
Encephalopathy due to sulfite oxidase deficiency,33016,1,21,17,17,0,22,3,19,0.8095238095238095,0.14285714285714285,1.0,0.8095238095238095,0.13636363636363635,0.14285714285714285
Pyruvate dehydrogenase deficiency,31168,5,35,31,7,24,24,1,23,0.2,0.02857142857142857,0.22580645161290322,0.2,0.041666666666666664,0.02857142857142857
Isolated glycerol kinase deficiency,33481,5,17,17,13,4,19,4,15,0.7647058823529411,0.23529411764705882,0.7647058823529411,0.7647058823529411,0.21052631578947367,0.23529411764705882
Congenital diaphragmatic hernia,30076,12,8,28,1,27,34,1,33,0.125,0.125,0.03571428571428571,0.125,0.029411764705882353,0.125
Congenital hydrocephalus,28443,0,21,15,0,15,29,1,28,0.0,0.047619047619047616,0.0,0.0,0.034482758620689655,0.047619047619047616
Neonatal hemochromatosis,30776,2,11,26,10,16,26,1,25,0.9090909090909091,0.09090909090909091,0.38461538461538464,0.9090909090909091,0.038461538461538464,0.09090909090909091
Cutaneous mastocytosis-deafness-microtia syndrome,31577,7,52,26,5,21,28,11,17,0.09615384615384616,0.21153846153846154,0.19230769230769232,0.09615384615384616,0.39285714285714285,0.21153846153846154
Hartnup disease,31907,0,30,15,12,3,6,0,6,0.4,0.0,0.8,0.4,0.0,0.0
Hawkinsinuria,30083,0,9,13,8,5,33,0,33,0.8888888888888888,0.0,0.6153846153846154,0.8888888888888888,0.0,0.0
Galactosialidosis,28079,2,9,16,11,5,28,2,26,1.2222222222222223,0.2222222222222222,0.6875,1.2222222222222223,0.07142857142857142,0.2222222222222222
Congenital fiber-type disproportion myopathy,31446,0,59,39,22,17,17,0,17,0.3728813559322034,0.0,0.5641025641025641,0.3728813559322034,0.0,0.0
Freeman-Sheldon syndrome,30510,0,31,22,7,15,18,2,16,0.22580645161290322,0.06451612903225806,0.3181818181818182,0.22580645161290322,0.1111111111111111,0.06451612903225806
"Mitochondrial DNA depletion syndrome, encephalomyopathic form with methylmalonic aciduria",29645,6,23,41,16,25,32,6,26,0.6956521739130435,0.2608695652173913,0.3902439024390244,0.6956521739130435,0.1875,0.2608695652173913
Fetal parvovirus syndrome,32419,4,9,23,9,14,26,2,24,1.0,0.2222222222222222,0.391304347826087,1.0,0.07692307692307693,0.2222222222222222
Frontal encephalocele,98223,13,11,17,2,15,21,2,19,0.18181818181818182,0.18181818181818182,0.11764705882352941,0.18181818181818182,0.09523809523809523,0.18181818181818182
Congenital pulmonary airway malformation,33235,11,5,22,3,19,25,1,24,0.6,0.2,0.13636363636363635,0.6,0.04,0.2
Congenital macroglossia,28733,8,4,23,4,19,22,1,21,1.0,0.25,0.17391304347826086,1.0,0.045454545454545456,0.25
Moebius syndrome,32744,2,42,16,5,11,16,2,14,0.11904761904761904,0.047619047619047616,0.3125,0.11904761904761904,0.125,0.047619047619047616
MASA syndrome,28587,0,13,22,13,9,36,0,36,1.0,0.0,0.5909090909090909,1.0,0.0,0.0
Marshall syndrome,32039,1,42,18,11,7,24,1,23,0.2619047619047619,0.023809523809523808,0.6111111111111112,0.2619047619047619,0.041666666666666664,0.023809523809523808
Neuroblastoma,37927,17,34,21,8,13,22,8,14,0.23529411764705882,0.23529411764705882,0.38095238095238093,0.23529411764705882,0.36363636363636365,0.23529411764705882
Thanatophoric dysplasia,30963,7,41,26,4,22,30,3,27,0.0975609756097561,0.07317073170731707,0.15384615384615385,0.0975609756097561,0.1,0.07317073170731707
Metatropic dysplasia,33376,0,26,18,3,15,30,0,30,0.11538461538461539,0.0,0.16666666666666666,0.11538461538461539,0.0,0.0
Proximal myotonic myopathy,31717,0,30,14,0,14,18,2,16,0.0,0.06666666666666667,0.0,0.0,0.1111111111111111,0.06666666666666667
Opsismodysplasia,29407,2,27,43,25,18,40,2,38,0.9259259259259259,0.07407407407407407,0.5813953488372093,0.9259259259259259,0.05,0.07407407407407407
Horizontal gaze palsy with progressive scoliosis,32396,7,16,21,7,14,31,6,25,0.4375,0.375,0.3333333333333333,0.4375,0.1935483870967742,0.375
Omphalocele,31866,6,5,18,0,18,20,0,20,0.0,0.0,0.0,0.0,0.0,0.0
Linear nevus sebaceus syndrome,28650,0,31,32,18,14,8,0,8,0.5806451612903226,0.0,0.5625,0.5806451612903226,0.0,0.0
Multiple intestinal atresia,27914,8,3,16,1,15,26,0,26,0.3333333333333333,0.0,0.0625,0.3333333333333333,0.0,0.0
Congenital short bowel syndrome,33057,8,7,16,6,10,31,0,31,0.8571428571428571,0.0,0.375,0.8571428571428571,0.0,0.0
Hypoplastic left heart syndrome,28836,4,8,20,7,13,20,0,20,0.875,0.0,0.35,0.875,0.0,0.0
Foveal hypoplasia-presenile cataract syndrome,33513,5,7,23,10,13,26,4,22,1.4285714285714286,0.5714285714285714,0.43478260869565216,1.4285714285714286,0.15384615384615385,0.5714285714285714
Jacobsen syndrome,31052,0,76,84,61,23,18,0,18,0.8026315789473685,0.0,0.7261904761904762,0.8026315789473685,0.0,0.0
Larsen-like osseous dysplasia-short stature syndrome,29567,4,21,38,15,23,38,4,34,0.7142857142857143,0.19047619047619047,0.39473684210526316,0.7142857142857143,0.10526315789473684,0.19047619047619047
Congenital laryngomalacia,31645,16,4,29,3,26,29,1,28,0.75,0.25,0.10344827586206896,0.75,0.034482758620689655,0.25
Trichorhinophalangeal syndrome type 2,27224,0,38,93,37,56,18,1,17,0.9736842105263158,0.02631578947368421,0.3978494623655914,0.9736842105263158,0.05555555555555555,0.02631578947368421
Congenital pulmonary lymphangiectasia,27545,5,16,16,11,5,28,5,23,0.6875,0.3125,0.6875,0.6875,0.17857142857142858,0.3125
Isolated congenital laryngeal web,31972,9,6,18,6,12,33,3,30,1.0,0.5,0.3333333333333333,1.0,0.09090909090909091,0.5
Laurence-Moon syndrome,29982,0,24,17,13,4,10,0,10,0.5416666666666666,0.0,0.7647058823529411,0.5416666666666666,0.0,0.0
Schizencephaly,30348,3,10,21,10,11,19,0,19,1.0,0.0,0.47619047619047616,1.0,0.0,0.0
Silver-Russell syndrome,32863,3,53,18,10,8,35,3,32,0.18867924528301888,0.05660377358490566,0.5555555555555556,0.18867924528301888,0.08571428571428572,0.05660377358490566
Multiple sclerosis-ichthyosis-factor VIII deficiency syndrome,32289,6,12,20,12,8,31,1,30,1.0,0.08333333333333333,0.6,1.0,0.03225806451612903,0.08333333333333333
Sjögren-Larsson syndrome,27310,0,28,17,15,2,39,2,37,0.5357142857142857,0.07142857142857142,0.8823529411764706,0.5357142857142857,0.05128205128205128,0.07142857142857142
Sirenomelia,32287,0,10,26,8,18,9,0,9,0.8,0.0,0.3076923076923077,0.8,0.0,0.0
Infantile spasms-broad thumbs syndrome,32276,0,15,22,13,9,49,1,48,0.8666666666666667,0.06666666666666667,0.5909090909090909,0.8666666666666667,0.02040816326530612,0.06666666666666667
Stormorken-Sjaastad-Langslet syndrome,31514,0,12,22,6,16,42,0,42,0.5,0.0,0.2727272727272727,0.5,0.0,0.0
Congenital toxoplasmosis,32823,5,26,16,16,0,21,8,13,0.6153846153846154,0.3076923076923077,1.0,0.6153846153846154,0.38095238095238093,0.3076923076923077
Thrombocytopenia-absent radius syndrome,27287,1,34,18,7,11,26,1,25,0.20588235294117646,0.029411764705882353,0.3888888888888889,0.20588235294117646,0.038461538461538464,0.029411764705882353
Tracheal agenesis,32543,5,5,23,6,17,26,2,24,1.2,0.4,0.2608695652173913,1.2,0.07692307692307693,0.4
VACTERL/VATER association,30889,3,41,47,28,19,22,4,18,0.6829268292682927,0.0975609756097561,0.5957446808510638,0.6829268292682927,0.18181818181818182,0.0975609756097561
Congenital varicella syndrome,32424,10,9,21,6,15,31,2,29,0.6666666666666666,0.2222222222222222,0.2857142857142857,0.6666666666666666,0.06451612903225806,0.2222222222222222
Juvenile Paget disease,31137,0,17,16,10,6,27,1,26,0.5882352941176471,0.058823529411764705,0.625,0.5882352941176471,0.037037037037037035,0.058823529411764705
Tetrasomy 12p syndrome,38887,12,29,21,2,19,27,2,25,0.06896551724137931,0.06896551724137931,0.09523809523809523,0.06896551724137931,0.07407407407407407,0.06896551724137931
Pendred syndrome,32139,2,15,17,13,4,43,4,39,0.8666666666666667,0.26666666666666666,0.7647058823529411,0.8666666666666667,0.09302325581395349,0.26666666666666666
Neuralgic amyotrophy,33286,4,24,17,13,4,16,1,15,0.5416666666666666,0.041666666666666664,0.7647058823529411,0.5416666666666666,0.0625,0.041666666666666664
Familial spontaneous pneumothorax,30499,15,3,23,3,20,20,0,20,1.0,0.0,0.13043478260869565,1.0,0.0,0.0
Proteus syndrome,29044,1,113,18,15,3,31,5,26,0.13274336283185842,0.04424778761061947,0.8333333333333334,0.13274336283185842,0.16129032258064516,0.04424778761061947
Prune belly syndrome,27929,0,34,30,22,8,22,2,20,0.6470588235294118,0.058823529411764705,0.7333333333333333,0.6470588235294118,0.09090909090909091,0.058823529411764705
Peroxisomal acyl-CoA oxidase deficiency,30385,2,29,20,13,7,22,2,20,0.4482758620689655,0.06896551724137931,0.65,0.4482758620689655,0.09090909090909091,0.06896551724137931
Difference of sex development-intellectual disability syndrome,31549,2,23,30,20,10,30,3,27,0.8695652173913043,0.13043478260869565,0.6666666666666666,0.8695652173913043,0.1,0.13043478260869565
Costello syndrome,29157,1,48,19,9,10,28,1,27,0.1875,0.020833333333333332,0.47368421052631576,0.1875,0.03571428571428571,0.020833333333333332
Congenital rubella syndrome,32425,2,31,17,15,2,23,7,16,0.4838709677419355,0.22580645161290322,0.8823529411764706,0.4838709677419355,0.30434782608695654,0.22580645161290322
Free sialic acid storage disease,29492,1,30,17,6,11,32,5,27,0.2,0.16666666666666666,0.35294117647058826,0.2,0.15625,0.16666666666666666
Osteogenesis imperfecta,27158,4,114,123,64,59,29,14,15,0.5614035087719298,0.12280701754385964,0.5203252032520326,0.5614035087719298,0.4827586206896552,0.12280701754385964
Mucopolysaccharidosis type 3,27436,10,106,21,8,13,22,6,16,0.07547169811320754,0.05660377358490566,0.38095238095238093,0.07547169811320754,0.2727272727272727,0.05660377358490566
Hirschsprung disease,27867,0,19,17,1,16,22,5,17,0.05263157894736842,0.2631578947368421,0.058823529411764705,0.05263157894736842,0.22727272727272727,0.2631578947368421
Glycogen storage disease due to glucose-6-phosphatase deficiency,27295,8,11,18,4,14,23,4,19,0.36363636363636365,0.36363636363636365,0.2222222222222222,0.36363636363636365,0.17391304347826086,0.36363636363636365
Gaucher disease,28772,3,93,38,30,8,28,9,19,0.3225806451612903,0.0967741935483871,0.7894736842105263,0.3225806451612903,0.32142857142857145,0.0967741935483871
GM1 gangliosidosis,27167,2,89,16,10,6,41,6,35,0.11235955056179775,0.06741573033707865,0.625,0.11235955056179775,0.14634146341463414,0.06741573033707865
Waardenburg syndrome,27569,4,32,24,6,18,24,6,18,0.1875,0.1875,0.25,0.1875,0.25,0.1875
Usher syndrome,27268,5,37,17,11,6,24,4,20,0.2972972972972973,0.10810810810810811,0.6470588235294118,0.2972972972972973,0.16666666666666666,0.10810810810810811
Retinitis pigmentosa,38253,11,31,19,8,11,27,7,20,0.25806451612903225,0.22580645161290322,0.42105263157894735,0.25806451612903225,0.25925925925925924,0.22580645161290322
Pelizaeus-Merzbacher disease,32148,12,32,28,8,20,23,8,15,0.25,0.25,0.2857142857142857,0.25,0.34782608695652173,0.25
X-linked recessive ocular albinism,30734,5,14,16,12,4,23,8,15,0.8571428571428571,0.5714285714285714,0.75,0.8571428571428571,0.34782608695652173,0.5714285714285714
Phenylketonuria,31918,3,23,20,4,16,38,2,36,0.17391304347826086,0.08695652173913043,0.2,0.17391304347826086,0.05263157894736842,0.08695652173913043
Chondrodysplasia-difference of sex development syndrome,38558,22,22,35,1,34,44,1,43,0.045454545454545456,0.045454545454545456,0.02857142857142857,0.045454545454545456,0.022727272727272728,0.045454545454545456
Weaver syndrome,28188,2,42,16,11,5,32,5,27,0.2619047619047619,0.11904761904761904,0.6875,0.2619047619047619,0.15625,0.11904761904761904
Fanconi anemia,32319,1,106,31,28,3,27,5,22,0.2641509433962264,0.04716981132075472,0.9032258064516129,0.2641509433962264,0.18518518518518517,0.04716981132075472
Familial isolated dilated cardiomyopathy,32609,10,13,29,5,24,19,4,15,0.38461538461538464,0.3076923076923077,0.1724137931034483,0.38461538461538464,0.21052631578947367,0.3076923076923077
Eosinophilic fasciitis,31808,3,16,16,14,2,27,3,24,0.875,0.1875,0.875,0.875,0.1111111111111111,0.1875
Granulomatosis with polyangiitis,32099,10,80,94,64,30,21,11,10,0.8,0.1375,0.6808510638297872,0.8,0.5238095238095238,0.1375
Immunoglobulin A vasculitis,32987,8,34,17,18,-1,33,14,19,0.5294117647058824,0.4117647058823529,1.0588235294117647,0.5294117647058824,0.42424242424242425,0.4117647058823529
Anti-glomerular basement membrane disease,38482,18,19,22,9,13,23,8,15,0.47368421052631576,0.42105263157894735,0.4090909090909091,0.47368421052631576,0.34782608695652173,0.42105263157894735
Microscopic polyangiitis,33208,3,55,17,18,-1,16,9,7,0.32727272727272727,0.16363636363636364,1.0588235294117647,0.32727272727272727,0.5625,0.16363636363636364
Locked-in syndrome,33246,3,16,19,15,4,36,3,33,0.9375,0.1875,0.7894736842105263,0.9375,0.08333333333333333,0.1875
Congenital herpes simplex virus infection,32426,10,4,26,3,23,30,0,30,0.75,0.0,0.11538461538461539,0.75,0.0,0.0
Congenital lobar emphysema,30057,9,13,20,6,14,20,4,16,0.46153846153846156,0.3076923076923077,0.3,0.46153846153846156,0.2,0.3076923076923077
Takayasu arteritis,32123,3,52,16,11,5,28,8,20,0.21153846153846154,0.15384615384615385,0.6875,0.21153846153846154,0.2857142857142857,0.15384615384615385
Dubin-Johnson syndrome,29712,7,11,24,13,11,22,5,17,1.1818181818181819,0.45454545454545453,0.5416666666666666,1.1818181818181819,0.22727272727272727,0.45454545454545453
Whipple disease,33359,5,47,17,16,1,29,10,19,0.3404255319148936,0.2127659574468085,0.9411764705882353,0.3404255319148936,0.3448275862068966,0.2127659574468085
Kawasaki disease,33038,5,46,21,21,0,30,10,20,0.45652173913043476,0.21739130434782608,1.0,0.45652173913043476,0.3333333333333333,0.21739130434782608
Congenital respiratory-biliary fistula,32507,15,2,22,2,20,27,0,27,1.0,0.0,0.09090909090909091,1.0,0.0,0.0
Congenital atransferrinemia,29483,5,6,20,6,14,28,1,27,1.0,0.16666666666666666,0.3,1.0,0.03571428571428571,0.16666666666666666
Multiminicore myopathy,27748,0,21,19,17,2,26,3,23,0.8095238095238095,0.14285714285714285,0.8947368421052632,0.8095238095238095,0.11538461538461539,0.14285714285714285
Polymyositis,32978,6,60,25,16,9,16,1,15,0.26666666666666666,0.016666666666666666,0.64,0.26666666666666666,0.0625,0.016666666666666666
Dermatomyositis,28745,2,75,19,12,7,12,8,4,0.16,0.10666666666666667,0.631578947368421,0.16,0.6666666666666666,0.10666666666666667
Behçet disease,30171,5,85,65,61,4,28,9,19,0.7176470588235294,0.10588235294117647,0.9384615384615385,0.7176470588235294,0.32142857142857145,0.10588235294117647
Oculopharyngeal muscular dystrophy,27548,1,24,23,9,14,3,2,1,0.375,0.08333333333333333,0.391304347826087,0.375,0.6666666666666666,0.08333333333333333
Alpha-N-acetylgalactosaminidase deficiency,28665,0,28,25,4,21,2,0,2,0.14285714285714285,0.0,0.16,0.14285714285714285,0.0,0.0
Inclusion body myositis,30448,4,14,16,12,4,22,1,21,0.8571428571428571,0.07142857142857142,0.75,0.8571428571428571,0.045454545454545456,0.07142857142857142
Larynx atresia,31647,9,6,21,5,16,27,2,25,0.8333333333333334,0.3333333333333333,0.23809523809523808,0.8333333333333334,0.07407407407407407,0.3333333333333333
Allergic bronchopulmonary aspergillosis,31008,6,14,20,13,7,21,5,16,0.9285714285714286,0.35714285714285715,0.65,0.9285714285714286,0.23809523809523808,0.35714285714285715
Eosinophilic granulomatosis with polyangiitis,32099,4,66,17,11,6,30,10,20,0.16666666666666666,0.15151515151515152,0.6470588235294118,0.16666666666666666,0.3333333333333333,0.15151515151515152
Maple syrup urine disease,95137,17,11,25,2,23,25,1,24,0.18181818181818182,0.09090909090909091,0.08,0.18181818181818182,0.04,0.09090909090909091
Methylmalonic acidemia with homocystinuria,33171,7,18,20,7,13,38,2,36,0.3888888888888889,0.1111111111111111,0.35,0.3888888888888889,0.05263157894736842,0.1111111111111111
Glutathione synthetase deficiency,31963,10,5,24,1,23,36,0,36,0.2,0.0,0.041666666666666664,0.2,0.0,0.0
X-linked alpha-thalassemia-intellectual disability syndrome,31249,2,57,75,47,28,24,4,20,0.8245614035087719,0.07017543859649122,0.6266666666666667,0.8245614035087719,0.16666666666666666,0.07017543859649122
Familial Mediterranean fever,32202,6,50,17,17,0,32,12,20,0.34,0.24,1.0,0.34,0.375,0.24
Simpson-Golabi-Behmel syndrome,30745,4,79,124,70,54,24,6,18,0.8860759493670886,0.0759493670886076,0.5645161290322581,0.8860759493670886,0.25,0.0759493670886076
Multiple symmetric lipomatosis,28575,0,10,17,10,7,15,2,13,1.0,0.2,0.5882352941176471,1.0,0.13333333333333333,0.2
Dermatitis herpetiformis,33410,8,26,17,10,7,22,7,15,0.38461538461538464,0.2692307692307692,0.5882352941176471,0.38461538461538464,0.3181818181818182,0.2692307692307692
Mucopolysaccharidosis type 4,27436,10,34,20,5,15,22,4,18,0.14705882352941177,0.11764705882352941,0.25,0.14705882352941177,0.18181818181818182,0.11764705882352941
Giant cell arteritis,27692,1,68,20,19,1,20,4,16,0.27941176470588236,0.058823529411764705,0.95,0.27941176470588236,0.2,0.058823529411764705
Budd-Chiari syndrome,31637,6,23,17,17,0,24,7,17,0.7391304347826086,0.30434782608695654,1.0,0.7391304347826086,0.2916666666666667,0.30434782608695654
Niemann-Pick disease type C,98094,8,81,32,5,27,23,5,18,0.06172839506172839,0.06172839506172839,0.15625,0.06172839506172839,0.21739130434782608,0.06172839506172839
Nephroblastoma,33158,9,27,17,10,7,21,7,14,0.37037037037037035,0.25925925925925924,0.5882352941176471,0.37037037037037035,0.3333333333333333,0.25925925925925924
Legg-Calvé-Perthes disease,31228,1,8,22,8,14,20,0,20,1.0,0.0,0.36363636363636365,1.0,0.0,0.0
Rabies,32981,2,19,16,14,2,29,5,24,0.7368421052631579,0.2631578947368421,0.875,0.7368421052631579,0.1724137931034483,0.2631578947368421
Botulism,32729,6,18,20,18,2,24,8,16,1.0,0.4444444444444444,0.9,1.0,0.3333333333333333,0.4444444444444444
Legionnaires disease,33292,2,42,17,17,0,19,8,11,0.40476190476190477,0.19047619047619047,1.0,0.40476190476190477,0.42105263157894735,0.19047619047619047
Wolfram syndrome,31066,2,39,16,7,9,32,3,29,0.1794871794871795,0.07692307692307693,0.4375,0.1794871794871795,0.09375,0.07692307692307693
Pemphigus vulgaris,30998,3,20,12,11,1,20,6,14,0.55,0.3,0.9166666666666666,0.55,0.3,0.3
Autosomal dominant hyper-IgE syndrome due to STAT3 deficiency,31806,5,49,16,8,8,26,7,19,0.16326530612244897,0.14285714285714285,0.5,0.16326530612244897,0.2692307692307692,0.14285714285714285
Stickler syndrome,32565,3,77,25,20,5,17,4,13,0.2597402597402597,0.05194805194805195,0.8,0.2597402597402597,0.23529411764705882,0.05194805194805195
Tetralogy of Fallot,27857,2,12,17,9,8,25,0,25,0.75,0.0,0.5294117647058824,0.75,0.0,0.0
Bazex-Dupré-Christol syndrome,30212,2,15,25,13,12,30,0,30,0.8666666666666667,0.0,0.52,0.8666666666666667,0.0,0.0
"46,XX gonadal dysgenesis",38652,20,25,27,7,20,31,6,25,0.28,0.24,0.25925925925925924,0.28,0.1935483870967742,0.24
ICF syndrome,39876,12,23,27,0,27,24,0,24,0.0,0.0,0.0,0.0,0.0,0.0
Holt-Oram syndrome,31211,1,29,21,11,10,40,6,34,0.3793103448275862,0.20689655172413793,0.5238095238095238,0.3793103448275862,0.15,0.20689655172413793
Roberts syndrome,32857,1,54,16,15,1,26,2,24,0.2777777777777778,0.037037037037037035,0.9375,0.2777777777777778,0.07692307692307693,0.037037037037037035
Uveal coloboma-cleft lip and palate-intellectual disability,31143,9,17,22,12,10,24,4,20,0.7058823529411765,0.23529411764705882,0.5454545454545454,0.7058823529411765,0.16666666666666666,0.23529411764705882
Cherubism,27195,1,15,17,12,5,28,1,27,0.8,0.06666666666666667,0.7058823529411765,0.8,0.03571428571428571,0.06666666666666667
Caudal regression syndrome,32697,0,29,17,13,4,2,0,2,0.4482758620689655,0.0,0.7647058823529411,0.4482758620689655,0.0,0.0
Werner syndrome,32590,5,59,37,21,16,26,6,20,0.3559322033898305,0.1016949152542373,0.5675675675675675,0.3559322033898305,0.23076923076923078,0.1016949152542373
Waardenburg-Shah syndrome,32808,3,23,17,18,-1,26,6,20,0.782608695652174,0.2608695652173913,1.0588235294117647,0.782608695652174,0.23076923076923078,0.2608695652173913
Familial progressive cardiac conduction defect,28103,4,8,17,10,7,17,4,13,1.25,0.5,0.5882352941176471,1.25,0.23529411764705882,0.5
Peters plus syndrome,30639,1,84,104,69,35,47,2,45,0.8214285714285714,0.023809523809523808,0.6634615384615384,0.8214285714285714,0.0425531914893617,0.023809523809523808
LCAT deficiency,33178,5,13,23,8,15,23,3,20,0.6153846153846154,0.23076923076923078,0.34782608695652173,0.6153846153846154,0.13043478260869565,0.23076923076923078
Choroideremia,96981,22,15,28,6,22,31,6,25,0.4,0.4,0.21428571428571427,0.4,0.1935483870967742,0.4
Neurofibromatosis-Noonan syndrome,30868,2,18,18,7,11,39,1,38,0.3888888888888889,0.05555555555555555,0.3888888888888889,0.3888888888888889,0.02564102564102564,0.05555555555555555
Liddle syndrome,28419,6,9,16,9,7,25,5,20,1.0,0.5555555555555556,0.5625,1.0,0.2,0.5555555555555556
Campomelic dysplasia,28683,2,38,55,36,19,30,4,26,0.9473684210526315,0.10526315789473684,0.6545454545454545,0.9473684210526315,0.13333333333333333,0.10526315789473684
Nance-Horan syndrome,32072,1,19,17,12,5,25,5,20,0.631578947368421,0.2631578947368421,0.7058823529411765,0.631578947368421,0.2,0.2631578947368421
Netherton syndrome,29333,4,31,37,24,13,25,3,22,0.7741935483870968,0.0967741935483871,0.6486486486486487,0.7741935483870968,0.12,0.0967741935483871
Hereditary sensory and autonomic neuropathy type 4,27625,9,56,32,9,23,44,3,41,0.16071428571428573,0.05357142857142857,0.28125,0.16071428571428573,0.06818181818181818,0.05357142857142857
Non-distal duplication 10q syndrome,39196,12,24,26,2,24,46,2,44,0.08333333333333333,0.08333333333333333,0.07692307692307693,0.08333333333333333,0.043478260869565216,0.08333333333333333
Trisomy 12p syndrome,33391,3,31,29,28,1,40,5,35,0.9032258064516129,0.16129032258064516,0.9655172413793104,0.9032258064516129,0.125,0.16129032258064516
3q13 microdeletion syndrome,33028,2,17,23,0,23,28,1,27,0.0,0.058823529411764705,0.0,0.0,0.03571428571428571,0.058823529411764705
Xp22.3 microdeletion syndrome,33253,4,12,24,10,14,25,2,23,0.8333333333333334,0.16666666666666666,0.4166666666666667,0.8333333333333334,0.08,0.16666666666666666
Distal deletion 17q syndrome,32575,0,31,17,16,1,36,3,33,0.5161290322580645,0.0967741935483871,0.9411764705882353,0.5161290322580645,0.08333333333333333,0.0967741935483871
Distal deletion 3p syndrome,28213,4,34,18,14,4,34,5,29,0.4117647058823529,0.14705882352941177,0.7777777777777778,0.4117647058823529,0.14705882352941177,0.14705882352941177
Monosomy 13q14 syndrome,32684,1,30,31,4,27,17,3,14,0.13333333333333333,0.1,0.12903225806451613,0.13333333333333333,0.17647058823529413,0.1
Distal deletion 10p syndrome,30426,7,31,28,8,20,29,6,23,0.25806451612903225,0.1935483870967742,0.2857142857142857,0.25806451612903225,0.20689655172413793,0.1935483870967742
Non-distal deletion 10q syndrome,29728,3,15,25,4,21,30,4,26,0.26666666666666666,0.26666666666666666,0.16,0.26666666666666666,0.13333333333333333,0.26666666666666666
Ring chromosome 8 syndrome,32385,0,14,20,0,20,28,1,27,0.0,0.07142857142857142,0.0,0.0,0.03571428571428571,0.07142857142857142
Currarino syndrome,29008,0,29,18,8,10,32,1,31,0.27586206896551724,0.034482758620689655,0.4444444444444444,0.27586206896551724,0.03125,0.034482758620689655
Ring chromosome 4 syndrome,32375,2,4,24,3,21,30,0,30,0.75,0.0,0.125,0.75,0.0,0.0
Ring chromosome 6 syndrome,32374,7,11,20,10,10,33,1,32,0.9090909090909091,0.09090909090909091,0.5,0.9090909090909091,0.030303030303030304,0.09090909090909091
Ring chromosome 1 syndrome,32387,3,13,19,12,7,39,1,38,0.9230769230769231,0.07692307692307693,0.631578947368421,0.9230769230769231,0.02564102564102564,0.07692307692307693
Ring chromosome 10 syndrome,32386,1,24,17,17,0,31,1,30,0.7083333333333334,0.041666666666666664,1.0,0.7083333333333334,0.03225806451612903,0.041666666666666664
Progressive familial intrahepatic cholestasis,32629,3,14,15,8,7,25,3,22,0.5714285714285714,0.21428571428571427,0.5333333333333333,0.5714285714285714,0.12,0.21428571428571427
Carey-Fineman-Ziter syndrome,31811,0,36,58,35,23,23,0,23,0.9722222222222222,0.0,0.603448275862069,0.9722222222222222,0.0,0.0
Heart defects-limb shortening syndrome,30939,2,14,16,10,6,32,5,27,0.7142857142857143,0.35714285714285715,0.625,0.7142857142857143,0.15625,0.35714285714285715
C syndrome,31628,0,54,66,45,21,10,0,10,0.8333333333333334,0.0,0.6818181818181818,0.8333333333333334,0.0,0.0
Barth syndrome,30347,1,4,24,2,22,31,0,31,0.5,0.0,0.08333333333333333,0.5,0.0,0.0
"48,XXYY syndrome",32250,2,61,45,40,5,29,6,23,0.6557377049180327,0.09836065573770492,0.8888888888888888,0.6557377049180327,0.20689655172413793,0.09836065573770492
Fraser syndrome,30452,1,66,24,5,19,26,3,23,0.07575757575757576,0.045454545454545456,0.20833333333333334,0.07575757575757576,0.11538461538461539,0.045454545454545456
"46,XY complete gonadal dysgenesis",38781,18,4,31,1,30,35,2,33,0.25,0.5,0.03225806451612903,0.25,0.05714285714285714,0.5
Léri-Weill dyschondrosteosis,30851,0,37,33,22,11,29,0,29,0.5945945945945946,0.0,0.6666666666666666,0.5945945945945946,0.0,0.0
Autosomal recessive spondylocostal dysostosis,29480,1,38,24,18,6,26,5,21,0.47368421052631576,0.13157894736842105,0.75,0.47368421052631576,0.19230769230769232,0.13157894736842105
Duane retraction syndrome,30399,12,62,19,6,13,27,5,22,0.0967741935483871,0.08064516129032258,0.3157894736842105,0.0967741935483871,0.18518518518518517,0.08064516129032258
Noonan syndrome with multiple lentigines,33317,2,50,37,36,1,28,6,22,0.72,0.12,0.972972972972973,0.72,0.21428571428571427,0.12
Mosaic trisomy 15 syndrome,33444,6,6,21,6,15,35,1,34,1.0,0.16666666666666666,0.2857142857142857,1.0,0.02857142857142857,0.16666666666666666
3C syndrome,28191,0,64,17,4,13,9,0,9,0.0625,0.0,0.23529411764705882,0.0625,0.0,0.0
Aase-Smith syndrome,29084,1,14,17,10,7,24,1,23,0.7142857142857143,0.07142857142857142,0.5882352941176471,0.7142857142857143,0.041666666666666664,0.07142857142857142
Ablepharon macrostomia syndrome,29773,0,39,41,35,6,25,0,25,0.8974358974358975,0.0,0.8536585365853658,0.8974358974358975,0.0,0.0
Spina bifida-hypospadias syndrome,32279,8,3,29,2,27,37,0,37,0.6666666666666666,0.0,0.06896551724137931,0.6666666666666666,0.0,0.0
Tetraploidy syndrome,32570,1,17,19,14,5,31,1,30,0.8235294117647058,0.058823529411764705,0.7368421052631579,0.8235294117647058,0.03225806451612903,0.058823529411764705
Trisomy X syndrome,32515,0,31,17,15,2,34,2,32,0.4838709677419355,0.06451612903225806,0.8823529411764706,0.4838709677419355,0.058823529411764705,0.06451612903225806
Triploidy syndrome,32516,1,34,18,18,0,32,1,31,0.5294117647058824,0.029411764705882353,1.0,0.5294117647058824,0.03125,0.029411764705882353
Familial peripheral male-limited precocious puberty,29908,7,11,16,7,9,35,6,29,0.6363636363636364,0.5454545454545454,0.4375,0.6363636363636364,0.17142857142857143,0.5454545454545454
Familial visceral myopathy,30255,3,23,17,3,14,26,0,26,0.13043478260869565,0.0,0.17647058823529413,0.13043478260869565,0.0,0.0
Mitochondrial myopathy-lactic acidosis-deafness syndrome,29082,4,9,17,5,12,23,0,23,0.5555555555555556,0.0,0.29411764705882354,0.5555555555555556,0.0,0.0
Mitochondrial myopathy and sideroblastic anemia,30011,3,19,35,15,20,27,2,25,0.7894736842105263,0.10526315789473684,0.42857142857142855,0.7894736842105263,0.07407407407407407,0.10526315789473684
Carnitine palmitoyl transferase 1A deficiency,27251,2,21,16,12,4,32,4,28,0.5714285714285714,0.19047619047619047,0.75,0.5714285714285714,0.125,0.19047619047619047
Epilepsy-microcephaly-skeletal dysplasia syndrome,29253,9,7,21,6,15,39,3,36,0.8571428571428571,0.42857142857142855,0.2857142857142857,0.8571428571428571,0.07692307692307693,0.42857142857142855
Amelocerebrohypohidrotic syndrome,29223,0,14,16,4,12,21,0,21,0.2857142857142857,0.0,0.25,0.2857142857142857,0.0,0.0
Griscelli syndrome,27582,1,36,58,37,21,30,1,29,1.0277777777777777,0.027777777777777776,0.6379310344827587,1.0277777777777777,0.03333333333333333,0.027777777777777776
Epilepsy-telangiectasia syndrome,31526,2,10,17,9,8,28,0,28,0.9,0.0,0.5294117647058824,0.9,0.0,0.0
Oculogastrointestinal muscular dystrophy,31123,1,13,18,11,7,21,0,21,0.8461538461538461,0.0,0.6111111111111112,0.8461538461538461,0.0,0.0
Trisomy 5p syndrome,39338,19,17,28,1,27,27,1,26,0.058823529411764705,0.058823529411764705,0.03571428571428571,0.058823529411764705,0.037037037037037035,0.058823529411764705
Trisomy 4p syndrome,33428,2,30,16,15,1,38,6,32,0.5,0.2,0.9375,0.5,0.15789473684210525,0.2
Trisomy 8q syndrome,33414,1,30,23,20,3,28,3,25,0.6666666666666666,0.1,0.8695652173913043,0.6666666666666666,0.10714285714285714,0.1
Distal duplication 6p syndrome,39199,20,33,31,3,28,31,2,29,0.09090909090909091,0.06060606060606061,0.0967741935483871,0.09090909090909091,0.06451612903225806,0.06060606060606061
Mosaic trisomy 14 syndrome,33446,2,30,19,17,2,30,2,28,0.5666666666666667,0.06666666666666667,0.8947368421052632,0.5666666666666667,0.06666666666666667,0.06666666666666667
Non-distal duplication 13q syndrome,39189,10,27,28,0,28,37,1,36,0.0,0.037037037037037035,0.0,0.0,0.02702702702702703,0.037037037037037035
17p11.2 microduplication syndrome,33180,4,35,18,3,15,30,3,27,0.08571428571428572,0.08571428571428572,0.16666666666666666,0.08571428571428572,0.1,0.08571428571428572
Distal duplication 14q syndrome,33445,0,10,17,9,8,16,0,16,0.9,0.0,0.5294117647058824,0.9,0.0,0.0
PAGOD syndrome,32665,0,31,19,17,2,27,1,26,0.5483870967741935,0.03225806451612903,0.8947368421052632,0.5483870967741935,0.037037037037037035,0.03225806451612903
Aicardi-Goutières syndrome,27962,2,72,112,63,49,4,1,3,0.875,0.013888888888888888,0.5625,0.875,0.25,0.013888888888888888
Hypoglossia-hypodactyly syndrome,39017,17,26,29,2,27,30,3,27,0.07692307692307693,0.11538461538461539,0.06896551724137931,0.07692307692307693,0.1,0.11538461538461539
Agnathia-holoprosencephaly-situs inversus syndrome,29148,3,19,26,16,10,42,2,40,0.8421052631578947,0.10526315789473684,0.6153846153846154,0.8421052631578947,0.047619047619047616,0.10526315789473684
Testicular regression syndrome,30323,4,11,23,12,11,33,5,28,1.0909090909090908,0.45454545454545453,0.5217391304347826,1.0909090909090908,0.15151515151515152,0.45454545454545453
Tibial hemimelia-polysyndactyly-triphalangeal thumb syndrome,32671,5,6,16,5,11,13,0,13,0.8333333333333334,0.0,0.3125,0.8333333333333334,0.0,0.0
Adrenomyodystrophy,29439,1,16,17,15,2,28,2,26,0.9375,0.125,0.8823529411764706,0.9375,0.07142857142857142,0.125
ADULT syndrome,37839,11,24,39,0,39,17,0,17,0.0,0.0,0.0,0.0,0.0,0.0
Alopecia-epilepsy-pyorrhea-intellectual disability syndrome,30393,4,14,16,2,14,30,7,23,0.14285714285714285,0.5,0.125,0.14285714285714285,0.23333333333333334,0.5
Alopecia universalis,38135,5,13,7,2,5,5,1,4,0.15384615384615385,0.07692307692307693,0.2857142857142857,0.15384615384615385,0.2,0.07692307692307693
Scalp defects-postaxial polydactyly syndrome,29677,4,4,22,2,20,30,0,30,0.5,0.0,0.09090909090909091,0.5,0.0,0.0
Alopecia-contractures-dwarfism-intellectual disability syndrome,31416,3,35,36,29,7,16,3,13,0.8285714285714286,0.08571428571428572,0.8055555555555556,0.8285714285714286,0.1875,0.08571428571428572
Fetal akinesia deformation sequence,29919,0,24,25,9,16,24,1,23,0.375,0.041666666666666664,0.36,0.375,0.041666666666666664,0.041666666666666664
2q37 microdeletion syndrome,33271,2,52,17,6,11,31,5,26,0.11538461538461539,0.09615384615384616,0.35294117647058826,0.11538461538461539,0.16129032258064516,0.09615384615384616
Amelo-onycho-hypohidrotic syndrome,29223,1,15,17,15,2,34,2,32,1.0,0.13333333333333333,0.8823529411764706,1.0,0.058823529411764705,0.13333333333333333
Amaurosis-hypertrichosis syndrome,27602,3,11,17,11,6,24,1,23,1.0,0.09090909090909091,0.6470588235294118,1.0,0.041666666666666664,0.09090909090909091
Alopecia-intellectual disability-hypergonadotropic hypogonadism syndrome,30707,4,3,21,2,19,27,0,27,0.6666666666666666,0.0,0.09523809523809523,0.6666666666666666,0.0,0.0
Hereditary neurocutaneous malformation,29587,4,4,32,4,28,21,1,20,1.0,0.25,0.125,1.0,0.047619047619047616,0.25
Congenital left ventricular aneurysm,39231,9,6,14,1,13,23,1,22,0.16666666666666666,0.16666666666666666,0.07142857142857142,0.16666666666666666,0.043478260869565216,0.16666666666666666
Vein of Galen aneurysmal malformation,33012,12,3,23,0,23,30,0,30,0.0,0.0,0.0,0.0,0.0,0.0
Mosaic variegated aneuploidy syndrome,28004,4,64,105,61,44,23,8,15,0.953125,0.125,0.580952380952381,0.953125,0.34782608695652173,0.125
Metaphyseal anadysplasia,27535,4,9,17,10,7,34,1,33,1.1111111111111112,0.1111111111111111,0.5882352941176471,1.1111111111111112,0.029411764705882353,0.1111111111111111
Beta-mercaptolactate cysteine disulfiduria,31387,0,24,21,19,2,35,0,35,0.7916666666666666,0.0,0.9047619047619048,0.7916666666666666,0.0,0.0
Isolated acheiropodia,29085,1,8,19,6,13,24,0,24,0.75,0.0,0.3157894736842105,0.75,0.0,0.0
Achondrogenesis,27350,2,23,31,9,22,24,3,21,0.391304347826087,0.13043478260869565,0.2903225806451613,0.391304347826087,0.125,0.13043478260869565
Short-limb skeletal dysplasia with severe combined immunodeficiency,29100,1,18,17,12,5,32,2,30,0.6666666666666666,0.1111111111111111,0.7058823529411765,0.6666666666666666,0.0625,0.1111111111111111
Oxoglutaric aciduria,38526,17,10,26,1,25,42,2,40,0.1,0.2,0.038461538461538464,0.1,0.047619047619047616,0.2
Abruzzo-Erickson syndrome,32125,1,24,23,16,7,18,2,16,0.6666666666666666,0.08333333333333333,0.6956521739130435,0.6666666666666666,0.1111111111111111,0.08333333333333333
Insulin-resistance syndrome type A,33489,5,7,49,7,42,31,1,30,1.0,0.14285714285714285,0.14285714285714285,1.0,0.03225806451612903,0.14285714285714285
Triple A syndrome,31081,0,35,18,11,7,18,0,18,0.3142857142857143,0.0,0.6111111111111112,0.3142857142857143,0.0,0.0
Achalasia-microcephaly syndrome,28820,4,10,25,9,16,29,2,27,0.9,0.2,0.36,0.9,0.06896551724137931,0.2
Acrocraniofacial dysostosis,28444,1,44,18,13,5,9,2,7,0.29545454545454547,0.045454545454545456,0.7222222222222222,0.29545454545454547,0.2222222222222222,0.045454545454545456
Acrodermatitis enteropathica,31937,2,31,21,14,7,27,3,24,0.45161290322580644,0.0967741935483871,0.6666666666666666,0.45161290322580644,0.1111111111111111,0.0967741935483871
Acrodysostosis,32833,2,53,18,15,3,35,4,31,0.2830188679245283,0.07547169811320754,0.8333333333333334,0.2830188679245283,0.11428571428571428,0.07547169811320754
3-hydroxyisobutyric aciduria,30400,0,15,19,13,6,28,0,28,0.8666666666666667,0.0,0.6842105263157895,0.8666666666666667,0.0,0.0
Vitamin B12-unresponsive methylmalonic acidemia,33189,1,25,17,8,9,33,3,30,0.32,0.12,0.47058823529411764,0.32,0.09090909090909091,0.12
Acro-renal-ocular syndrome,28155,7,44,22,0,22,40,0,40,0.0,0.0,0.0,0.0,0.0,0.0
Acro-renal-mandibular syndrome,31163,0,37,53,31,22,31,0,31,0.8378378378378378,0.0,0.5849056603773585,0.8378378378378378,0.0,0.0
Hajdu-Cheney syndrome,30947,2,86,34,2,32,36,3,33,0.023255813953488372,0.03488372093023256,0.058823529411764705,0.023255813953488372,0.08333333333333333,0.03488372093023256
"Acrofacial dysostosis, Weyers type",28047,0,19,27,1,26,34,0,34,0.05263157894736842,0.0,0.037037037037037035,0.05263157894736842,0.0,0.0
Acropectorovertebral dysplasia,27947,0,12,21,8,13,18,0,18,0.6666666666666666,0.0,0.38095238095238093,0.6666666666666666,0.0,0.0
Hereditary continuous muscle fiber activity,32842,7,10,16,8,8,17,0,17,0.8,0.0,0.5,0.8,0.0,0.0
Adams-Oliver syndrome,28022,2,46,79,39,40,25,1,24,0.8478260869565217,0.021739130434782608,0.4936708860759494,0.8478260869565217,0.04,0.021739130434782608
"Isolated absence/hypoplasia of fingers excluding thumb, unilateral",31277,1,5,29,4,25,19,0,19,0.8,0.0,0.13793103448275862,0.8,0.0,0.0
"Acromesomelic dysplasia, Maroteaux type",99045,20,18,30,4,26,38,4,34,0.2222222222222222,0.2222222222222222,0.13333333333333333,0.2222222222222222,0.10526315789473684,0.2222222222222222
"Acromesomelic dysplasia, Hunter-Thompson type",30051,1,18,23,13,10,19,1,18,0.7222222222222222,0.05555555555555555,0.5652173913043478,0.7222222222222222,0.05263157894736842,0.05555555555555555
Hereditary sensory and autonomic neuropathy type 2,27625,8,15,30,0,30,39,0,39,0.0,0.0,0.0,0.0,0.0,0.0
Acromicric dysplasia,28047,0,22,21,15,6,19,0,19,0.6818181818181818,0.0,0.7142857142857143,0.6818181818181818,0.0,0.0
Cerebellar ataxia-ectodermal dysplasia syndrome,27387,2,12,14,9,5,16,1,15,0.75,0.08333333333333333,0.6428571428571429,0.75,0.0625,0.08333333333333333
Congenital unilateral hypoplasia of depressor anguli oris,29255,1,26,18,16,2,21,1,20,0.6153846153846154,0.038461538461538464,0.8888888888888888,0.6153846153846154,0.047619047619047616,0.038461538461538464
Ataxia-oculomotor apraxia type 1,27817,2,5,19,4,15,3,1,2,0.8,0.2,0.21052631578947367,0.8,0.3333333333333333,0.2
Cerebellar ataxia-hypogonadism syndrome,28370,3,20,21,13,8,5,3,2,0.65,0.15,0.6190476190476191,0.65,0.6,0.15
Ataxia-hypogonadism-choroidal dystrophy syndrome,29798,2,3,17,3,14,23,3,20,1.0,1.0,0.17647058823529413,1.0,0.13043478260869565,1.0
Ataxia-tapetoretinal degeneration syndrome,30850,4,9,21,9,12,33,8,25,1.0,0.8888888888888888,0.42857142857142855,1.0,0.24242424242424243,0.8888888888888888
Benign paroxysmal tonic upgaze of childhood with ataxia,30987,6,3,26,4,22,6,2,4,1.3333333333333333,0.6666666666666666,0.15384615384615385,1.3333333333333333,0.3333333333333333,0.6666666666666666
Spinocerebellar ataxia-dysmorphism syndrome,27662,2,26,31,1,30,18,3,15,0.038461538461538464,0.11538461538461539,0.03225806451612903,0.038461538461538464,0.16666666666666666,0.11538461538461539
Infantile-onset spinocerebellar ataxia,31537,1,7,18,7,11,5,3,2,1.0,0.42857142857142855,0.3888888888888889,1.0,0.6,0.42857142857142855
Spastic ataxia with congenital miosis,27721,0,8,19,3,16,19,4,15,0.375,0.5,0.15789473684210525,0.375,0.21052631578947367,0.5
Ataxia-photosensitivity-short stature syndrome,33200,4,16,16,15,1,39,7,32,0.9375,0.4375,0.9375,0.9375,0.1794871794871795,0.4375
Colonic atresia,28880,9,8,20,6,14,18,1,17,0.75,0.125,0.3,0.75,0.05555555555555555,0.125
Ataxia-deafness-intellectual disability syndrome,29667,15,17,33,5,28,26,2,24,0.29411764705882354,0.11764705882352941,0.15151515151515152,0.29411764705882354,0.07692307692307693,0.11764705882352941
Progressive hemifacial atrophy,31985,1,11,17,10,7,22,1,21,0.9090909090909091,0.09090909090909091,0.5882352941176471,0.9090909090909091,0.045454545454545456,0.09090909090909091
Pulmonary atresia-intact ventricular septum syndrome,30358,11,5,30,4,26,24,0,24,0.8,0.0,0.13333333333333333,0.8,0.0,0.0
Duodenal atresia,28562,9,16,22,6,16,14,5,9,0.375,0.3125,0.2727272727272727,0.375,0.35714285714285715,0.3125
Baller-Gerold syndrome,31947,0,43,67,39,28,1,0,1,0.9069767441860465,0.0,0.582089552238806,0.9069767441860465,0.0,0.0
Cheilitis glandularis,31409,0,5,16,4,12,20,0,20,0.8,0.0,0.25,0.8,0.0,0.0
Bannayan-Riley-Ruvalcaba syndrome,29873,3,55,17,12,5,19,4,15,0.21818181818181817,0.07272727272727272,0.7058823529411765,0.21818181818181817,0.21052631578947367,0.07272727272727272
Banki syndrome,30390,0,4,23,2,21,37,0,37,0.5,0.0,0.08695652173913043,0.5,0.0,0.0
Bangstad syndrome,28893,1,21,20,15,5,26,1,25,0.7142857142857143,0.047619047619047616,0.75,0.7142857142857143,0.038461538461538464,0.047619047619047616
Severe microbrachycephaly-intellectual disability-athetoid cerebral palsy syndrome,32741,1,32,17,17,0,24,4,20,0.53125,0.125,1.0,0.53125,0.16666666666666666,0.125
Bartsocas-Papas syndrome,28697,0,26,41,23,18,22,1,21,0.8846153846153846,0.038461538461538464,0.5609756097560976,0.8846153846153846,0.045454545454545456,0.038461538461538464
Barber-Say syndrome,30037,0,23,34,20,14,7,0,7,0.8695652173913043,0.0,0.5882352941176471,0.8695652173913043,0.0,0.0
Congenital intrauterine infection-like syndrome,32427,2,7,17,0,17,22,0,22,0.0,0.0,0.0,0.0,0.0,0.0
Aniridia-renal agenesis-psychomotor retardation syndrome,29961,3,16,18,16,2,36,2,34,1.0,0.125,0.8888888888888888,1.0,0.05555555555555555,0.125
Aniridia-ptosis-intellectual disability-familial obesity syndrome,33002,6,11,25,11,14,35,5,30,1.0,0.45454545454545453,0.44,1.0,0.14285714285714285,0.45454545454545453
Aniridia-intellectual disability syndrome,33001,13,5,29,3,26,28,1,27,0.6,0.2,0.10344827586206896,0.6,0.03571428571428571,0.2
Aniridia-absent patella syndrome,30456,2,8,30,4,26,31,2,29,0.5,0.25,0.13333333333333333,0.5,0.06451612903225806,0.25
Ankyloblepharon-ectodermal defects-cleft lip/palate syndrome,27391,3,31,17,12,5,37,2,35,0.3870967741935484,0.06451612903225806,0.7058823529411765,0.3870967741935484,0.05405405405405406,0.06451612903225806
Ankyloblepharon filiforme adnatum-cleft palate syndrome,29953,6,5,25,4,21,30,3,27,0.8,0.6,0.16,0.8,0.1,0.6
Ankyloblepharon filiforme adnatum-imperforate anus syndrome,32997,7,5,31,3,28,26,2,24,0.6,0.4,0.0967741935483871,0.6,0.07692307692307693,0.4
Dental ankylosis,31838,2,4,20,4,16,15,0,15,1.0,0.0,0.2,1.0,0.0,0.0
Thumb stiffness-brachydactyly-intellectual disability syndrome,31548,5,6,33,5,28,25,1,24,0.8333333333333334,0.16666666666666666,0.15151515151515152,0.8333333333333334,0.04,0.16666666666666666
Anonychia-microcephaly syndrome,33187,5,8,20,8,12,20,1,19,1.0,0.125,0.4,1.0,0.05,0.125
Anophthalmia plus syndrome,28468,2,16,15,10,5,26,2,24,0.625,0.125,0.6666666666666666,0.625,0.07692307692307693,0.125
Microphthalmia with limb anomalies,31021,0,57,17,3,14,38,6,32,0.05263157894736842,0.10526315789473684,0.17647058823529413,0.05263157894736842,0.15789473684210525,0.10526315789473684
Antley-Bixler syndrome,32124,1,30,40,6,34,39,5,34,0.2,0.16666666666666666,0.15,0.2,0.1282051282051282,0.16666666666666666
Aortic arch anomaly-facial dysmorphism-intellectual disability syndrome,28747,3,23,17,13,4,32,6,26,0.5652173913043478,0.2608695652173913,0.7647058823529411,0.5652173913043478,0.1875,0.2608695652173913
Aphalangy-syndactyly-microcephaly syndrome,29724,2,14,17,9,8,28,2,26,0.6428571428571429,0.14285714285714285,0.5294117647058824,0.6428571428571429,0.07142857142857142,0.14285714285714285
Aplasia cutis congenita-intestinal lymphangiectasia syndrome,30290,2,13,18,10,8,29,3,26,0.7692307692307693,0.23076923076923078,0.5555555555555556,0.7692307692307693,0.10344827586206896,0.23076923076923078
Fibular aplasia-ectrodactyly syndrome,28530,1,4,23,4,19,29,0,29,1.0,0.0,0.17391304347826086,1.0,0.0,0.0
Aplasia cutis-myopia syndrome,30852,1,11,17,8,9,31,2,29,0.7272727272727273,0.18181818181818182,0.47058823529411764,0.7272727272727273,0.06451612903225806,0.18181818181818182
Ulnar hypoplasia-split foot syndrome,28652,2,4,25,3,22,22,1,21,0.75,0.25,0.12,0.75,0.045454545454545456,0.25
Lung agenesis-heart defect-thumb anomalies syndrome,32165,1,27,21,19,2,39,5,34,0.7037037037037037,0.18518518518518517,0.9047619047619048,0.7037037037037037,0.1282051282051282,0.18518518518518517
X-linked mandibulofacial dysostosis,30401,2,24,18,4,14,31,2,29,0.16666666666666666,0.08333333333333333,0.2222222222222222,0.16666666666666666,0.06451612903225806,0.08333333333333333
Arthrogryposis-like hand anomaly-sensorineural deafness syndrome,30721,6,5,18,4,14,40,1,39,0.8,0.2,0.2222222222222222,0.8,0.025,0.2
Arthrogryposis multiplex congenita-whistling face syndrome,28356,1,24,18,13,5,40,4,36,0.5416666666666666,0.16666666666666666,0.7222222222222222,0.5416666666666666,0.1,0.16666666666666666
Chylous ascites,30152,8,7,23,6,17,16,1,15,0.8571428571428571,0.14285714285714285,0.2608695652173913,0.8571428571428571,0.0625,0.14285714285714285
Atrioventricular defect-blepharophimosis-radial and anal defect syndrome,29364,2,22,22,17,5,34,3,31,0.7727272727272727,0.13636363636363635,0.7727272727272727,0.7727272727272727,0.08823529411764706,0.13636363636363635
Heart-hand syndrome type 2,30839,1,25,19,11,8,13,2,11,0.44,0.08,0.5789473684210527,0.44,0.15384615384615385,0.08
Cardiomyopathy-cataract-hip spine disease syndrome,32896,4,14,24,10,14,35,3,32,0.7142857142857143,0.21428571428571427,0.4166666666666667,0.7142857142857143,0.08571428571428572,0.21428571428571427
Cardiofaciocutaneous syndrome,28065,2,79,16,5,11,35,5,30,0.06329113924050633,0.06329113924050633,0.3125,0.06329113924050633,0.14285714285714285,0.06329113924050633
Heart defect-tongue hamartoma-polysyndactyly syndrome,27309,3,6,19,5,14,28,2,26,0.8333333333333334,0.3333333333333333,0.2631578947368421,0.8333333333333334,0.07142857142857142,0.3333333333333333
Hyperkeratosis-hyperpigmentation syndrome,32913,5,5,14,5,9,15,1,14,1.0,0.2,0.35714285714285715,1.0,0.06666666666666667,0.2
Pentalogy of Cantrell,31497,2,25,17,13,4,32,7,25,0.52,0.28,0.7647058823529411,0.52,0.21875,0.28
Persistent Müllerian duct syndrome,31830,11,3,20,3,17,28,2,26,1.0,0.6666666666666666,0.15,1.0,0.07142857142857142,0.6666666666666666
Camurati-Engelmann disease,29176,1,54,67,49,18,18,1,17,0.9074074074074074,0.018518518518518517,0.7313432835820896,0.9074074074074074,0.05555555555555555,0.018518518518518517
"Camptodactyly syndrome, Guadalajara type 1",27865,1,47,106,43,63,14,3,11,0.9148936170212766,0.06382978723404255,0.4056603773584906,0.9148936170212766,0.21428571428571427,0.06382978723404255
"Camptodactyly syndrome, Guadalajara type 2",27865,0,13,33,7,26,17,0,17,0.5384615384615384,0.0,0.21212121212121213,0.5384615384615384,0.0,0.0
Camptodactyly-taurinuria syndrome,32919,12,4,26,2,24,35,1,34,0.5,0.25,0.07692307692307693,0.5,0.02857142857142857,0.25
Camptobrachydactyly,31694,2,9,26,2,24,25,1,24,0.2222222222222222,0.1111111111111111,0.07692307692307693,0.2222222222222222,0.04,0.1111111111111111
Night blindness-skeletal anomalies-dysmorphism syndrome,32860,0,23,18,18,0,44,3,41,0.782608695652174,0.13043478260869565,1.0,0.782608695652174,0.06818181818181818,0.13043478260869565
Cerebrocostomandibular syndrome,28611,0,27,18,0,18,14,0,14,0.0,0.0,0.0,0.0,0.0,0.0
Catel-Manzke syndrome,31360,1,25,41,20,21,23,1,22,0.8,0.04,0.4878048780487805,0.8,0.043478260869565216,0.04
Cortical blindness-intellectual disability-polydactyly syndrome,29088,2,14,18,13,5,32,2,30,0.9285714285714286,0.14285714285714285,0.7222222222222222,0.9285714285714286,0.0625,0.14285714285714285
Cataract-intellectual disability-anal atresia-urinary defects syndrome,32865,6,12,26,12,14,27,3,24,1.0,0.25,0.46153846153846156,1.0,0.1111111111111111,0.25
Cataract-intellectual disability-hypogonadism syndrome,30594,1,30,29,18,11,11,1,10,0.6,0.03333333333333333,0.6206896551724138,0.6,0.09090909090909091,0.03333333333333333
Cataract-microcornea syndrome,29582,5,7,20,5,15,23,2,21,0.7142857142857143,0.2857142857142857,0.25,0.7142857142857143,0.08695652173913043,0.2857142857142857
Cataract-nephropathy-encephalopathy syndrome,30101,3,6,25,5,20,38,1,37,0.8333333333333334,0.16666666666666666,0.2,0.8333333333333334,0.02631578947368421,0.16666666666666666
Cataract-hypertrichosis-intellectual disability syndrome,30120,2,8,24,7,17,18,1,17,0.875,0.125,0.2916666666666667,0.875,0.05555555555555555,0.125
Cataract-aberrant oral frenula-growth delay syndrome,31097,1,10,14,4,10,23,0,23,0.4,0.0,0.2857142857142857,0.4,0.0,0.0
Hereditary hyperferritinemia-cataract syndrome,27324,0,2,7,1,6,32,1,31,0.5,0.5,0.14285714285714285,0.5,0.03125,0.5
Autosomal recessive palmoplantar keratoderma and congenital alopecia,29558,2,10,20,8,12,14,2,12,0.8,0.2,0.4,0.8,0.14285714285714285,0.2
Congenital heart defect-round face-developmental delay syndrome,30832,2,12,17,10,7,25,1,24,0.8333333333333334,0.08333333333333333,0.5882352941176471,0.8333333333333334,0.04,0.08333333333333333
Carnosinase deficiency,29697,9,5,27,5,22,33,0,33,1.0,0.0,0.18518518518518517,1.0,0.0,0.0
Böök syndrome,27208,0,10,16,11,5,12,0,12,1.1,0.0,0.6875,1.1,0.0,0.0
Tricho-retino-dento-digital syndrome,27849,2,10,16,8,8,48,3,45,0.8,0.3,0.5,0.8,0.0625,0.3
Borjeson-Forssman-Lehmann syndrome,32096,2,34,17,13,4,34,3,31,0.38235294117647056,0.08823529411764706,0.7647058823529411,0.38235294117647056,0.08823529411764706,0.08823529411764706
Ascher syndrome,31447,0,12,15,8,7,24,0,24,0.6666666666666666,0.0,0.5333333333333333,0.6666666666666666,0.0,0.0
Bonnemann-Meinecke-Reich syndrome,30769,0,11,16,9,7,21,0,21,0.8181818181818182,0.0,0.5625,0.8181818181818182,0.0,0.0
Blepharoptosis-myopia-ectopia lentis syndrome,31260,3,10,20,7,13,24,3,21,0.7,0.3,0.35,0.7,0.125,0.3
Bencze syndrome,28378,0,8,23,9,14,21,0,21,1.125,0.0,0.391304347826087,1.125,0.0,0.0
Blepharonasofacial malformation syndrome,29759,2,28,25,23,2,30,2,28,0.8214285714285714,0.07142857142857142,0.92,0.8214285714285714,0.06666666666666667,0.07142857142857142
Maxillonasal dysplasia,30733,5,20,21,1,20,11,0,11,0.05,0.0,0.047619047619047616,0.05,0.0,0.0
Auriculoosteodysplasia,29573,0,10,18,11,7,16,0,16,1.1,0.0,0.6111111111111112,1.1,0.0,0.0
Congenital contractural arachnodactyly,97927,10,21,32,5,27,27,2,25,0.23809523809523808,0.09523809523809523,0.15625,0.23809523809523808,0.07407407407407407,0.09523809523809523
Beemer-Ertbruggen syndrome,30487,0,13,17,11,6,4,0,4,0.8461538461538461,0.0,0.6470588235294118,0.8461538461538461,0.0,0.0
Distal limb deficiencies-micrognathia syndrome,31198,3,30,23,1,22,36,4,32,0.03333333333333333,0.13333333333333333,0.043478260869565216,0.03333333333333333,0.1111111111111111,0.13333333333333333
Infantile choroidocerebral calcification syndrome,30703,4,5,19,5,14,31,1,30,1.0,0.2,0.2631578947368421,1.0,0.03225806451612903,0.2
Symmetrical thalamic calcifications,32925,3,16,19,15,4,23,4,19,0.9375,0.25,0.7894736842105263,0.9375,0.17391304347826086,0.25
"Campomelia, Cumming type",31707,2,27,17,14,3,30,2,28,0.5185185185185185,0.07407407407407407,0.8235294117647058,0.5185185185185185,0.06666666666666667,0.07407407407407407
Lambert syndrome,28157,0,16,17,14,3,24,0,24,0.875,0.0,0.8235294117647058,0.875,0.0,0.0
Branchio-oculo-facial syndrome,28514,1,37,81,28,53,17,0,17,0.7567567567567568,0.0,0.345679012345679,0.7567567567567568,0.0,0.0
Autosomal dominant popliteal pterygium syndrome,38207,3,24,3,0,3,8,1,7,0.0,0.041666666666666664,0.0,0.0,0.125,0.041666666666666664
Brachydactyly-preaxial hallux varus syndrome,30364,0,13,17,12,5,36,1,35,0.9230769230769231,0.07692307692307693,0.7058823529411765,0.9230769230769231,0.027777777777777776,0.07692307692307693
Brachytelephalangy-dysmorphism-Kallmann syndrome,28377,0,19,19,14,5,22,3,19,0.7368421052631579,0.15789473684210525,0.7368421052631579,0.7368421052631579,0.13636363636363635,0.15789473684210525
Bowen-Conradi syndrome,32137,6,20,21,5,16,30,3,27,0.25,0.15,0.23809523809523808,0.25,0.1,0.15
Brachydactyly-elbow wrist dysplasia syndrome,28535,0,11,16,9,7,27,2,25,0.8181818181818182,0.18181818181818182,0.5625,0.8181818181818182,0.07407407407407407,0.18181818181818182
Brachydactyly-arterial hypertension syndrome,31964,0,5,16,3,13,22,1,21,0.6,0.2,0.1875,0.6,0.045454545454545456,0.2
Craniofrontonasal dysplasia,27877,0,42,18,1,17,15,0,15,0.023809523809523808,0.0,0.05555555555555555,0.023809523809523808,0.0,0.0
SPECC1L-related hypertelorism syndrome,31236,0,39,18,14,4,32,2,30,0.358974358974359,0.05128205128205128,0.7777777777777778,0.358974358974359,0.0625,0.05128205128205128
Non-syndromic bilambdoid and sagittal craniosynostosis,32568,4,29,21,5,16,40,4,36,0.1724137931034483,0.13793103448275862,0.23809523809523808,0.1724137931034483,0.1,0.13793103448275862
Craniotelencephalic dysplasia,30450,0,15,17,12,5,20,0,20,0.8,0.0,0.7058823529411765,0.8,0.0,0.0
"Craniosynostosis, Philadelphia type",29816,3,3,18,0,18,20,0,20,0.0,0.0,0.0,0.0,0.0,0.0
Cranio-osteoarthropathy,29816,6,14,25,4,21,36,4,32,0.2857142857142857,0.2857142857142857,0.16,0.2857142857142857,0.1111111111111111,0.2857142857142857
Craniometaphyseal dysplasia,27596,0,13,16,4,12,32,3,29,0.3076923076923077,0.23076923076923078,0.25,0.3076923076923077,0.09375,0.23076923076923078
Coxopodopatellar syndrome,30567,0,5,31,0,31,10,1,9,0.0,0.2,0.0,0.0,0.1,0.2
Coxoauricular syndrome,30881,0,9,17,10,7,20,0,20,1.1111111111111112,0.0,0.5882352941176471,1.1111111111111112,0.0,0.0
Autosomal recessive Robinow syndrome,29073,1,80,17,8,9,38,2,36,0.1,0.025,0.47058823529411764,0.1,0.05263157894736842,0.025
Thin ribs-tubular bones-dysmorphism syndrome,32431,1,8,8,7,1,26,1,25,0.875,0.125,0.875,0.875,0.038461538461538464,0.125
Cranioectodermal dysplasia,27422,0,30,22,8,14,15,0,15,0.26666666666666666,0.0,0.36363636363636365,0.26666666666666666,0.0,0.0
Craniodigital-intellectual disability syndrome,32414,2,14,19,12,7,23,2,21,0.8571428571428571,0.14285714285714285,0.631578947368421,0.8571428571428571,0.08695652173913043,0.14285714285714285
Craniodiaphyseal dysplasia,27877,1,13,18,6,12,66,1,65,0.46153846153846156,0.07692307692307693,0.3333333333333333,0.46153846153846156,0.015151515151515152,0.07692307692307693
Crane-Heise syndrome,32415,0,20,18,17,1,5,0,5,0.85,0.0,0.9444444444444444,0.85,0.0,0.0
Dahlberg-Borer-Newcomer syndrome,32006,0,17,17,13,4,25,0,25,0.7647058823529411,0.0,0.7647058823529411,0.7647058823529411,0.0,0.0
Curry-Jones syndrome,29096,0,19,17,14,3,21,0,21,0.7368421052631579,0.0,0.8235294117647058,0.7368421052631579,0.0,0.0
Cutis gyrata-acanthosis nigricans-craniosynostosis syndrome,28632,4,44,55,37,18,44,4,40,0.8409090909090909,0.09090909090909091,0.6727272727272727,0.8409090909090909,0.09090909090909091,0.09090909090909091
Knobloch syndrome,28312,0,26,17,10,7,10,1,9,0.38461538461538464,0.038461538461538464,0.5882352941176471,0.38461538461538464,0.1,0.038461538461538464
Familial benign copper deficiency,28458,0,12,16,10,6,16,0,16,0.8333333333333334,0.0,0.625,0.8333333333333334,0.0,0.0
Dandy-Walker malformation-postaxial polydactyly syndrome,30740,2,2,18,1,17,36,1,35,0.5,0.5,0.05555555555555555,0.5,0.027777777777777776,0.5
X-linked intellectual disability-Dandy-Walker malformation-basal ganglia disease-seizures syndrome,27376,7,7,23,2,21,25,1,24,0.2857142857142857,0.14285714285714285,0.08695652173913043,0.2857142857142857,0.04,0.14285714285714285
Craniofacial-deafness-hand syndrome,29298,1,17,19,15,4,40,2,38,0.8823529411764706,0.11764705882352941,0.7894736842105263,0.8823529411764706,0.05,0.11764705882352941
Cryptomicrotia-brachydactyly-excess fingertip arch syndrome,27451,1,7,18,7,11,22,0,22,1.0,0.0,0.3888888888888889,1.0,0.0,0.0
Cryptorchidism-arachnodactyly-intellectual disability syndrome,32599,2,17,19,15,4,25,3,22,0.8823529411764706,0.17647058823529413,0.7894736842105263,0.8823529411764706,0.12,0.17647058823529413
Jackson-Weiss syndrome,32031,0,21,20,15,5,21,0,21,0.7142857142857143,0.0,0.75,0.7142857142857143,0.0,0.0
Crisponi syndrome,32013,5,23,20,3,17,25,2,23,0.13043478260869565,0.08695652173913043,0.15,0.13043478260869565,0.08,0.08695652173913043
Familial calcium pyrophosphate deposition,27424,14,17,30,8,22,20,6,14,0.47058823529411764,0.35294117647058826,0.26666666666666666,0.47058823529411764,0.3,0.35294117647058826
Tarsal-carpal coalition syndrome,27284,0,3,11,3,8,15,0,15,1.0,0.0,0.2727272727272727,1.0,0.0,0.0
Greenberg dysplasia,31956,0,18,17,6,11,27,0,27,0.3333333333333333,0.0,0.35294117647058826,0.3333333333333333,0.0,0.0
Benign hereditary chorea,28939,11,2,24,4,20,22,2,20,2.0,1.0,0.16666666666666666,2.0,0.09090909090909091,1.0
Cerebrofaciothoracic dysplasia,32129,0,35,69,30,39,10,0,10,0.8571428571428571,0.0,0.43478260869565216,0.8571428571428571,0.0,0.0
Hydrocephaly-cerebellar agenesis syndrome,30355,6,5,18,4,14,22,3,19,0.8,0.6,0.2222222222222222,0.8,0.13636363636363635,0.6
Richards-Rundle syndrome,31837,0,13,16,8,8,16,0,16,0.6153846153846154,0.0,0.5,0.6153846153846154,0.0,0.0
Uncombable hair syndrome,28500,2,6,16,4,12,12,0,12,0.6666666666666666,0.0,0.25,0.6666666666666666,0.0,0.0
Coloboma of macula-brachydactyly type B syndrome,28908,6,9,18,10,8,29,2,27,1.1111111111111112,0.2222222222222222,0.5555555555555556,1.1111111111111112,0.06896551724137931,0.2222222222222222
Contractures-ectodermal dysplasia-cleft lip/palate syndrome,28770,3,8,15,6,9,28,1,27,0.75,0.125,0.4,0.75,0.03571428571428571,0.125
Lethal congenital contracture syndrome type 1,27984,1,18,16,4,12,36,2,34,0.2222222222222222,0.1111111111111111,0.25,0.2222222222222222,0.05555555555555555,0.1111111111111111
Cooks syndrome,28102,0,8,16,5,11,28,0,28,0.625,0.0,0.3125,0.625,0.0,0.0
Corneal dystrophy-perceptive deafness syndrome,27893,8,5,29,5,24,15,2,13,1.0,0.4,0.1724137931034483,1.0,0.13333333333333333,0.4
Vici syndrome,28110,0,35,59,31,28,18,0,18,0.8857142857142857,0.0,0.5254237288135594,0.8857142857142857,0.0,0.0
Intellectual disability-hypoplastic corpus callosum-preauricular tag syndrome,32348,1,27,22,19,3,20,1,19,0.7037037037037037,0.037037037037037035,0.8636363636363636,0.7037037037037037,0.05,0.037037037037037035
Choroidal atrophy-alopecia syndrome,32382,4,16,23,10,13,26,2,24,0.625,0.125,0.43478260869565216,0.625,0.07692307692307693,0.125
Xq21 microdeletion syndrome,32429,4,39,99,7,92,25,2,23,0.1794871794871795,0.05128205128205128,0.0707070707070707,0.1794871794871795,0.08,0.05128205128205128
X-linked skeletal dysplasia-intellectual disability syndrome,30680,3,9,19,7,12,39,2,37,0.7777777777777778,0.2222222222222222,0.3684210526315789,0.7777777777777778,0.05128205128205128,0.2222222222222222
Cleidorhizomelic syndrome,28603,0,7,14,5,9,23,0,23,0.7142857142857143,0.0,0.35714285714285715,0.7142857142857143,0.0,0.0
Coats disease,39106,21,8,29,4,25,28,4,24,0.5,0.5,0.13793103448275862,0.5,0.14285714285714285,0.5
CODAS syndrome,29615,1,33,54,28,26,26,1,25,0.8484848484848485,0.030303030303030304,0.5185185185185185,0.8484848484848485,0.038461538461538464,0.030303030303030304
COFS syndrome,32357,1,33,17,17,0,31,1,30,0.5151515151515151,0.030303030303030304,1.0,0.5151515151515151,0.03225806451612903,0.030303030303030304
"Bone dysplasia, lethal Holmgren type",27168,1,39,17,15,2,23,2,21,0.38461538461538464,0.05128205128205128,0.8823529411764706,0.38461538461538464,0.08695652173913043,0.05128205128205128
X-linked retinal dysplasia,30207,7,6,26,6,20,28,4,24,1.0,0.6666666666666666,0.23076923076923078,1.0,0.14285714285714285,0.6666666666666666
Axial mesodermal dysplasia spectrum,32945,0,42,17,15,2,12,0,12,0.35714285714285715,0.0,0.8823529411764706,0.35714285714285715,0.0,0.0
Hereditary mucoepithelial dysplasia,31858,0,18,18,10,8,15,0,15,0.5555555555555556,0.0,0.5555555555555556,0.5555555555555556,0.0,0.0
Progressive cone dystrophy,28237,9,5,20,4,16,26,3,23,0.8,0.6,0.2,0.8,0.11538461538461539,0.6
Jalili syndrome,32115,0,9,19,10,9,39,0,39,1.1111111111111112,0.0,0.5263157894736842,1.1111111111111112,0.0,0.0
Cone rod dystrophy,29580,3,15,17,10,7,17,5,12,0.6666666666666666,0.3333333333333333,0.5882352941176471,0.6666666666666666,0.29411764705882354,0.3333333333333333
Thanatophoric dysplasia type 1,30963,7,40,28,3,25,42,4,38,0.075,0.1,0.10714285714285714,0.075,0.09523809523809523,0.1
Skeletal dysplasia-epilepsy-short stature syndrome,28392,5,15,17,13,4,36,9,27,0.8666666666666667,0.6,0.7647058823529411,0.8666666666666667,0.25,0.6
Thoracic dysplasia-hydrocephalus syndrome,27969,0,13,16,12,4,23,0,23,0.9230769230769231,0.0,0.75,0.9230769230769231,0.0,0.0
Familial developmental dysphasia,29936,5,3,16,3,13,17,2,15,1.0,0.6666666666666666,0.1875,1.0,0.11764705882352941,0.6666666666666666
Kyphomelic dysplasia,31825,0,18,18,10,8,19,2,17,0.5555555555555556,0.1111111111111111,0.5555555555555556,0.5555555555555556,0.10526315789473684,0.1111111111111111
Ghosal hematodiaphyseal dysplasia,32156,1,13,17,9,8,26,1,25,0.6923076923076923,0.07692307692307693,0.5294117647058824,0.6923076923076923,0.038461538461538464,0.07692307692307693
Thoracomelic dysplasia,28177,4,18,21,3,18,37,1,36,0.16666666666666666,0.05555555555555555,0.14285714285714285,0.16666666666666666,0.02702702702702703,0.05555555555555555
"Acrofacial dysostosis, Rodríguez type",31874,0,20,20,9,11,20,0,20,0.45,0.0,0.45,0.45,0.0,0.0
Hypomandibular faciocranial dysostosis,29184,1,27,29,25,4,28,1,27,0.9259259259259259,0.037037037037037035,0.8620689655172413,0.9259259259259259,0.03571428571428571,0.037037037037037035
Oculomaxillofacial dysostosis,33546,0,21,19,21,-2,34,0,34,1.0,0.0,1.105263157894737,1.0,0.0,0.0
Craniofacial dysostosis-diaphyseal hyperplasia syndrome,27877,0,36,18,2,16,32,4,28,0.05555555555555555,0.1111111111111111,0.1111111111111111,0.05555555555555555,0.125,0.1111111111111111
Ectodermal dysplasia-intellectual disability-central nervous system malformation syndrome,30676,1,39,34,30,4,33,3,30,0.7692307692307693,0.07692307692307693,0.8823529411764706,0.7692307692307693,0.09090909090909091,0.07692307692307693
Epiphyseal dysplasia-hearing loss-dysmorphism syndrome,32946,2,25,19,18,1,37,3,34,0.72,0.12,0.9473684210526315,0.72,0.08108108108108109,0.12
Ectodermal dysplasia-blindness syndrome,30336,0,25,22,18,4,6,2,4,0.72,0.08,0.8181818181818182,0.72,0.3333333333333333,0.08
"Hidrotic ectodermal dysplasia, Christianson-Fourie type",27194,2,10,16,9,7,33,2,31,0.9,0.2,0.5625,0.9,0.06060606060606061,0.2
"Hidrotic ectodermal dysplasia, Halal type",32947,0,18,17,17,0,35,1,34,0.9444444444444444,0.05555555555555555,1.0,0.9444444444444444,0.02857142857142857,0.05555555555555555
Odontomicronychial dysplasia,29495,4,9,23,6,17,8,2,6,0.6666666666666666,0.2222222222222222,0.2608695652173913,0.6666666666666666,0.25,0.2222222222222222
Fibular dimelia-diplopodia syndrome,33416,5,3,15,2,13,14,0,14,0.6666666666666666,0.0,0.13333333333333333,0.6666666666666666,0.0,0.0
Caudal duplication,28997,0,15,19,9,10,3,0,3,0.6,0.0,0.47368421052631576,0.6,0.0,0.0
Arterial dissection-lentiginosis syndrome,31591,2,4,27,3,24,30,0,30,0.75,0.0,0.1111111111111111,0.75,0.0,0.0
Split cord malformation type I,94628,6,3,11,0,11,10,0,10,0.0,0.0,0.0,0.0,0.0,0.0
Wolcott-Rallison syndrome,30988,2,40,78,17,61,25,1,24,0.425,0.025,0.21794871794871795,0.425,0.04,0.025
Sporadic fetal brain disruption sequence,33403,0,10,23,8,15,22,1,21,0.8,0.1,0.34782608695652173,0.8,0.045454545454545456,0.1
X-linked corneal dermoid,30185,2,4,22,5,17,17,0,17,1.25,0.0,0.22727272727272727,1.25,0.0,0.0
Acrofrontofacionasal dysostosis,30415,0,29,39,21,18,58,1,57,0.7241379310344828,0.034482758620689655,0.5384615384615384,0.7241379310344828,0.017241379310344827,0.034482758620689655
Dysosteosclerosis,31109,0,22,19,3,16,37,0,37,0.13636363636363635,0.0,0.15789473684210525,0.13636363636363635,0.0,0.0
Thakker-Donnai syndrome,31482,0,25,30,23,7,22,0,22,0.92,0.0,0.7666666666666667,0.92,0.0,0.0
Dysequilibrium syndrome,31340,4,14,18,10,8,21,5,16,0.7142857142857143,0.35714285714285715,0.5555555555555556,0.7142857142857143,0.23809523809523808,0.35714285714285715
Retinal degeneration-nanophthalmos-glaucoma syndrome,32163,2,7,19,5,14,28,3,25,0.7142857142857143,0.42857142857142855,0.2631578947368421,0.7142857142857143,0.10714285714285714,0.42857142857142855
Hypotrichosis with juvenile macular degeneration,27196,2,15,21,13,8,32,2,30,0.8666666666666667,0.13333333333333333,0.6190476190476191,0.8666666666666667,0.0625,0.13333333333333333
Steroid dehydrogenase deficiency-dental anomalies syndrome,32251,8,4,28,3,25,17,0,17,0.75,0.0,0.10714285714285714,0.75,0.0,0.0
Transcobalamin deficiency,32067,7,12,19,0,19,20,0,20,0.0,0.0,0.0,0.0,0.0,0.0
Lipodystrophy due to peptidic growth factors deficiency,31568,3,28,22,19,3,38,4,34,0.6785714285714286,0.14285714285714285,0.8636363636363636,0.6785714285714286,0.10526315789473684,0.14285714285714285
Prolidase deficiency,31373,2,39,30,21,9,30,2,28,0.5384615384615384,0.05128205128205128,0.7,0.5384615384615384,0.06666666666666667,0.05128205128205128
Dermatoleukodystrophy,29383,1,6,16,5,11,31,1,30,0.8333333333333334,0.16666666666666666,0.3125,0.8333333333333334,0.03225806451612903,0.16666666666666666
Dermoodontodysplasia,31728,0,16,17,14,3,19,0,19,0.875,0.0,0.8235294117647058,0.875,0.0,0.0
"Dermatoosteolysis, Kirghizian type",31749,4,21,18,13,5,42,4,38,0.6190476190476191,0.19047619047619047,0.7222222222222222,0.6190476190476191,0.09523809523809523,0.19047619047619047
Absence of fingerprints-congenital milia syndrome,31543,2,9,16,8,8,21,2,19,0.8888888888888888,0.2222222222222222,0.5,0.8888888888888888,0.09523809523809523,0.2222222222222222
Dentin dysplasia,27987,6,4,15,3,12,25,2,23,0.75,0.5,0.2,0.75,0.08,0.5
1p36 deletion syndrome,32015,2,99,18,8,10,29,8,21,0.08080808080808081,0.08080808080808081,0.4444444444444444,0.08080808080808081,0.27586206896551724,0.08080808080808081
Oculocerebrocutaneous syndrome,29016,0,40,5,0,5,18,1,17,0.0,0.025,0.0,0.0,0.05555555555555555,0.025
Blepharo-cheilo-odontic syndrome,29329,1,15,18,6,12,36,2,34,0.4,0.13333333333333333,0.3333333333333333,0.4,0.05555555555555555,0.13333333333333333
Cleft lip-retinopathy syndrome,30251,2,4,19,0,19,21,1,20,0.0,0.25,0.0,0.0,0.047619047619047616,0.25
Cleft lip/palate-deafness-sacral lipoma syndrome,32551,7,13,23,11,12,31,2,29,0.8461538461538461,0.15384615384615385,0.4782608695652174,0.8461538461538461,0.06451612903225806,0.15384615384615385
Cleft lip/palate-intestinal malrotation-cardiopathy syndrome,28622,1,15,18,9,9,23,2,21,0.6,0.13333333333333333,0.5,0.6,0.08695652173913043,0.13333333333333333
Laryngotracheoesophageal cleft,32550,4,13,17,7,10,30,9,21,0.5384615384615384,0.6923076923076923,0.4117647058823529,0.5384615384615384,0.3,0.6923076923076923
Acrocardiofacial syndrome,28065,2,37,17,1,16,33,3,30,0.02702702702702703,0.08108108108108109,0.058823529411764705,0.02702702702702703,0.09090909090909091,0.08108108108108109
Alar cartilages hypoplasia-coloboma-telecanthus syndrome,31999,2,7,21,5,16,29,1,28,0.7142857142857143,0.14285714285714285,0.23809523809523808,0.7142857142857143,0.034482758620689655,0.14285714285714285
Cleft palate-large ears-small head syndrome,32054,2,19,17,14,3,18,2,16,0.7368421052631579,0.10526315789473684,0.8235294117647058,0.7368421052631579,0.1111111111111111,0.10526315789473684
Cleft palate-stapes fixation-oligodontia syndrome,30253,4,9,20,10,10,20,1,19,1.1111111111111112,0.1111111111111111,0.5,1.1111111111111112,0.05,0.1111111111111111
Fibrochondrogenesis,29636,0,29,48,22,26,18,0,18,0.7586206896551724,0.0,0.4583333333333333,0.7586206896551724,0.0,0.0
Femur-fibula-ulna complex,32544,0,14,21,7,14,42,0,42,0.5,0.0,0.3333333333333333,0.5,0.0,0.0
Hereditary gingival fibromatosis,32528,16,2,20,2,18,27,2,25,1.0,1.0,0.1,1.0,0.07407407407407407,1.0
Endocardial fibroelastosis,28131,0,16,18,13,5,20,0,20,0.8125,0.0,0.7222222222222222,0.8125,0.0,0.0
Epiphyseal stippling-osteoclastic hyperplasia syndrome,28971,5,10,18,0,18,29,1,28,0.0,0.1,0.0,0.0,0.034482758620689655,0.1
Congenital lethal erythroderma,31253,3,9,13,7,6,30,1,29,0.7777777777777778,0.1111111111111111,0.5384615384615384,0.7777777777777778,0.03333333333333333,0.1111111111111111
Exostoses-anetodermia-brachydactyly type E syndrome,28355,13,5,34,6,28,41,2,39,1.2,0.4,0.17647058823529413,1.2,0.04878048780487805,0.4
Extrasystoles-short stature-hyperpigmentation-microcephaly syndrome,31135,4,13,21,11,10,30,3,27,0.8461538461538461,0.23076923076923078,0.5238095238095238,0.8461538461538461,0.1,0.23076923076923078
Flat face-microstomia-ear anomaly syndrome,27433,2,32,31,19,12,25,2,23,0.59375,0.0625,0.6129032258064516,0.59375,0.08,0.0625
Facial dysmorphism-anorexia-cachexia-eye and skin anomalies syndrome,33098,2,21,18,18,0,22,3,19,0.8571428571428571,0.14285714285714285,1.0,0.8571428571428571,0.13636363636363635,0.14285714285714285
Facial dysmorphism-macrocephaly-myopia-Dandy-Walker malformation syndrome,29992,3,29,19,13,6,35,5,30,0.4482758620689655,0.1724137931034483,0.6842105263157895,0.4482758620689655,0.14285714285714285,0.1724137931034483
Lethal faciocardiomelic dysplasia,28934,1,15,19,13,6,33,0,33,0.8666666666666667,0.0,0.6842105263157895,0.8666666666666667,0.0,0.0
Faciocardiorenal syndrome,28065,0,14,17,1,16,37,0,37,0.07142857142857142,0.0,0.058823529411764705,0.07142857142857142,0.0,0.0
Autosomal recessive faciodigitogenital syndrome,31076,3,34,18,10,8,33,2,31,0.29411764705882354,0.058823529411764705,0.5555555555555556,0.29411764705882354,0.06060606060606061,0.058823529411764705
Bilateral striopallidodentate calcinosis,33092,4,11,20,10,10,39,1,38,0.9090909090909091,0.09090909090909091,0.5,0.9090909090909091,0.02564102564102564,0.09090909090909091
Femoral-facial syndrome,27536,1,36,25,9,16,37,0,37,0.25,0.0,0.36,0.25,0.0,0.0
Fetal trimethadione syndrome,33155,0,26,18,18,0,24,2,22,0.6923076923076923,0.07692307692307693,1.0,0.6923076923076923,0.08333333333333333,0.07692307692307693
Fetal hydantoin syndrome,33156,1,30,19,18,1,22,3,19,0.6,0.1,0.9473684210526315,0.6,0.13636363636363635,0.1
Fetal minoxidil syndrome,33130,4,8,20,5,15,29,0,29,0.625,0.0,0.25,0.625,0.0,0.0
Cocaine embryofetopathy,33157,9,8,17,5,12,24,1,23,0.625,0.125,0.29411764705882354,0.625,0.041666666666666664,0.125
Phenobarbital embryopathy,33129,0,16,18,12,6,39,0,39,0.75,0.0,0.6666666666666666,0.75,0.0,0.0
Fetal methylmercury syndrome,39044,11,5,27,4,23,39,4,35,0.8,0.8,0.14814814814814814,0.8,0.10256410256410256,0.8
Fetal cytomegalovirus syndrome,32421,9,20,23,7,16,26,6,20,0.35,0.3,0.30434782608695654,0.35,0.23076923076923078,0.3
Vitamin K antagonist embryofetopathy,33154,0,26,19,18,1,33,2,31,0.6923076923076923,0.07692307692307693,0.9473684210526315,0.6923076923076923,0.06060606060606061,0.07692307692307693
Emery-Nelson syndrome,28832,0,12,19,10,9,31,0,31,0.8333333333333334,0.0,0.5263157894736842,0.8333333333333334,0.0,0.0
Diabetic embryopathy,33136,0,32,17,16,1,16,1,15,0.5,0.03125,0.9411764705882353,0.5,0.0625,0.03125
Methimazole embryofetopathy,33137,0,13,11,2,9,18,1,17,0.15384615384615385,0.07692307692307693,0.18181818181818182,0.15384615384615385,0.05555555555555555,0.07692307692307693
Toluene embryopathy,33139,0,22,20,15,5,15,1,14,0.6818181818181818,0.045454545454545456,0.75,0.6818181818181818,0.06666666666666667,0.045454545454545456
Lowry-Wood syndrome,32128,2,21,18,16,2,34,2,32,0.7619047619047619,0.09523809523809523,0.8888888888888888,0.7619047619047619,0.058823529411764705,0.09523809523809523
Dysplasia epiphysealis hemimelica,29341,2,16,16,14,2,21,3,18,0.875,0.1875,0.875,0.875,0.14285714285714285,0.1875
Eng-Strom syndrome,30490,0,9,34,5,29,19,0,19,0.5555555555555556,0.0,0.14705882352941177,0.5555555555555556,0.0,0.0
Hypohidrotic ectodermal dysplasia-hypothyroidism-ciliary dyskinesia syndrome,31544,3,15,17,11,6,31,5,26,0.7333333333333333,0.3333333333333333,0.6470588235294118,0.7333333333333333,0.16129032258064516,0.3333333333333333
Congenital muscular dystrophy-infantile cataract-hypogonadism syndrome,28935,1,14,19,12,7,16,1,15,0.8571428571428571,0.07142857142857142,0.631578947368421,0.8571428571428571,0.0625,0.07142857142857142
Melorheostosis with osteopoikilosis,32937,9,7,23,4,19,28,0,28,0.5714285714285714,0.0,0.17391304347826086,0.5714285714285714,0.0,0.0
Focal facial dermal dysplasia type III,27910,3,23,26,9,17,27,4,23,0.391304347826087,0.17391304347826086,0.34615384615384615,0.391304347826087,0.14814814814814814,0.17391304347826086
Intellectual disability-spasticity-ectrodactyly syndrome,31474,4,9,18,8,10,20,2,18,0.8888888888888888,0.2222222222222222,0.4444444444444444,0.8888888888888888,0.1,0.2222222222222222
Leukomelanoderma-infantilism-intellectual disability-hypodontia-hypotrichosis syndrome,30799,5,16,16,13,3,30,4,26,0.8125,0.25,0.8125,0.8125,0.13333333333333333,0.25
"Ectodermal dysplasia, trichoodontoonychial type",27631,2,12,17,12,5,21,2,19,1.0,0.16666666666666666,0.7058823529411765,1.0,0.09523809523809523,0.16666666666666666
EEC syndrome,38130,0,61,30,2,28,21,0,21,0.03278688524590164,0.0,0.06666666666666667,0.03278688524590164,0.0,0.0
EEM syndrome,38130,7,16,35,1,34,31,2,29,0.0625,0.125,0.02857142857142857,0.0625,0.06451612903225806,0.125
Edinburgh malformation syndrome,31660,1,28,26,23,3,21,0,21,0.8214285714285714,0.0,0.8846153846153846,0.8214285714285714,0.0,0.0
Indomethacin embryofetopathy,33142,1,12,19,7,12,26,0,26,0.5833333333333334,0.0,0.3684210526315789,0.5833333333333334,0.0,0.0
Fetal iodine syndrome,30560,4,7,20,6,14,25,1,24,0.8571428571428571,0.14285714285714285,0.3,0.8571428571428571,0.04,0.14285714285714285
Fetal valproate spectrum disorder,33147,2,8,21,7,14,26,0,26,0.875,0.0,0.3333333333333333,0.875,0.0,0.0
Aminopterin/methotrexate embryofetopathy,33144,1,33,18,18,0,18,1,17,0.5454545454545454,0.030303030303030304,1.0,0.5454545454545454,0.05555555555555555,0.030303030303030304
Diaphragmatic defect-limb deficiency-skull defect syndrome,28516,2,16,20,14,6,31,3,28,0.875,0.1875,0.7,0.875,0.0967741935483871,0.1875
Donnai-Barrow syndrome,30192,1,28,17,14,3,28,2,26,0.5,0.07142857142857142,0.8235294117647058,0.5,0.07142857142857142,0.07142857142857142
"Craniosynostosis, Herrmann-Opitz type",33344,2,24,19,18,1,31,4,27,0.75,0.16666666666666666,0.9473684210526315,0.75,0.12903225806451613,0.16666666666666666
Nodular neuronal heterotopia,33343,1,3,20,3,17,5,1,4,1.0,0.3333333333333333,0.15,1.0,0.2,0.3333333333333333
Isolated hemihyperplasia,29808,0,12,19,6,13,8,0,8,0.5,0.0,0.3157894736842105,0.5,0.0,0.0
"46,XX ovotesticular difference of sex development",98421,11,14,35,7,28,43,6,37,0.5,0.42857142857142855,0.2,0.5,0.13953488372093023,0.42857142857142855
Short stature-craniofacial anomalies-genital hypoplasia syndrome,31087,3,28,19,13,6,22,3,19,0.4642857142857143,0.10714285714285714,0.6842105263157895,0.4642857142857143,0.13636363636363635,0.10714285714285714
HEC syndrome,28965,4,12,16,11,5,15,0,15,0.9166666666666666,0.0,0.6875,0.9166666666666666,0.0,0.0
Multifocal infantile hemangioma with extracutenous involvement,33357,4,19,21,13,8,38,3,35,0.6842105263157895,0.15789473684210525,0.6190476190476191,0.6842105263157895,0.07894736842105263,0.15789473684210525
Cystic hamartoma of lung and kidney,33365,10,5,17,5,12,24,1,23,1.0,0.2,0.29411764705882354,1.0,0.041666666666666664,0.2
"Hip dysplasia, Beukes type",28071,0,11,16,9,7,18,1,17,0.8181818181818182,0.09090909090909091,0.5625,0.8181818181818182,0.05555555555555555,0.09090909090909091
Harrod syndrome,30996,1,26,19,13,6,35,0,35,0.5,0.0,0.6842105263157895,0.5,0.0,0.0
Hall-Riggs syndrome,28970,0,29,18,11,7,18,0,18,0.3793103448275862,0.0,0.6111111111111112,0.3793103448275862,0.0,0.0
Dysmorphism-pectus carinatum-joint laxity syndrome,33369,6,11,24,11,13,13,0,13,1.0,0.0,0.4583333333333333,1.0,0.0,0.0
Hallux varus-preaxial polysyndactyly syndrome,28416,9,2,25,2,23,12,0,12,1.0,0.0,0.08,1.0,0.0,0.0
Hallermann-Streiff syndrome,28521,0,50,17,11,6,29,3,26,0.22,0.06,0.6470588235294118,0.22,0.10344827586206896,0.06
Greig cephalopolysyndactyly syndrome,30921,1,22,17,10,7,26,2,24,0.45454545454545453,0.09090909090909091,0.5882352941176471,0.45454545454545453,0.07692307692307693,0.09090909090909091
"Acromesomelic dysplasia, Grebe type",27236,6,18,19,3,16,35,3,32,0.16666666666666666,0.16666666666666666,0.15789473684210525,0.16666666666666666,0.08571428571428572,0.16666666666666666
Grubben-de Cock-Borghgraef syndrome,29312,0,15,21,14,7,16,0,16,0.9333333333333333,0.0,0.6666666666666666,0.9333333333333333,0.0,0.0
Gordon syndrome,31704,0,14,36,14,22,24,0,24,1.0,0.0,0.3888888888888889,1.0,0.0,0.0
Focal dermal hypoplasia,30209,1,69,14,4,10,25,4,21,0.057971014492753624,0.057971014492753624,0.2857142857142857,0.057971014492753624,0.16,0.057971014492753624
Grant syndrome,29736,0,25,27,23,4,35,0,35,0.92,0.0,0.8518518518518519,0.92,0.0,0.0
Gorlin-Chaudhry-Moss syndrome,28966,5,28,25,4,21,33,2,31,0.14285714285714285,0.07142857142857142,0.16,0.14285714285714285,0.06060606060606061,0.07142857142857142
Glaucoma-sleep apnea syndrome,33319,18,3,31,3,28,33,1,32,1.0,0.3333333333333333,0.0967741935483871,1.0,0.030303030303030304,0.3333333333333333
Glaucoma-ectopia lentis-microspherophakia-stiff joints-short stature syndrome,29851,3,3,25,2,23,32,3,29,0.6666666666666666,1.0,0.08,0.6666666666666666,0.09375,1.0
Multinodular goiter-cystic kidney-polydactyly syndrome,32166,6,5,18,6,12,34,0,34,1.2,0.0,0.3333333333333333,1.2,0.0,0.0
GMS syndrome,31863,0,13,20,13,7,25,0,25,1.0,0.0,0.65,1.0,0.0,0.0
Prominent glabella-microcephaly-hypogenitalism syndrome,29828,2,31,33,27,6,27,6,21,0.8709677419354839,0.1935483870967742,0.8181818181818182,0.8709677419354839,0.2222222222222222,0.1935483870967742
German syndrome,29369,0,32,17,15,2,32,0,32,0.46875,0.0,0.8823529411764706,0.46875,0.0,0.0
Geroderma osteodysplastica,27611,2,30,30,19,11,33,2,31,0.6333333333333333,0.06666666666666667,0.6333333333333333,0.6333333333333333,0.06060606060606061,0.06666666666666667
Gemignani syndrome,33323,0,13,16,11,5,21,0,21,0.8461538461538461,0.0,0.6875,0.8461538461538461,0.0,0.0
Genitopalatocardiac syndrome,30694,0,25,17,12,5,43,2,41,0.48,0.08,0.7058823529411765,0.48,0.046511627906976744,0.08
Gastrocutaneous syndrome,31240,0,13,16,10,6,13,0,13,0.7692307692307693,0.0,0.625,0.7692307692307693,0.0,0.0
Galloway-Mowat syndrome,31695,0,28,17,6,11,26,0,26,0.21428571428571427,0.0,0.35294117647058826,0.21428571428571427,0.0,0.0
GAPO syndrome,31188,0,54,70,43,27,17,0,17,0.7962962962962963,0.0,0.6142857142857143,0.7962962962962963,0.0,0.0
Splenogonadal fusion-limb defects-micrognathia syndrome,31220,4,28,28,26,2,27,6,21,0.9285714285714286,0.21428571428571427,0.9285714285714286,0.9285714285714286,0.2222222222222222,0.21428571428571427
Posterior fusion of lumbosacral vertebrae-blepharoptosis syndrome,30969,6,6,27,5,22,19,2,17,0.8333333333333334,0.3333333333333333,0.18518518518518517,0.8333333333333334,0.10526315789473684,0.3333333333333333
Blepharophimosis-ptosis-esotropia-syndactyly-short stature syndrome,31444,3,13,17,9,8,40,6,34,0.6923076923076923,0.46153846153846156,0.5294117647058824,0.6923076923076923,0.15,0.46153846153846156
Frontofacionasal dysplasia,28884,1,31,38,25,13,31,1,30,0.8064516129032258,0.03225806451612903,0.6578947368421053,0.8064516129032258,0.03225806451612903,0.03225806451612903
Foix-Chavany-Marie syndrome,32510,1,8,16,7,9,30,1,29,0.875,0.125,0.4375,0.875,0.03333333333333333,0.125
Flynn-Aird syndrome,29170,0,30,17,14,3,19,0,19,0.4666666666666667,0.0,0.8235294117647058,0.4666666666666667,0.0,0.0
FLOTCH syndrome,32512,0,9,19,11,8,20,0,20,1.2222222222222223,0.0,0.5789473684210527,1.2222222222222223,0.0,0.0
Paraplegia-intellectual disability-hyperkeratosis syndrome,28093,1,21,17,13,4,41,2,39,0.6190476190476191,0.09523809523809523,0.7647058823529411,0.6190476190476191,0.04878048780487805,0.09523809523809523
Scalp-ear-nipple syndrome,29732,2,25,28,10,18,27,2,25,0.4,0.08,0.35714285714285715,0.4,0.07407407407407407,0.08
Hepatic fibrosis-renal cysts-intellectual disability syndrome,29626,3,29,16,15,1,38,5,33,0.5172413793103449,0.1724137931034483,0.9375,0.5172413793103449,0.13157894736842105,0.1724137931034483
Juvenile hyaline fibromatosis,32527,2,16,16,15,1,41,3,38,0.9375,0.1875,0.9375,0.9375,0.07317073170731707,0.1875
Gingival fibromatosis-progressive deafness syndrome,28133,5,4,33,4,29,30,1,29,1.0,0.25,0.12121212121212122,1.0,0.03333333333333333,0.25
Gingival fibromatosis-hypertrichosis syndrome,31207,2,13,17,13,4,29,3,26,1.0,0.23076923076923078,0.7647058823529411,1.0,0.10344827586206896,0.23076923076923078
Gingival fibromatosis-facial dysmorphism syndrome,30641,2,14,17,14,3,33,2,31,1.0,0.14285714285714285,0.8235294117647058,1.0,0.06060606060606061,0.14285714285714285
Macrosomia-microphthalmia-cleft palate syndrome,29257,0,11,22,10,12,17,1,16,0.9090909090909091,0.09090909090909091,0.45454545454545453,0.9090909090909091,0.058823529411764705,0.09090909090909091
Hypo- and hypermelanotic cutaneous macules-retarded growth-intellectual disability syndrome,33239,8,8,23,6,17,18,3,15,0.75,0.375,0.2608695652173913,0.75,0.16666666666666666,0.375
Ollier disease,28727,1,26,16,12,4,34,1,33,0.46153846153846156,0.038461538461538464,0.75,0.46153846153846156,0.029411764705882353,0.038461538461538464
Hand-foot-genital syndrome,30965,0,25,32,20,12,20,0,20,0.8,0.0,0.625,0.8,0.0,0.0
Isolated split hand-split foot malformation,28928,0,8,24,2,22,16,2,14,0.25,0.25,0.08333333333333333,0.25,0.125,0.25
Familial supernumerary nipples,30638,3,2,8,1,7,11,1,10,0.5,0.5,0.125,0.5,0.09090909090909091,0.5
McDonough syndrome,31525,0,27,33,21,12,14,0,14,0.7777777777777778,0.0,0.6363636363636364,0.7777777777777778,0.0,0.0
Laurin-Sandrow syndrome,29707,0,28,32,25,7,15,0,15,0.8928571428571429,0.0,0.78125,0.8928571428571429,0.0,0.0
Early-onset parkinsonism-intellectual disability syndrome,28974,4,9,18,10,8,22,2,20,1.1111111111111112,0.2222222222222222,0.5555555555555556,1.1111111111111112,0.09090909090909091,0.2222222222222222
Leukonychia totalis,33008,3,8,22,8,14,4,1,3,1.0,0.125,0.36363636363636365,1.0,0.25,0.125
Lowe-Kohn-Cohen syndrome,33245,14,5,20,3,17,29,0,29,0.6,0.0,0.15,0.6,0.0,0.0
Dislocation of the hip-dysmorphism syndrome,30455,1,20,22,15,7,13,1,12,0.75,0.05,0.6818181818181818,0.75,0.07692307692307693,0.05
Macrocephaly-spastic paraplegia-dysmorphism syndrome,31371,4,24,32,22,10,28,5,23,0.9166666666666666,0.20833333333333334,0.6875,0.9166666666666666,0.17857142857142858,0.20833333333333334
Kabuki syndrome,31000,2,92,23,14,9,35,9,26,0.15217391304347827,0.09782608695652174,0.6086956521739131,0.15217391304347827,0.2571428571428571,0.09782608695652174
"Diffuse palmoplantar keratoderma, Bothnian type",30262,6,10,8,0,8,11,0,11,0.0,0.0,0.0,0.0,0.0,0.0
Epidermolysis bullosa simplex with anodontia/hypodontia,33042,1,19,17,17,0,8,1,7,0.8947368421052632,0.05263157894736842,1.0,0.8947368421052632,0.125,0.05263157894736842
Keratoderma hereditarium mutilans,27163,3,17,18,10,8,27,3,24,0.5882352941176471,0.17647058823529413,0.5555555555555556,0.5882352941176471,0.1111111111111111,0.17647058823529413
"Familial partial lipodystrophy, Dunnigan type",27788,0,34,18,10,8,14,0,14,0.29411764705882354,0.0,0.5555555555555556,0.29411764705882354,0.0,0.0
Congenital velopharyngeal incompetence,28838,8,5,23,7,16,30,0,30,1.4,0.0,0.30434782608695654,1.4,0.0,0.0
Isotretinoin syndrome,27758,0,12,19,3,16,7,0,7,0.25,0.0,0.15789473684210525,0.25,0.0,0.0
Absence deformity of leg-cataract syndrome,27847,0,9,19,8,11,10,0,10,0.8888888888888888,0.0,0.42105263157894735,0.8888888888888888,0.0,0.0
Johanson-Blizzard syndrome,29262,3,37,17,12,5,50,5,45,0.32432432432432434,0.13513513513513514,0.7058823529411765,0.32432432432432434,0.1,0.13513513513513514
Harlequin ichthyosis,27513,0,18,17,7,10,25,2,23,0.3888888888888889,0.1111111111111111,0.4117647058823529,0.3888888888888889,0.08,0.1111111111111111
Fused mandibular incisors,32105,5,2,15,3,12,17,1,16,1.5,0.5,0.2,1.5,0.058823529411764705,0.5
Neuronal intranuclear inclusion disease,29217,5,18,18,9,9,25,7,18,0.5,0.3888888888888889,0.5,0.5,0.28,0.3888888888888889
Familial isolated hypoparathyroidism,29404,2,12,19,10,9,27,0,27,0.8333333333333334,0.0,0.5263157894736842,0.8333333333333334,0.0,0.0
Megacystis-microcolon-intestinal hypoperistalsis syndrome,29763,2,17,15,11,4,20,4,16,0.6470588235294118,0.23529411764705882,0.7333333333333333,0.6470588235294118,0.2,0.23529411764705882
Hypodontia-dysplasia of nails syndrome,27360,4,16,19,16,3,15,2,13,1.0,0.125,0.8421052631578947,1.0,0.13333333333333333,0.125
Dilated cardiomyopathy-hypergonadotropic hypogonadism syndrome,31362,3,7,25,4,21,12,0,12,0.5714285714285714,0.0,0.16,0.5714285714285714,0.0,0.0
Fibulo-ulnar hypoplasia-renal anomalies syndrome,29840,0,22,21,13,8,17,2,15,0.5909090909090909,0.09090909090909091,0.6190476190476191,0.5909090909090909,0.11764705882352941,0.09090909090909091
Primary pulmonary hypoplasia,27835,4,26,18,17,1,32,5,27,0.6538461538461539,0.19230769230769232,0.9444444444444444,0.6538461538461539,0.15625,0.19230769230769232
Cerebellar hypoplasia-tapetoretinal degeneration syndrome,33517,2,9,22,9,13,12,4,8,1.0,0.4444444444444444,0.4090909090909091,1.0,0.3333333333333333,0.4444444444444444
Radial hypoplasia-triphalangeal thumbs-hypospadias-maxillary diastema syndrome,29311,7,6,21,6,15,31,1,30,1.0,0.16666666666666666,0.2857142857142857,1.0,0.03225806451612903,0.16666666666666666
Primary hypomagnesemia with hypercalciuria and nephrocalcinosis with severe ocular involvement,27583,2,11,18,6,12,29,0,29,0.5454545454545454,0.0,0.3333333333333333,0.5454545454545454,0.0,0.0
Hypertrichosis lanuginosa congenita,33530,3,7,16,1,15,16,1,15,0.14285714285714285,0.14285714285714285,0.0625,0.14285714285714285,0.0625,0.14285714285714285
Maternal hyperthermia-induced birth defects,33536,1,16,17,15,2,32,1,31,0.9375,0.0625,0.8823529411764706,0.9375,0.03125,0.0625
Focal palmoplantar and gingival keratoderma,31528,5,9,13,9,4,12,3,9,1.0,0.3333333333333333,0.6923076923076923,1.0,0.25,0.3333333333333333
Histidinuria-renal tubular defect syndrome,31498,0,14,17,13,4,30,0,30,0.9285714285714286,0.0,0.7647058823529411,0.9285714285714286,0.0,0.0
Holzgreve syndrome,30186,0,21,18,13,5,23,0,23,0.6190476190476191,0.0,0.7222222222222222,0.6190476190476191,0.0,0.0
Holoprosencephaly-postaxial polydactyly syndrome,28950,1,36,26,18,8,31,2,29,0.5,0.05555555555555555,0.6923076923076923,0.5,0.06451612903225806,0.05555555555555555
Holoprosencephaly-caudal dysgenesis syndrome,33338,2,16,23,10,13,29,1,28,0.625,0.0625,0.43478260869565216,0.625,0.034482758620689655,0.0625
Holoprosencephaly-craniosynostosis syndrome,28771,2,21,17,17,0,17,2,15,0.8095238095238095,0.09523809523809523,1.0,0.8095238095238095,0.11764705882352941,0.09523809523809523
Orofaciodigital syndrome type 1,27672,2,65,31,11,20,60,6,54,0.16923076923076924,0.09230769230769231,0.3548387096774194,0.16923076923076924,0.1,0.09230769230769231
OSLAM syndrome,30657,0,7,28,5,23,22,0,22,0.7142857142857143,0.0,0.17857142857142858,0.7142857142857143,0.0,0.0
Progressive osseous heteroplasia,29358,1,12,18,11,7,23,1,22,0.9166666666666666,0.08333333333333333,0.6111111111111112,0.9166666666666666,0.043478260869565216,0.08333333333333333
Blount disease,31308,9,5,18,2,16,26,1,25,0.4,0.2,0.1111111111111111,0.4,0.038461538461538464,0.2
Olivopontocerebellar atrophy-deafness syndrome,28400,1,14,18,12,6,15,3,12,0.8571428571428571,0.21428571428571427,0.6666666666666666,0.8571428571428571,0.2,0.21428571428571427
Congenital central hypoventilation syndrome,31618,3,10,19,6,13,21,2,19,0.6,0.2,0.3157894736842105,0.6,0.09523809523809523,0.2
Ophthalmomandibulomelic dysplasia,31552,0,19,19,13,6,38,0,38,0.6842105263157895,0.0,0.6842105263157895,0.6842105263157895,0.0,0.0
"Oculocerebral hypopigmentation syndrome, Preus type",29864,0,26,25,20,5,28,5,23,0.7692307692307693,0.19230769230769232,0.8,0.7692307692307693,0.17857142857142858,0.19230769230769232
Odonto-onycho dysplasia-alopecia syndrome,29598,1,11,21,6,15,48,2,46,0.5454545454545454,0.18181818181818182,0.2857142857142857,0.5454545454545454,0.041666666666666664,0.18181818181818182
Odontomatosis-aortae esophagus stenosis syndrome,30421,1,6,19,6,13,28,0,28,1.0,0.0,0.3157894736842105,1.0,0.0,0.0
Severe oculo-renal-cerebellar syndrome,29536,2,29,17,13,4,25,2,23,0.4482758620689655,0.06896551724137931,0.7647058823529411,0.4482758620689655,0.08,0.06896551724137931
Oculotrichoanal syndrome,29910,1,10,18,9,9,26,0,26,0.9,0.0,0.5,0.9,0.0,0.0
"Oculocerebral hypopigmentation syndrome, Cross type",29864,1,45,26,11,15,26,8,18,0.24444444444444444,0.17777777777777778,0.4230769230769231,0.24444444444444444,0.3076923076923077,0.17777777777777778
Annular pancreas,30446,11,3,17,1,16,21,0,21,0.3333333333333333,0.0,0.058823529411764705,0.3333333333333333,0.0,0.0
Pachygyria-intellectual disability-epilepsy syndrome,31861,7,4,19,4,15,24,0,24,1.0,0.0,0.21052631578947367,1.0,0.0,0.0
Papillon-Lefèvre syndrome,31186,2,29,16,18,-2,22,3,19,0.6206896551724138,0.10344827586206896,1.125,0.6206896551724138,0.13636363636363635,0.10344827586206896
Papilloma of choroid plexus,30230,6,9,18,8,10,17,3,14,0.8888888888888888,0.3333333333333333,0.4444444444444444,0.8888888888888888,0.17647058823529413,0.3333333333333333
Otofaciocervical syndrome,28403,0,23,36,20,16,20,0,20,0.8695652173913043,0.0,0.5555555555555556,0.8695652173913043,0.0,0.0
"Endosteal hyperostosis, Worth type",31190,0,13,26,1,25,13,0,13,0.07692307692307693,0.0,0.038461538461538464,0.07692307692307693,0.0,0.0
Pachydermoperiostosis,29236,2,41,25,2,23,36,2,34,0.04878048780487805,0.04878048780487805,0.08,0.04878048780487805,0.05555555555555555,0.04878048780487805
Otoonychoperoneal syndrome,30165,0,13,19,9,10,12,0,12,0.6923076923076923,0.0,0.47368421052631576,0.6923076923076923,0.0,0.0
Osteopathia striata-pigmentary dermopathy-white forelock syndrome,32370,2,7,21,5,16,34,1,33,0.7142857142857143,0.14285714285714285,0.23809523809523808,0.7142857142857143,0.029411764705882353,0.14285714285714285
Multicentric carpo-tarsal osteolysis with or without nephropathy,28040,3,21,25,19,6,20,4,16,0.9047619047619048,0.19047619047619047,0.76,0.9047619047619048,0.2,0.19047619047619047
Nasu-Hakola disease,32371,0,28,17,16,1,18,0,18,0.5714285714285714,0.0,0.9411764705882353,0.5714285714285714,0.0,0.0
Osteomesopyknosis,28316,0,7,11,6,5,32,1,31,0.8571428571428571,0.14285714285714285,0.5454545454545454,0.8571428571428571,0.03125,0.14285714285714285
Autosomal recessive distal osteolysis syndrome,27419,1,9,17,7,10,31,2,29,0.7777777777777778,0.2222222222222222,0.4117647058823529,0.7777777777777778,0.06451612903225806,0.2222222222222222
Short stature-valvular heart disease-characteristic facies syndrome,30765,2,14,16,10,6,32,1,31,0.7142857142857143,0.07142857142857142,0.625,0.7142857142857143,0.03125,0.07142857142857142
Phakomatosis pigmentovascularis,32602,1,14,18,12,6,31,0,31,0.8571428571428571,0.0,0.6666666666666666,0.8571428571428571,0.0,0.0
Short stature-wormian bones-dextrocardia syndrome,32606,4,25,21,21,0,33,4,29,0.84,0.16,1.0,0.84,0.12121212121212122,0.16
Short stature-deafness-neutrophil dysfunction-dysmorphism syndrome,32605,8,8,30,4,26,27,1,26,0.5,0.125,0.13333333333333333,0.5,0.037037037037037035,0.125
Alopecia-intellectual disability syndrome,30393,2,24,17,5,12,19,4,15,0.20833333333333334,0.16666666666666666,0.29411764705882354,0.20833333333333334,0.21052631578947367,0.16666666666666666
Pelvic dysplasia-arthrogryposis of lower limbs syndrome,31333,5,10,21,9,12,46,1,45,0.9,0.1,0.42857142857142855,0.9,0.021739130434782608,0.1
Penoscrotal transposition,32416,3,20,17,15,2,11,3,8,0.75,0.15,0.8823529411764706,0.75,0.2727272727272727,0.15
PEHO syndrome,31464,1,42,59,40,19,38,2,36,0.9523809523809523,0.047619047619047616,0.6779661016949152,0.9523809523809523,0.05263157894736842,0.047619047619047616
Stiff skin syndrome,27904,2,20,15,11,4,20,1,19,0.55,0.05,0.7333333333333333,0.55,0.05,0.05
Pectus excavatum-macrocephaly-dysplastic nails syndrome,27564,1,15,16,15,1,3,1,2,1.0,0.06666666666666667,0.9375,1.0,0.3333333333333333,0.06666666666666667
Spastic paraparesis-deafness syndrome,31889,2,13,19,10,9,20,2,18,0.7692307692307693,0.15384615384615385,0.5263157894736842,0.7692307692307693,0.1,0.15384615384615385
Laryngeal abductor paralysis,28645,8,2,20,2,18,24,0,24,1.0,0.0,0.1,1.0,0.0,0.0
Parana hard skin syndrome,30260,0,12,16,13,3,9,0,9,1.0833333333333333,0.0,0.8125,1.0833333333333333,0.0,0.0
"Renal agenesis, bilateral",99177,8,18,23,1,22,19,0,19,0.05555555555555555,0.0,0.043478260869565216,0.05555555555555555,0.0,0.0
Porencephaly,28067,1,8,17,8,9,13,1,12,1.0,0.125,0.47058823529411764,1.0,0.07692307692307693,0.125
Crossed polysyndactyly,28302,1,11,18,11,7,27,2,25,1.0,0.18181818181818182,0.6111111111111112,1.0,0.07407407407407407,0.18181818181818182
Cronkhite-Canada syndrome,29668,0,33,42,29,13,14,1,13,0.8787878787878788,0.030303030303030304,0.6904761904761905,0.8787878787878788,0.07142857142857142,0.030303030303030304
Polyneuropathy-intellectual disability-acromicria-premature menopause syndrome,33274,3,16,17,14,3,37,2,35,0.875,0.125,0.8235294117647058,0.875,0.05405405405405406,0.125
Isolated polycystic liver disease,27247,3,22,16,11,5,17,4,13,0.5,0.18181818181818182,0.6875,0.5,0.23529411764705882,0.18181818181818182
Postaxial polydactyly-dental and vertebral anomalies syndrome,31601,1,29,27,22,5,35,3,32,0.7586206896551724,0.10344827586206896,0.8148148148148148,0.7586206896551724,0.08571428571428572,0.10344827586206896
Poland syndrome,30463,4,58,49,42,7,23,1,22,0.7241379310344828,0.017241379310344827,0.8571428571428571,0.7241379310344828,0.043478260869565216,0.017241379310344827
Hereditary acrokeratotic poikiloderma,38421,16,47,32,4,28,23,2,21,0.0851063829787234,0.0425531914893617,0.125,0.0851063829787234,0.08695652173913043,0.0425531914893617
Pili torti-developmental delay-neurological abnormalities syndrome,30006,2,10,23,10,13,17,2,15,1.0,0.2,0.43478260869565216,1.0,0.11764705882352941,0.2
Pili torti,28034,3,9,16,9,7,16,3,13,1.0,0.3333333333333333,0.5625,1.0,0.1875,0.3333333333333333
Piebald trait-neurologic defects syndrome,31849,3,14,16,12,4,26,3,23,0.8571428571428571,0.21428571428571427,0.75,0.8571428571428571,0.11538461538461539,0.21428571428571427
Piebaldism,30388,6,19,17,14,3,31,7,24,0.7368421052631579,0.3684210526315789,0.8235294117647058,0.7368421052631579,0.22580645161290322,0.3684210526315789
"Phocomelia, Schinzel type",28522,2,31,25,9,16,26,2,24,0.2903225806451613,0.06451612903225806,0.36,0.2903225806451613,0.07692307692307693,0.06451612903225806
Lower limb malformation-hypospadias syndrome,33217,3,12,18,9,9,15,1,14,0.75,0.08333333333333333,0.5,0.75,0.06666666666666667,0.08333333333333333
Upper limb defect-eye and ear abnormalities syndrome,30812,5,12,21,10,11,32,2,30,0.8333333333333334,0.16666666666666666,0.47619047619047616,0.8333333333333334,0.0625,0.16666666666666666
Müllerian duct anomalies-limb anomalies syndrome,31835,5,14,16,12,4,24,4,20,0.8571428571428571,0.2857142857142857,0.75,0.8571428571428571,0.16666666666666666,0.2857142857142857
"Upper limb mesomelic dysplasia, type Fryns",27318,0,3,20,3,17,25,0,25,1.0,0.0,0.15,1.0,0.0,0.0
Acrogeria,32773,2,19,19,18,1,20,4,16,0.9473684210526315,0.21052631578947367,0.9473684210526315,0.9473684210526315,0.2,0.21052631578947367
McKusick-Kaufman syndrome,30059,0,28,18,13,5,10,0,10,0.4642857142857143,0.0,0.7222222222222222,0.4642857142857143,0.0,0.0
White forelock with malformations,31091,1,19,23,14,9,26,1,25,0.7368421052631579,0.05263157894736842,0.6086956521739131,0.7368421052631579,0.038461538461538464,0.05263157894736842
Dysraphism-cleft lip/palate-limb reduction defects syndrome,33221,8,9,32,6,26,57,1,56,0.6666666666666666,0.1111111111111111,0.1875,0.6666666666666666,0.017543859649122806,0.1111111111111111
Megalencephaly,28361,5,16,16,2,14,10,2,8,0.125,0.125,0.125,0.125,0.2,0.125
Megalocornea-intellectual disability syndrome,27212,4,41,21,16,5,24,6,18,0.3902439024390244,0.14634146341463414,0.7619047619047619,0.3902439024390244,0.25,0.14634146341463414
Neurocutaneous melanocytosis,28180,2,46,17,13,4,38,5,33,0.2826086956521739,0.10869565217391304,0.7647058823529411,0.2826086956521739,0.13157894736842105,0.10869565217391304
Melkersson-Rosenthal syndrome,30833,2,14,17,14,3,24,1,23,1.0,0.07142857142857142,0.8235294117647058,1.0,0.041666666666666664,0.07142857142857142
Microcephaly-deafness-intellectual disability syndrome,31460,3,15,17,12,5,31,2,29,0.8,0.13333333333333333,0.7058823529411765,0.8,0.06451612903225806,0.13333333333333333
Oculoauriculovertebral spectrum with radial defects,30140,0,31,28,25,3,22,0,22,0.8064516129032258,0.0,0.8928571428571429,0.8064516129032258,0.0,0.0
Microcornea-glaucoma-absent frontal sinuses syndrome,31470,1,10,15,9,6,37,1,36,0.9,0.1,0.6,0.9,0.02702702702702703,0.1
Spastic ataxia-corneal dystrophy syndrome,29469,5,12,16,11,5,23,5,18,0.9166666666666666,0.4166666666666667,0.6875,0.9166666666666666,0.21739130434782608,0.4166666666666667
Lethal intrauterine growth restriction-cortical malformation-congenital contractures syndrome,30844,5,24,19,6,13,37,4,33,0.25,0.16666666666666666,0.3157894736842105,0.25,0.10810810810810811,0.16666666666666666
Moynahan syndrome,30362,5,10,20,8,12,22,2,20,0.8,0.2,0.4,0.8,0.09090909090909091,0.2
Moyamoya disease,29366,4,5,18,4,14,41,0,41,0.8,0.0,0.2222222222222222,0.8,0.0,0.0
Corpus callosum agenesis-abnormal genitalia syndrome,31429,1,21,17,2,15,29,0,29,0.09523809523809523,0.0,0.11764705882352941,0.09523809523809523,0.0,0.0
Multiple benign circumferential skin creases on limbs,27906,3,30,26,1,25,16,4,12,0.03333333333333333,0.13333333333333333,0.038461538461538464,0.03333333333333333,0.25,0.13333333333333333
Autosomal dominant primary microcephaly,27182,1,6,94,5,89,10,1,9,0.8333333333333334,0.16666666666666666,0.05319148936170213,0.8333333333333334,0.1,0.16666666666666666
Micro syndrome,32037,0,42,18,4,14,25,0,25,0.09523809523809523,0.0,0.2222222222222222,0.09523809523809523,0.0,0.0
Microcephaly-cervical spine fusion anomalies syndrome,28141,3,26,20,13,7,29,3,26,0.5,0.11538461538461539,0.65,0.5,0.10344827586206896,0.11538461538461539
Autosomal recessive chorioretinopathy-microcephaly syndrome,30010,6,22,24,7,17,24,4,20,0.3181818181818182,0.18181818181818182,0.2916666666666667,0.3181818181818182,0.16666666666666666,0.18181818181818182
"Microcephaly-microcornea syndrome, Seemanova type",32766,4,15,26,12,14,21,4,17,0.8,0.26666666666666666,0.46153846153846156,0.8,0.19047619047619047,0.26666666666666666
Langer mesomelic dysplasia,27632,1,13,22,12,10,37,2,35,0.9230769230769231,0.15384615384615385,0.5454545454545454,0.9230769230769231,0.05405405405405406,0.15384615384615385
"Mesomelic dysplasia, Nievergelt type",38211,9,26,32,4,28,37,5,32,0.15384615384615385,0.19230769230769232,0.125,0.15384615384615385,0.13513513513513514,0.19230769230769232
"Microcephalic primordial dwarfism, Montreal type",30346,2,30,45,5,40,26,4,22,0.16666666666666666,0.13333333333333333,0.1111111111111111,0.16666666666666666,0.15384615384615385,0.13333333333333333
Mesomelic dwarfism-cleft palate-camptodactyly syndrome,30137,2,17,22,17,5,31,2,29,1.0,0.11764705882352941,0.7727272727272727,1.0,0.06451612903225806,0.11764705882352941
"Microcephalic primordial dwarfism, Toriello type",30346,1,18,38,14,24,12,2,10,0.7777777777777778,0.1111111111111111,0.3684210526315789,0.7777777777777778,0.16666666666666666,0.1111111111111111
Osteoglosphonic dysplasia,27306,3,20,24,4,20,43,2,41,0.2,0.1,0.16666666666666666,0.2,0.046511627906976744,0.1
"Mesomelic dwarfism, Reinhardt-Pfeiffer type",27612,0,13,15,12,3,33,2,31,0.9230769230769231,0.15384615384615385,0.8,0.9230769230769231,0.06060606060606061,0.15384615384615385
Mayer-Rokitansky-Küster-Hauser syndrome type 2,30327,0,12,22,1,21,35,2,33,0.08333333333333333,0.16666666666666666,0.045454545454545456,0.08333333333333333,0.05714285714285714,0.16666666666666666
Muckle-Wells syndrome,29681,4,37,19,16,3,31,6,25,0.43243243243243246,0.16216216216216217,0.8421052631578947,0.43243243243243246,0.1935483870967742,0.16216216216216217
Mulibrey nanism,27480,3,9,18,6,12,25,1,24,0.6666666666666666,0.1111111111111111,0.3333333333333333,0.6666666666666666,0.04,0.1111111111111111
3M syndrome,27584,0,42,17,8,9,6,0,6,0.19047619047619047,0.0,0.47058823529411764,0.19047619047619047,0.0,0.0
Ataxia-pancytopenia syndrome,31519,5,18,27,17,10,16,5,11,0.9444444444444444,0.2777777777777778,0.6296296296296297,0.9444444444444444,0.3125,0.2777777777777778
Noonan syndrome-like disorder with loose anagen hair,29750,6,29,63,23,40,30,5,25,0.7931034482758621,0.1724137931034483,0.36507936507936506,0.7931034482758621,0.16666666666666666,0.1724137931034483
Knuckle pads-leukonychia-sensorineural deafness-palmoplantar hyperkeratosis syndrome,29543,9,7,20,5,15,33,3,30,0.7142857142857143,0.42857142857142855,0.25,0.7142857142857143,0.09090909090909091,0.42857142857142855
Bifid nose,31368,4,2,17,0,17,11,0,11,0.0,0.0,0.0,0.0,0.0,0.0
Neutropenia-monocytopenia-deafness syndrome,32876,11,4,26,5,21,38,3,35,1.25,0.75,0.19230769230769232,1.25,0.07894736842105263,0.75
Oculofaciocardiodental syndrome,28065,1,43,17,2,15,26,1,25,0.046511627906976744,0.023255813953488372,0.11764705882352941,0.046511627906976744,0.038461538461538464,0.023255813953488372
Oculodentodigital dysplasia,27953,2,83,37,8,29,35,13,22,0.0963855421686747,0.1566265060240964,0.21621621621621623,0.0963855421686747,0.37142857142857144,0.1566265060240964
Urofacial syndrome,31625,0,11,19,4,15,11,0,11,0.36363636363636365,0.0,0.21052631578947367,0.36363636363636365,0.0,0.0
Nephropathy-deafness-hyperparathyroidism syndrome,27435,7,8,23,6,17,27,3,24,0.75,0.375,0.2608695652173913,0.75,0.1111111111111111,0.375
Nathalie syndrome,29787,0,4,23,3,20,32,0,32,0.75,0.0,0.13043478260869565,0.75,0.0,0.0
Keipert syndrome,28646,0,24,43,19,24,26,1,25,0.7916666666666666,0.041666666666666664,0.4418604651162791,0.7916666666666666,0.038461538461538464,0.041666666666666664
Neurofaciodigitorenal syndrome,27267,2,30,24,17,7,41,3,38,0.5666666666666667,0.1,0.7083333333333334,0.5666666666666667,0.07317073170731707,0.1
Renal coloboma syndrome,32095,1,14,17,4,13,33,3,30,0.2857142857142857,0.21428571428571427,0.23529411764705882,0.2857142857142857,0.09090909090909091,0.21428571428571427
Tetraamelia-multiple malformations syndrome,32572,0,35,18,16,2,39,0,39,0.45714285714285713,0.0,0.8888888888888888,0.45714285714285713,0.0,0.0
Thalidomide embryopathy,32567,0,17,16,14,2,29,1,28,0.8235294117647058,0.058823529411764705,0.875,0.8235294117647058,0.034482758620689655,0.058823529411764705
Radioulnar synostosis-microcephaly-scoliosis syndrome,32302,2,19,16,15,1,37,6,31,0.7894736842105263,0.3157894736842105,0.9375,0.7894736842105263,0.16216216216216217,0.3157894736842105
Radioulnar synostosis-developmental delay-hypotonia syndrome,32091,1,20,20,16,4,41,5,36,0.8,0.25,0.8,0.8,0.12195121951219512,0.25
Weismann-Netter syndrome,31816,0,20,23,16,7,23,0,23,0.8,0.0,0.6956521739130435,0.8,0.0,0.0
Trichodermodysplasia-dental alterations syndrome,32530,0,19,17,16,1,20,0,20,0.8421052631578947,0.0,0.9411764705882353,0.8421052631578947,0.0,0.0
Thomas syndrome,32564,4,11,21,7,14,20,0,20,0.6363636363636364,0.0,0.3333333333333333,0.6363636363636364,0.0,0.0
"Thiemann disease, familial form",31503,3,5,24,4,20,36,0,36,0.8,0.0,0.16666666666666666,0.8,0.0,0.0
Tibial aplasia-ectrodactyly syndrome,32560,2,18,15,14,1,20,2,18,0.7777777777777778,0.1111111111111111,0.9333333333333333,0.7777777777777778,0.1,0.1111111111111111
Hoyeraal-Hreidarsson syndrome,32562,0,28,17,17,0,24,0,24,0.6071428571428571,0.0,1.0,0.6071428571428571,0.0,0.0
Trismus-pseudocamptodactyly syndrome,30181,1,7,18,6,12,18,0,18,0.8571428571428571,0.0,0.3333333333333333,0.8571428571428571,0.0,0.0
Urban-Rogers-Meyer syndrome,29639,0,28,18,15,3,28,0,28,0.5357142857142857,0.0,0.8333333333333334,0.5357142857142857,0.0,0.0
Hyperostosis corticalis generalisata,29653,2,8,15,6,9,35,2,33,0.75,0.25,0.4,0.75,0.05714285714285714,0.25
Trichodysplasia-xeroderma syndrome,31096,1,10,27,8,19,27,0,27,0.8,0.0,0.2962962962962963,0.8,0.0,0.0
Non-syndromic metopic craniosynostosis,27344,4,12,22,0,22,42,1,41,0.0,0.08333333333333333,0.0,0.0,0.023809523809523808,0.08333333333333333
Autoimmune polyendocrinopathy type 1,27834,2,19,17,7,10,35,0,35,0.3684210526315789,0.0,0.4117647058823529,0.3684210526315789,0.0,0.0
Wieacker-Wolff syndrome,38849,0,14,30,0,30,18,0,18,0.0,0.0,0.0,0.0,0.0,0.0
Wildervanck syndrome,31224,1,11,16,9,7,25,0,25,0.8181818181818182,0.0,0.5625,0.8181818181818182,0.0,0.0
Worster-Drought syndrome,28437,1,18,19,5,14,23,0,23,0.2777777777777778,0.0,0.2631578947368421,0.2777777777777778,0.0,0.0
Velo-facial-skeletal syndrome,27369,1,18,18,11,7,22,2,20,0.6111111111111112,0.1111111111111111,0.6111111111111112,0.6111111111111112,0.09090909090909091,0.1111111111111111
Verloove Vanhorick-Brubakk syndrome,31791,0,18,17,13,4,47,0,47,0.7222222222222222,0.0,0.7647058823529411,0.7222222222222222,0.0,0.0
MMEP syndrome,28919,0,11,21,6,15,14,0,14,0.5454545454545454,0.0,0.2857142857142857,0.5454545454545454,0.0,0.0
Weill-Marchesani syndrome,28146,2,21,25,10,15,31,3,28,0.47619047619047616,0.14285714285714285,0.4,0.47619047619047616,0.0967741935483871,0.14285714285714285
Thoraco-abdominal enteric duplication,33415,7,12,21,9,12,19,0,19,0.75,0.0,0.42857142857142855,0.75,0.0,0.0
Symbrachydactyly of hands and feet,98322,5,8,5,0,5,7,0,7,0.0,0.0,0.0,0.0,0.0,0.0
Acromelic frontonasal dysplasia,31586,0,37,17,12,5,28,0,28,0.32432432432432434,0.0,0.7058823529411765,0.32432432432432434,0.0,0.0
Congenital amegakaryocytic thrombocytopenia,30222,2,11,14,10,4,31,2,29,0.9090909090909091,0.18181818181818182,0.7142857142857143,0.9090909090909091,0.06451612903225806,0.18181818181818182
Young syndrome,31400,0,5,18,0,18,43,0,43,0.0,0.0,0.0,0.0,0.0,0.0
Hirschsprung disease-ganglioneuroblastoma syndrome,29014,5,8,20,7,13,18,0,18,0.875,0.0,0.35,0.875,0.0,0.0
Intellectual disability-short stature-hypertelorism syndrome,32813,11,9,24,9,15,38,2,36,1.0,0.2222222222222222,0.375,1.0,0.05263157894736842,0.2222222222222222
Facial dysmorphism-shawl scrotum-joint laxity syndrome,33556,0,24,19,17,2,17,0,17,0.7083333333333334,0.0,0.8947368421052632,0.7083333333333334,0.0,0.0
Microphthalmia-microtia-fetal akinesia syndrome,32755,1,15,21,13,8,24,3,21,0.8666666666666667,0.2,0.6190476190476191,0.8666666666666667,0.125,0.2
Brachydactyly-mesomelia-intellectual disability-heart defects syndrome,32720,3,11,19,9,10,29,1,28,0.8181818181818182,0.09090909090909091,0.47368421052631576,0.8181818181818182,0.034482758620689655,0.09090909090909091
Fryns-Smeets-Thiry syndrome,32502,2,19,17,17,0,33,4,29,0.8947368421052632,0.21052631578947367,1.0,0.8947368421052632,0.12121212121212122,0.21052631578947367
Atherosclerosis-deafness-diabetes-epilepsy-nephropathy syndrome,28576,1,23,17,16,1,20,2,18,0.6956521739130435,0.08695652173913043,0.9411764705882353,0.6956521739130435,0.1,0.08695652173913043
Muscular pseudohypertrophy-hypothyroidism syndrome,33034,5,15,18,12,6,20,1,19,0.8,0.06666666666666667,0.6666666666666666,0.8,0.05,0.06666666666666667
Myalgia-eosinophilia syndrome associated with tryptophan,32733,2,10,19,7,12,18,0,18,0.7,0.0,0.3684210526315789,0.7,0.0,0.0
"Dysplastic cortical hyperostosis, Kozlowski-Tsuruta type",33537,2,14,17,11,6,32,3,29,0.7857142857142857,0.21428571428571427,0.6470588235294118,0.7857142857142857,0.09375,0.21428571428571427
"Progeroid syndrome, Petty type",31991,3,28,112,29,83,33,1,32,1.0357142857142858,0.03571428571428571,0.25892857142857145,1.0357142857142858,0.030303030303030304,0.03571428571428571
White matter hypoplasia-corpus callosum agenesis-intellectual disability syndrome,32343,8,17,23,14,9,23,3,20,0.8235294117647058,0.17647058823529413,0.6086956521739131,0.8235294117647058,0.13043478260869565,0.17647058823529413
Autosomal dominant prognathism,28627,8,3,23,3,20,13,0,13,1.0,0.0,0.13043478260869565,1.0,0.0,0.0
Acrodysplasia scoliosis,29310,1,4,18,0,18,46,1,45,0.0,0.25,0.0,0.0,0.021739130434782608,0.25
Proteus-like syndrome,33263,1,31,17,17,0,46,1,45,0.5483870967741935,0.03225806451612903,1.0,0.5483870967741935,0.021739130434782608,0.03225806451612903
"46,XX difference of sex development-anorectal anomalies syndrome",33260,8,15,20,14,6,48,5,43,0.9333333333333333,0.3333333333333333,0.7,0.9333333333333333,0.10416666666666667,0.3333333333333333
Non-eruption of teeth-maxillary hypoplasia-genu valgum syndrome,30911,2,8,13,8,5,21,2,19,1.0,0.25,0.6153846153846154,1.0,0.09523809523809523,0.25
Familial pterygium of the conjunctiva,30225,6,3,20,4,16,24,1,23,1.3333333333333333,0.3333333333333333,0.2,1.3333333333333333,0.041666666666666664,0.3333333333333333
Chronic intestinal pseudoobstruction,97922,14,6,16,1,15,18,1,17,0.16666666666666666,0.16666666666666666,0.0625,0.16666666666666666,0.05555555555555555,0.16666666666666666
Mirror polydactyly-vertebral segmentation-limbs defects syndrome,32706,5,7,26,5,21,23,1,22,0.7142857142857143,0.14285714285714285,0.19230769230769232,0.7142857142857143,0.043478260869565216,0.14285714285714285
Autosomal recessive multiple pterygium syndrome,38697,14,65,27,5,22,37,5,32,0.07692307692307693,0.07692307692307693,0.18518518518518517,0.07692307692307693,0.13513513513513514,0.07692307692307693
Ramon syndrome,28032,0,17,17,11,6,27,0,27,0.6470588235294118,0.0,0.6470588235294118,0.6470588235294118,0.0,0.0
External auditory canal atresia-vertical talus-hypertelorism syndrome,28323,4,6,18,7,11,29,2,27,1.1666666666666667,0.3333333333333333,0.3888888888888889,1.1666666666666667,0.06896551724137931,0.3333333333333333
Delayed membranous cranial ossification,31603,3,7,18,7,11,26,1,25,1.0,0.14285714285714285,0.3888888888888889,1.0,0.038461538461538464,0.14285714285714285
Renal tubular dysgenesis,32831,5,13,36,8,28,13,0,13,0.6153846153846154,0.0,0.2222222222222222,0.6153846153846154,0.0,0.0
Growth delay-hydrocephaly-lung hypoplasia syndrome,28695,1,17,18,14,4,28,0,28,0.8235294117647058,0.0,0.7777777777777778,0.8235294117647058,0.0,0.0
Delayed speech-facial asymmetry-strabismus-ear lobe creases syndrome,32152,3,14,15,13,2,30,3,27,0.9285714285714286,0.21428571428571427,0.8666666666666667,0.9285714285714286,0.1,0.21428571428571427
Intellectual disability-cataracts-calcified pinnae-myopathy syndrome,29991,2,33,19,12,7,24,1,23,0.36363636363636365,0.030303030303030304,0.631578947368421,0.36363636363636365,0.041666666666666664,0.030303030303030304
X-linked intellectual disability-hypogonadism-ichthyosis-obesity-short stature syndrome,32821,5,18,20,14,6,27,4,23,0.7777777777777778,0.2222222222222222,0.7,0.7777777777777778,0.14814814814814814,0.2222222222222222
Monoamine oxidase A deficiency,28961,5,2,22,1,21,22,1,21,0.5,0.5,0.045454545454545456,0.5,0.045454545454545456,0.5
Intellectual disability-myopathy-short stature-endocrine defect syndrome,29725,2,30,25,17,8,27,4,23,0.5666666666666667,0.13333333333333333,0.68,0.5666666666666667,0.14814814814814814,0.13333333333333333
"Intellectual disability, Wolff type",30904,0,29,22,19,3,21,0,21,0.6551724137931034,0.0,0.8636363636363636,0.6551724137931034,0.0,0.0
"Rhizomelic syndrome, Urbach type",29571,0,26,12,11,1,38,2,36,0.4230769230769231,0.07692307692307693,0.9166666666666666,0.4230769230769231,0.05263157894736842,0.07692307692307693
Robin sequence-oligodactyly syndrome,30699,2,10,20,8,12,37,2,35,0.8,0.2,0.4,0.8,0.05405405405405406,0.2
Mayer-Rokitansky-Küster-Hauser syndrome,30327,14,20,51,4,47,24,4,20,0.2,0.2,0.0784313725490196,0.2,0.16666666666666666,0.2
Schneckenbecken dysplasia,29679,0,26,31,24,7,26,0,26,0.9230769230769231,0.0,0.7741935483870968,0.9230769230769231,0.0,0.0
Autoimmune polyendocrinopathy type 2,38555,11,12,18,1,17,27,2,25,0.08333333333333333,0.16666666666666666,0.05555555555555555,0.08333333333333333,0.07407407407407407,0.16666666666666666
Satoyoshi syndrome,30048,1,24,16,8,8,29,0,29,0.3333333333333333,0.0,0.5,0.3333333333333333,0.0,0.0
Ruvalcaba syndrome,28803,0,36,8,6,2,39,0,39,0.16666666666666666,0.0,0.75,0.16666666666666666,0.0,0.0
Senior-Loken syndrome,27417,1,16,17,9,8,30,2,28,0.5625,0.125,0.5294117647058824,0.5625,0.06666666666666667,0.125
Nijmegen breakage syndrome,27380,4,49,17,4,13,26,3,23,0.08163265306122448,0.061224489795918366,0.23529411764705882,0.08163265306122448,0.11538461538461539,0.061224489795918366
Arginine vasopressin resistance-intracranial calcification-short stature-facial dysmorphism syndrome,29832,1,15,16,2,14,27,4,23,0.13333333333333333,0.26666666666666666,0.125,0.13333333333333333,0.14814814814814814,0.26666666666666666
Autosomal dominant spondylocostal dysostosis,29480,2,22,46,19,27,27,2,25,0.8636363636363636,0.09090909090909091,0.41304347826086957,0.8636363636363636,0.07407407407407407,0.09090909090909091
Spondylocamptodactyly syndrome,38339,8,3,26,1,25,58,2,56,0.3333333333333333,0.6666666666666666,0.038461538461538464,0.3333333333333333,0.034482758620689655,0.6666666666666666
"Omphalocele syndrome, Shprintzen-Goldberg type",31954,0,21,17,8,9,24,1,23,0.38095238095238093,0.047619047619047616,0.47058823529411764,0.38095238095238093,0.041666666666666664,0.047619047619047616
Septo-optic dysplasia spectrum,30549,4,33,29,21,8,26,7,19,0.6363636363636364,0.21212121212121213,0.7241379310344828,0.6363636363636364,0.2692307692307692,0.21212121212121213
Subaortic stenosis-short stature syndrome,30548,2,26,45,21,24,39,5,34,0.8076923076923077,0.19230769230769232,0.4666666666666667,0.8076923076923077,0.1282051282051282,0.19230769230769232
Holoprosencephaly-radial heart renal anomalies syndrome,31894,2,27,24,17,7,28,3,25,0.6296296296296297,0.1111111111111111,0.7083333333333334,0.6296296296296297,0.10714285714285714,0.1111111111111111
Sprengel deformity,28692,4,6,15,4,11,17,2,15,0.6666666666666666,0.3333333333333333,0.26666666666666666,0.6666666666666666,0.11764705882352941,0.3333333333333333
Conductive deafness-malformed external ear syndrome,30226,2,13,18,11,7,16,1,15,0.8461538461538461,0.07692307692307693,0.6111111111111112,0.8461538461538461,0.0625,0.07692307692307693
Deafness-epiphyseal dysplasia-short stature syndrome,28062,3,19,18,13,5,27,2,25,0.6842105263157895,0.10526315789473684,0.7222222222222222,0.6842105263157895,0.07407407407407407,0.10526315789473684
Supravalvular aortic stenosis,28231,18,7,29,7,22,23,5,18,1.0,0.7142857142857143,0.2413793103448276,1.0,0.21739130434782608,0.7142857142857143
Hearing loss-familial salivary gland insensitivity to aldosterone syndrome,32334,11,3,25,2,23,29,1,28,0.6666666666666666,0.3333333333333333,0.08,0.6666666666666666,0.034482758620689655,0.3333333333333333
Deafness-oligodontia syndrome,31584,5,4,23,4,19,33,2,31,1.0,0.5,0.17391304347826086,1.0,0.06060606060606061,0.5
Fountain syndrome,29331,0,44,18,16,2,18,1,17,0.36363636363636365,0.022727272727272728,0.8888888888888888,0.36363636363636365,0.05555555555555555,0.022727272727272728
Conductive deafness-ptosis-skeletal anomalies syndrome,31565,2,16,16,12,4,29,4,25,0.75,0.25,0.75,0.75,0.13793103448275862,0.25
Deafness-craniofacial syndrome,27898,3,14,18,12,6,30,4,26,0.8571428571428571,0.2857142857142857,0.6666666666666666,0.8571428571428571,0.13333333333333333,0.2857142857142857
Cochleosaccular degeneration-cataract syndrome,29004,6,5,21,5,16,24,0,24,1.0,0.0,0.23809523809523808,1.0,0.0,0.0
Isolated humero-radial synostosis,29031,2,11,13,8,5,41,3,38,0.7272727272727273,0.2727272727272727,0.6153846153846154,0.7272727272727273,0.07317073170731707,0.2727272727272727
Proximal symphalangism,27357,0,15,18,7,11,14,1,13,0.4666666666666667,0.06666666666666667,0.3888888888888889,0.4666666666666667,0.07142857142857142,0.06666666666666667
Cleft lip/palate-ectodermal dysplasia syndrome,27507,7,42,17,3,14,49,3,46,0.07142857142857142,0.07142857142857142,0.17647058823529413,0.07142857142857142,0.061224489795918366,0.07142857142857142
Autosomal recessive hypohidrotic ectodermal dysplasia,32453,4,10,23,3,20,32,2,30,0.3,0.2,0.13043478260869565,0.3,0.0625,0.2
Erythrokeratodermia variabilis,38275,5,29,35,4,31,17,3,14,0.13793103448275862,0.10344827586206896,0.11428571428571428,0.13793103448275862,0.17647058823529413,0.10344827586206896
SAPHO syndrome,32951,5,30,25,25,0,29,10,19,0.8333333333333334,0.3333333333333333,1.0,0.8333333333333334,0.3448275862068966,0.3333333333333333
Lymphedema with yellow nails,29797,1,24,22,22,0,23,1,22,0.9166666666666666,0.041666666666666664,1.0,0.9166666666666666,0.043478260869565216,0.041666666666666664
Macrophagic myofasciitis,33273,9,6,20,4,16,22,2,20,0.6666666666666666,0.3333333333333333,0.2,0.6666666666666666,0.09090909090909091,0.3333333333333333
"46,XX testicular difference of sex development",38749,15,4,24,1,23,42,1,41,0.25,0.25,0.041666666666666664,0.25,0.023809523809523808,0.25
Autosomal dominant hypocalcemia,28238,4,30,38,25,13,32,10,22,0.8333333333333334,0.3333333333333333,0.6578947368421053,0.8333333333333334,0.3125,0.3333333333333333
Adult-onset Still disease,32993,6,58,16,16,0,27,11,16,0.27586206896551724,0.1896551724137931,1.0,0.27586206896551724,0.4074074074074074,0.1896551724137931
Dracunculiasis,32442,2,15,17,13,4,28,3,25,0.8666666666666667,0.2,0.7647058823529411,0.8666666666666667,0.10714285714285714,0.2
Isolated anencephaly/exencephaly,29207,2,2,28,2,26,34,1,33,1.0,0.5,0.07142857142857142,1.0,0.029411764705882353,0.5
TMEM70-related mitochondrial encephalo-cardio-myopathy,38859,15,30,22,0,22,26,2,24,0.0,0.06666666666666667,0.0,0.0,0.07692307692307693,0.06666666666666667
Best vitelliform macular dystrophy,27619,3,6,18,6,12,30,4,26,1.0,0.6666666666666666,0.3333333333333333,1.0,0.13333333333333333,0.6666666666666666
Miller-Dieker syndrome,29453,3,18,44,15,29,29,1,28,0.8333333333333334,0.05555555555555555,0.3409090909090909,0.8333333333333334,0.034482758620689655,0.05555555555555555
X-linked lissencephaly with abnormal genitalia,31402,3,21,33,19,14,42,4,38,0.9047619047619048,0.19047619047619047,0.5757575757575758,0.9047619047619048,0.09523809523809523,0.19047619047619047
Kyphoscoliotic Ehlers-Danlos syndrome due to lysyl hydroxylase 1 deficiency,33340,4,66,25,11,14,30,4,26,0.16666666666666666,0.06060606060606061,0.44,0.16666666666666666,0.13333333333333333,0.06060606060606061
"Congenital nephrotic syndrome, Finnish type",30172,1,5,17,4,13,18,2,16,0.8,0.4,0.23529411764705882,0.8,0.1111111111111111,0.4
Hypermobile Ehlers-Danlos syndrome,27533,3,70,20,14,6,23,7,16,0.2,0.1,0.7,0.2,0.30434782608695654,0.1
Vascular Ehlers-Danlos syndrome,94823,14,95,31,5,26,31,5,26,0.05263157894736842,0.05263157894736842,0.16129032258064516,0.05263157894736842,0.16129032258064516,0.05263157894736842
Hyperprolinemia type 1,28903,2,6,16,4,12,11,2,9,0.6666666666666666,0.3333333333333333,0.25,0.6666666666666666,0.18181818181818182,0.3333333333333333
Pseudohypoaldosteronism type 2,28487,3,9,17,10,7,32,4,28,1.1111111111111112,0.4444444444444444,0.5882352941176471,1.1111111111111112,0.125,0.4444444444444444
Pseudoxanthoma elasticum,30537,0,41,16,9,7,37,2,35,0.21951219512195122,0.04878048780487805,0.5625,0.21951219512195122,0.05405405405405406,0.04878048780487805
Isolated Klippel-Feil syndrome,39098,14,33,25,5,20,32,5,27,0.15151515151515152,0.15151515151515152,0.2,0.15151515151515152,0.15625,0.15151515151515152
Larsen syndrome,31684,1,27,15,1,14,21,2,19,0.037037037037037035,0.07407407407407407,0.06666666666666667,0.037037037037037035,0.09523809523809523,0.07407407407407407
Cutaneous small vessel vasculitis,84265,12,14,26,8,18,26,6,20,0.5714285714285714,0.42857142857142855,0.3076923076923077,0.5714285714285714,0.23076923076923078,0.42857142857142855
Kindler epidermolysis bullosa,29328,1,41,19,10,9,16,3,13,0.24390243902439024,0.07317073170731707,0.5263157894736842,0.24390243902439024,0.1875,0.07317073170731707
Reynolds syndrome,29955,4,24,19,13,6,27,5,22,0.5416666666666666,0.20833333333333334,0.6842105263157895,0.5416666666666666,0.18518518518518517,0.20833333333333334
Criss-cross heart,32358,4,13,22,10,12,40,1,39,0.7692307692307693,0.07692307692307693,0.45454545454545453,0.7692307692307693,0.025,0.07692307692307693
Antisynthetase syndrome,32317,2,42,17,16,1,26,9,17,0.38095238095238093,0.21428571428571427,0.9411764705882353,0.38095238095238093,0.34615384615384615,0.21428571428571427
Pyomyositis,32985,8,12,21,11,10,23,2,21,0.9166666666666666,0.16666666666666666,0.5238095238095238,0.9166666666666666,0.08695652173913043,0.16666666666666666
Alopecia totalis,38135,5,10,18,2,16,10,2,8,0.2,0.2,0.1111111111111111,0.2,0.2,0.2
Syringocystadenoma papilliferum,33005,1,5,10,5,5,23,0,23,1.0,0.0,0.5,1.0,0.0,0.0
Pili bifurcati,33209,5,2,19,2,17,36,1,35,1.0,0.5,0.10526315789473684,1.0,0.027777777777777776,0.5
Proliferating trichilemmal cyst,33442,3,3,24,3,21,19,1,18,1.0,0.3333333333333333,0.125,1.0,0.05263157894736842,0.3333333333333333
Kerion celsi,29549,4,8,22,10,12,19,2,17,1.25,0.25,0.45454545454545453,1.25,0.10526315789473684,0.25
Lichen planopilaris,32619,9,15,26,4,22,19,2,17,0.26666666666666666,0.13333333333333333,0.15384615384615385,0.26666666666666666,0.10526315789473684,0.13333333333333333
Erosive pustular dermatosis of the scalp,32445,8,5,21,4,17,24,1,23,0.8,0.2,0.19047619047619047,0.8,0.041666666666666664,0.2
Quinquaud folliculitis decalvans,32199,6,7,21,7,14,16,3,13,1.0,0.42857142857142855,0.3333333333333333,1.0,0.1875,0.42857142857142855
Marie Unna hereditary hypotrichosis,33470,9,5,20,5,15,30,2,28,1.0,0.4,0.25,1.0,0.06666666666666667,0.4
Loose anagen syndrome,27850,6,3,25,1,24,26,0,26,0.3333333333333333,0.0,0.04,0.3333333333333333,0.0,0.0
Ringed hair disease,30642,4,2,11,3,8,26,0,26,1.5,0.0,0.2727272727272727,1.5,0.0,0.0
Woolly hair,38788,8,12,9,3,6,12,4,8,0.25,0.3333333333333333,0.3333333333333333,0.25,0.3333333333333333,0.3333333333333333
Crandall syndrome,32479,1,11,18,10,8,18,1,17,0.9090909090909091,0.09090909090909091,0.5555555555555556,0.9090909090909091,0.05555555555555555,0.09090909090909091
Babesiosis,32638,4,31,17,17,0,23,8,15,0.5483870967741935,0.25806451612903225,1.0,0.5483870967741935,0.34782608695652173,0.25806451612903225
Roch-Leri mesosomatous lipomatosis,33326,7,4,25,3,22,32,0,32,0.75,0.0,0.12,0.75,0.0,0.0
Pseudopelade of Brocq,32645,6,9,18,7,11,23,1,22,0.7777777777777778,0.1111111111111111,0.3888888888888889,0.7777777777777778,0.043478260869565216,0.1111111111111111
Dissecting cellulitis of the scalp,28699,1,7,21,5,16,22,2,20,0.7142857142857143,0.2857142857142857,0.23809523809523808,0.7142857142857143,0.09090909090909091,0.2857142857142857
Vogt-Koyanagi-Harada disease,33368,7,36,20,13,7,30,8,22,0.3611111111111111,0.2222222222222222,0.65,0.3611111111111111,0.26666666666666666,0.2222222222222222
Inherited epidermodysplasia verruciformis,28815,6,11,19,4,15,25,3,22,0.36363636363636365,0.2727272727272727,0.21052631578947367,0.36363636363636365,0.12,0.2727272727272727
CINCA syndrome,30483,1,44,17,14,3,25,4,21,0.3181818181818182,0.09090909090909091,0.8235294117647058,0.3181818181818182,0.16,0.09090909090909091
Lymphangioleiomyomatosis,29275,2,36,20,19,1,21,6,15,0.5277777777777778,0.16666666666666666,0.95,0.5277777777777778,0.2857142857142857,0.16666666666666666
Severe hereditary thrombophilia due to congenital protein C deficiency,31567,5,10,21,3,18,17,3,14,0.3,0.3,0.14285714285714285,0.3,0.17647058823529413,0.3
Sézary syndrome,32282,1,29,17,14,3,29,5,24,0.4827586206896552,0.1724137931034483,0.8235294117647058,0.4827586206896552,0.1724137931034483,0.1724137931034483
Classic mycosis fungoides,30990,2,29,17,16,1,21,7,14,0.5517241379310345,0.2413793103448276,0.9411764705882353,0.5517241379310345,0.3333333333333333,0.2413793103448276
3-methylcrotonyl-CoA carboxylase deficiency,29803,3,10,16,4,12,30,2,28,0.4,0.2,0.25,0.4,0.06666666666666667,0.2
Hyperimmunoglobulinemia D with periodic fever,29059,6,26,17,12,5,26,4,22,0.46153846153846156,0.15384615384615385,0.7058823529411765,0.46153846153846156,0.15384615384615385,0.15384615384615385
Severe hereditary thrombophilia due to congenital protein S deficiency,30555,5,14,13,3,10,26,4,22,0.21428571428571427,0.2857142857142857,0.23076923076923078,0.21428571428571427,0.15384615384615385,0.2857142857142857
Vitamin B12-responsive methylmalonic acidemia,38693,19,13,21,1,20,23,2,21,0.07692307692307693,0.15384615384615385,0.047619047619047616,0.07692307692307693,0.08695652173913043,0.15384615384615385
Paris-Trousseau thrombocytopenia,30294,2,2,24,2,22,22,0,22,1.0,0.0,0.08333333333333333,1.0,0.0,0.0
Homocystinuria without methylmalonic aciduria,33171,2,13,20,10,10,18,1,17,0.7692307692307693,0.07692307692307693,0.5,0.7692307692307693,0.05555555555555555,0.07692307692307693
Sneddon syndrome,28715,1,54,17,17,0,31,6,25,0.3148148148148148,0.1111111111111111,1.0,0.3148148148148148,0.1935483870967742,0.1111111111111111
Bardet-Biedl syndrome,27886,2,95,17,11,6,25,10,15,0.11578947368421053,0.10526315789473684,0.6470588235294118,0.11578947368421053,0.4,0.10526315789473684
Stüve-Wiedemann syndrome,27231,4,44,86,43,43,29,3,26,0.9772727272727273,0.06818181818181818,0.5,0.9772727272727273,0.10344827586206896,0.06818181818181818
Leber congenital amaurosis,28852,7,25,52,21,31,27,3,24,0.84,0.12,0.40384615384615385,0.84,0.1111111111111111,0.12
Xeroderma pigmentosum,31055,12,59,24,6,18,35,8,27,0.1016949152542373,0.13559322033898305,0.25,0.1016949152542373,0.22857142857142856,0.13559322033898305
Kallmann syndrome,31593,0,44,16,7,9,8,4,4,0.1590909090909091,0.09090909090909091,0.4375,0.1590909090909091,0.5,0.09090909090909091
Aplasia cutis congenita,28732,1,13,14,10,4,30,1,29,0.7692307692307693,0.07692307692307693,0.7142857142857143,0.7692307692307693,0.03333333333333333,0.07692307692307693
Hydrocephaly-low insertion umbilicus syndrome,28443,0,10,21,0,21,22,1,21,0.0,0.1,0.0,0.0,0.045454545454545456,0.1
"Rhizomelic dysplasia, Patterson-Lowry type",31126,3,17,22,16,6,42,1,41,0.9411764705882353,0.058823529411764705,0.7272727272727273,0.9411764705882353,0.023809523809523808,0.058823529411764705
Hypomyelination neuropathy-arthrogryposis syndrome,32883,12,5,22,4,18,25,1,24,0.8,0.2,0.18181818181818182,0.8,0.04,0.2
Medullary sponge kidney,32929,4,5,24,4,20,19,1,18,0.8,0.2,0.16666666666666666,0.8,0.05263157894736842,0.2
Hailey-Hailey disease,32154,2,5,12,6,6,3,1,2,1.2,0.2,0.5,1.2,0.3333333333333333,0.2
Mixed connective tissue disease,38353,16,68,21,4,17,24,5,19,0.058823529411764705,0.07352941176470588,0.19047619047619047,0.058823529411764705,0.20833333333333334,0.07352941176470588
Linear verrucous nevus syndrome,98638,4,27,7,0,7,28,2,26,0.0,0.07407407407407407,0.0,0.0,0.07142857142857142,0.07407407407407407
Early-onset generalized limb-onset dystonia,31302,1,5,17,6,11,18,2,16,1.2,0.4,0.35294117647058826,1.2,0.1111111111111111,0.4
Narcolepsy type 1,32306,10,30,21,7,14,28,7,21,0.23333333333333334,0.23333333333333334,0.3333333333333333,0.23333333333333334,0.25,0.23333333333333334
Familial melanoma,33176,2,11,20,9,11,27,0,27,0.8181818181818182,0.0,0.45,0.8181818181818182,0.0,0.0
Propionic acidemia,29070,12,11,38,10,28,47,5,42,0.9090909090909091,0.45454545454545453,0.2631578947368421,0.9090909090909091,0.10638297872340426,0.45454545454545453
Rhizomelic chondrodysplasia punctata,38558,15,20,21,2,19,40,4,36,0.1,0.2,0.09523809523809523,0.1,0.1,0.2
Cartilage-hair hypoplasia,31860,1,79,94,77,17,37,3,34,0.9746835443037974,0.0379746835443038,0.8191489361702128,0.9746835443037974,0.08108108108108109,0.0379746835443038
Essential thrombocythemia,28536,1,30,18,15,3,18,6,12,0.5,0.2,0.8333333333333334,0.5,0.3333333333333333,0.2
Smith-Lemli-Opitz syndrome,29631,1,106,18,13,5,30,11,19,0.12264150943396226,0.10377358490566038,0.7222222222222222,0.12264150943396226,0.36666666666666664,0.10377358490566038
Von Willebrand disease,39535,14,20,17,2,15,25,2,23,0.1,0.1,0.11764705882352941,0.1,0.08,0.1
His bundle tachycardia,32495,11,4,19,5,14,26,2,24,1.25,0.5,0.2631578947368421,1.25,0.07692307692307693,0.5
Catecholaminergic polymorphic ventricular tachycardia,27503,4,10,16,6,10,20,4,16,0.6,0.4,0.375,0.6,0.2,0.4
Infantile myofibromatosis,29362,11,28,29,2,27,36,0,36,0.07142857142857142,0.0,0.06896551724137931,0.07142857142857142,0.0,0.0
Nephronophthisis,98711,17,3,24,2,22,20,0,20,0.6666666666666666,0.0,0.08333333333333333,0.6666666666666666,0.0,0.0
Congenital pulmonary valvar stenosis,84083,14,3,20,0,20,23,0,23,0.0,0.0,0.0,0.0,0.0,0.0
Common variable immunodeficiency,27188,8,26,39,14,25,28,4,24,0.5384615384615384,0.15384615384615385,0.358974358974359,0.5384615384615384,0.14285714285714285,0.15384615384615385
Intellectual disability-polydactyly-uncombable hair syndrome,32810,1,34,28,25,3,26,3,23,0.7352941176470589,0.08823529411764706,0.8928571428571429,0.7352941176470589,0.11538461538461539,0.08823529411764706
Axenfeld-Rieger syndrome,28350,3,21,44,19,25,17,4,13,0.9047619047619048,0.19047619047619047,0.4318181818181818,0.9047619047619048,0.23529411764705882,0.19047619047619047
Tyrosinemia type 1,37602,14,6,27,2,25,28,2,26,0.3333333333333333,0.3333333333333333,0.07407407407407407,0.3333333333333333,0.07142857142857142,0.3333333333333333
Cerebral arteriovenous malformation,38143,7,11,18,3,15,27,1,26,0.2727272727272727,0.09090909090909091,0.16666666666666666,0.2727272727272727,0.037037037037037035,0.09090909090909091
Familial cold urticaria,28698,13,17,31,8,23,33,7,26,0.47058823529411764,0.4117647058823529,0.25806451612903225,0.47058823529411764,0.21212121212121213,0.4117647058823529
Hereditary persistence of fetal hemoglobin-beta-thalassemia syndrome,32198,8,6,30,5,25,38,4,34,0.8333333333333334,0.6666666666666666,0.16666666666666666,0.8333333333333334,0.10526315789473684,0.6666666666666666
Char syndrome,29956,0,28,34,25,9,29,0,29,0.8928571428571429,0.0,0.7352941176470589,0.8928571428571429,0.0,0.0
Linear IgA dermatosis,32380,5,11,25,9,16,24,1,23,0.8181818181818182,0.09090909090909091,0.36,0.8181818181818182,0.041666666666666664,0.09090909090909091
Mucous membrane pemphigoid,32381,6,7,19,7,12,25,2,23,1.0,0.2857142857142857,0.3684210526315789,1.0,0.08,0.2857142857142857
Epidermolysis bullosa acquisita,31133,4,10,12,1,11,13,1,12,0.1,0.1,0.08333333333333333,0.1,0.07692307692307693,0.1
Primary effusion lymphoma,33071,10,8,22,8,14,22,2,20,1.0,0.25,0.36363636363636365,1.0,0.09090909090909091,0.25
Aceruloplasminemia,27772,1,41,34,35,-1,26,3,23,0.8536585365853658,0.07317073170731707,1.0294117647058822,0.8536585365853658,0.11538461538461539,0.07317073170731707
Congenital cataracts-facial dysmorphism-neuropathy syndrome,30433,1,32,16,9,7,21,1,20,0.28125,0.03125,0.5625,0.28125,0.047619047619047616,0.03125
Phelan-McDermid syndrome,30547,2,51,23,13,10,23,2,21,0.2549019607843137,0.0392156862745098,0.5652173913043478,0.2549019607843137,0.08695652173913043,0.0392156862745098
Nodular regenerative hyperplasia of the liver,32521,5,2,23,3,20,21,2,19,1.5,1.0,0.13043478260869565,1.5,0.09523809523809523,1.0
Subcorneal pustular dermatosis,32522,4,11,19,8,11,21,4,17,0.7272727272727273,0.36363636363636365,0.42105263157894735,0.7272727272727273,0.19047619047619047,0.36363636363636365
Felty syndrome,30061,5,36,17,19,-2,25,8,17,0.5277777777777778,0.2222222222222222,1.1176470588235294,0.5277777777777778,0.32,0.2222222222222222
Pyoderma gangrenosum,33494,5,15,16,15,1,24,5,19,1.0,0.3333333333333333,0.9375,1.0,0.20833333333333334,0.3333333333333333
Stevens-Johnson syndrome,32746,7,39,17,16,1,35,13,22,0.41025641025641024,0.3333333333333333,0.9411764705882353,0.41025641025641024,0.37142857142857144,0.3333333333333333
Hypocomplementemic urticarial vasculitis,32737,4,47,18,18,0,25,8,17,0.3829787234042553,0.1702127659574468,1.0,0.3829787234042553,0.32,0.1702127659574468
Adiposis dolorosa,29641,1,40,17,15,2,25,3,22,0.375,0.075,0.8823529411764706,0.375,0.12,0.075
Bullous impetigo,32392,7,8,21,9,12,30,2,28,1.125,0.25,0.42857142857142855,1.125,0.06666666666666667,0.25
Morning glory disc anomaly,33417,1,7,25,5,20,6,0,6,0.7142857142857143,0.0,0.2,0.7142857142857143,0.0,0.0
3-hydroxy-3-methylglutaryl-CoA synthase deficiency,31378,7,3,28,3,25,25,2,23,1.0,0.6666666666666666,0.10714285714285714,1.0,0.08,0.6666666666666666
Paroxysmal extreme pain disorder,29403,5,2,19,1,18,22,0,22,0.5,0.0,0.05263157894736842,0.5,0.0,0.0
Gastrointestinal stromal tumor,29194,2,18,17,15,2,25,6,19,0.8333333333333334,0.3333333333333333,0.8823529411764706,0.8333333333333334,0.24,0.3333333333333333
PHACE syndrome,29548,1,34,20,16,4,35,4,31,0.47058823529411764,0.11764705882352941,0.8,0.47058823529411764,0.11428571428571428,0.11764705882352941
PFAPA syndrome,33134,2,27,16,16,0,27,6,21,0.5925925925925926,0.2222222222222222,1.0,0.5925925925925926,0.2222222222222222,0.2222222222222222
Omenn syndrome,29973,4,28,31,24,7,30,6,24,0.8571428571428571,0.21428571428571427,0.7741935483870968,0.8571428571428571,0.2,0.21428571428571427
MALT lymphoma,31676,4,17,17,16,1,20,5,15,0.9411764705882353,0.29411764705882354,0.9411764705882353,0.9411764705882353,0.25,0.29411764705882354
Branchiootic syndrome,29196,1,16,26,16,10,8,3,5,1.0,0.1875,0.6153846153846154,1.0,0.375,0.1875
X-linked creatine transporter deficiency,30717,1,26,18,9,9,25,2,23,0.34615384615384615,0.07692307692307693,0.5,0.34615384615384615,0.08,0.07692307692307693
Muenke syndrome,27500,1,21,39,17,22,31,1,30,0.8095238095238095,0.047619047619047616,0.4358974358974359,0.8095238095238095,0.03225806451612903,0.047619047619047616
Corpus callosum agenesis-intellectual disability-coloboma-micrognathia syndrome,30625,3,24,17,16,1,29,3,26,0.6666666666666666,0.125,0.9411764705882353,0.6666666666666666,0.10344827586206896,0.125
Ulnar/fibula ray defect-brachydactyly syndrome,27244,2,12,18,13,5,24,2,22,1.0833333333333333,0.16666666666666666,0.7222222222222222,1.0833333333333333,0.08333333333333333,0.16666666666666666
Mantle cell lymphoma,32531,9,9,21,9,12,31,4,27,1.0,0.4444444444444444,0.42857142857142855,1.0,0.12903225806451613,0.4444444444444444
Wyburn-Mason syndrome,32508,1,27,17,15,2,20,1,19,0.5555555555555556,0.037037037037037035,0.8823529411764706,0.5555555555555556,0.05,0.037037037037037035
Spinal arteriovenous metameric syndrome,32557,0,20,17,18,-1,23,1,22,0.9,0.05,1.0588235294117647,0.9,0.043478260869565216,0.05
Hypotrichosis simplex,27278,5,6,22,6,16,19,1,18,1.0,0.16666666666666666,0.2727272727272727,1.0,0.05263157894736842,0.16666666666666666
Familial cutaneous collagenoma,30088,1,7,19,8,11,15,3,12,1.1428571428571428,0.42857142857142855,0.42105263157894735,1.1428571428571428,0.2,0.42857142857142855
Gnathodiaphyseal dysplasia,28298,2,7,17,7,10,7,0,7,1.0,0.0,0.4117647058823529,1.0,0.0,0.0
Familial tumoral calcinosis,32506,2,18,18,19,-1,25,2,23,1.0555555555555556,0.1111111111111111,1.0555555555555556,1.0555555555555556,0.08,0.1111111111111111
Lipodystrophy-intellectual disability-deafness syndrome,30883,1,13,16,8,8,30,1,29,0.6153846153846154,0.07692307692307693,0.5,0.6153846153846154,0.03333333333333333,0.07692307692307693
Microlissencephaly-micromelia syndrome,32892,3,25,16,14,2,18,2,16,0.56,0.08,0.875,0.56,0.1111111111111111,0.08
Craniolenticulosutural dysplasia,27877,0,34,18,1,17,16,0,16,0.029411764705882353,0.0,0.05555555555555555,0.029411764705882353,0.0,0.0
Zellweger-like syndrome without peroxisomal anomalies,32874,0,22,17,4,13,16,0,16,0.18181818181818182,0.0,0.23529411764705882,0.18181818181818182,0.0,0.0
Lichen amyloidosis,32648,3,2,14,2,12,12,1,11,1.0,0.5,0.14285714285714285,1.0,0.08333333333333333,0.5
Focal myositis,33270,10,7,17,6,11,27,3,24,0.8571428571428571,0.42857142857142855,0.35294117647058826,0.8571428571428571,0.1111111111111111,0.42857142857142855
Talo-patello-scaphoid osteolysis,27572,1,6,19,5,14,28,0,28,0.8333333333333334,0.0,0.2631578947368421,0.8333333333333334,0.0,0.0
Thiamine-responsive megaloblastic anemia syndrome,28236,1,20,16,9,7,25,3,22,0.45,0.15,0.5625,0.45,0.12,0.15
Blomstrand lethal chondrodysplasia,30248,0,37,18,2,16,46,0,46,0.05405405405405406,0.0,0.1111111111111111,0.05405405405405406,0.0,0.0
Braddock syndrome,31182,0,24,17,12,5,19,0,19,0.5,0.0,0.7058823529411765,0.5,0.0,0.0
Potocki-Shaffer syndrome,29123,3,23,17,12,5,32,3,29,0.5217391304347826,0.13043478260869565,0.7058823529411765,0.5217391304347826,0.09375,0.13043478260869565
Branchiogenic deafness syndrome,32168,0,21,18,16,2,32,0,32,0.7619047619047619,0.0,0.8888888888888888,0.7619047619047619,0.0,0.0
Keratolytic winter erythema,30620,5,3,18,3,15,19,2,17,1.0,0.6666666666666666,0.16666666666666666,1.0,0.10526315789473684,0.6666666666666666
Striate palmoplantar keratoderma,28842,5,3,13,1,12,9,1,8,0.3333333333333333,0.3333333333333333,0.07692307692307693,0.3333333333333333,0.1111111111111111,0.3333333333333333
Sebocystomatosis,29397,3,3,23,2,21,14,0,14,0.6666666666666666,0.0,0.08695652173913043,0.6666666666666666,0.0,0.0
Lipoid proteinosis,31566,1,23,19,17,2,27,3,24,0.7391304347826086,0.13043478260869565,0.8947368421052632,0.7391304347826086,0.1111111111111111,0.13043478260869565
Porokeratosis of Mibelli,32975,9,5,19,5,14,17,3,14,1.0,0.6,0.2631578947368421,1.0,0.17647058823529413,0.6
Familial multiple trichoepithelioma,28726,4,4,13,3,10,36,0,36,0.75,0.0,0.23076923076923078,0.75,0.0,0.0
Bullous pemphigoid,33194,8,15,17,7,10,35,5,30,0.4666666666666667,0.3333333333333333,0.4117647058823529,0.4666666666666667,0.14285714285714285,0.3333333333333333
Relapsing polychondritis,33203,1,53,17,18,-1,39,5,34,0.33962264150943394,0.09433962264150944,1.0588235294117647,0.33962264150943394,0.1282051282051282,0.09433962264150944
Hypoplasminogenemia,28591,0,16,21,13,8,19,0,19,0.8125,0.0,0.6190476190476191,0.8125,0.0,0.0
Desmoid tumor,30659,3,20,18,17,1,29,4,25,0.85,0.2,0.9444444444444444,0.85,0.13793103448275862,0.2
Muscle-eye-brain disease,33277,1,23,16,16,0,18,4,14,0.6956521739130435,0.17391304347826086,1.0,0.6956521739130435,0.2222222222222222,0.17391304347826086
"Distal myopathy, Welander type",27805,4,13,18,13,5,29,3,26,1.0,0.23076923076923078,0.7222222222222222,1.0,0.10344827586206896,0.23076923076923078
Congenital primary megaureter,98139,2,10,5,1,4,25,5,20,0.1,0.5,0.2,0.1,0.2,0.5
"Congenital muscular dystrophy, Fukuyama type",28595,3,31,24,9,15,24,2,22,0.2903225806451613,0.06451612903225806,0.375,0.2903225806451613,0.08333333333333333,0.06451612903225806
Acrokeratoelastoidosis of Costa,38117,5,12,16,0,16,10,2,8,0.0,0.16666666666666666,0.0,0.0,0.2,0.16666666666666666
Dyschromatosis universalis hereditaria,29842,0,9,16,10,6,24,0,24,1.1111111111111112,0.0,0.625,1.1111111111111112,0.0,0.0
Familial cylindromatosis,29866,0,2,11,2,9,34,0,34,1.0,0.0,0.18181818181818182,1.0,0.0,0.0
Dyschromatosis symmetrica hereditaria,29842,1,4,16,5,11,33,0,33,1.25,0.0,0.3125,1.25,0.0,0.0
Acquired ichthyosis,39370,6,15,22,2,20,14,3,11,0.13333333333333333,0.2,0.09090909090909091,0.13333333333333333,0.21428571428571427,0.2
Hyperkeratosis lenticularis perstans,28179,1,7,13,5,8,26,1,25,0.7142857142857143,0.14285714285714285,0.38461538461538464,0.7142857142857143,0.038461538461538464,0.14285714285714285
Progressive symmetric erythrokeratodermia,38275,6,3,26,1,25,15,3,12,0.3333333333333333,1.0,0.038461538461538464,0.3333333333333333,0.2,1.0
Hereditary leiomyomatosis and renal cell cancer,30295,0,11,17,10,7,19,0,19,0.9090909090909091,0.0,0.5882352941176471,0.9090909090909091,0.0,0.0
Erythroderma desquamativum,38275,9,4,27,0,27,13,0,13,0.0,0.0,0.0,0.0,0.0,0.0
Familial keratoacanthoma,33441,2,7,19,7,12,9,0,9,1.0,0.0,0.3684210526315789,1.0,0.0,0.0
Jessner lymphocytic infiltration of the skin,32420,1,6,21,6,15,6,3,3,1.0,0.5,0.2857142857142857,1.0,0.5,0.5
Bullous lichen planus,32619,8,5,26,5,21,29,2,27,1.0,0.4,0.19230769230769232,1.0,0.06896551724137931,0.4
Glutamate-cysteine ligase deficiency,95085,13,15,25,1,24,31,1,30,0.06666666666666667,0.06666666666666667,0.04,0.06666666666666667,0.03225806451612903,0.06666666666666667
Nodular non-suppurative panniculitis,32789,6,15,17,15,2,33,6,27,1.0,0.4,0.8823529411764706,1.0,0.18181818181818182,0.4
Naxos disease,28931,3,14,22,11,11,25,4,21,0.7857142857142857,0.2857142857142857,0.5,0.7857142857142857,0.16,0.2857142857142857
Non-syndromic sagittal craniosynostosis,38233,10,4,32,1,31,28,3,25,0.25,0.75,0.03125,0.25,0.10714285714285714,0.75
Non-syndromic bicoronal craniosynostosis,27344,5,11,31,2,29,35,2,33,0.18181818181818182,0.18181818181818182,0.06451612903225806,0.18181818181818182,0.05714285714285714,0.18181818181818182
Nanophthalmos,29133,14,6,21,2,19,20,2,18,0.3333333333333333,0.3333333333333333,0.09523809523809523,0.3333333333333333,0.1,0.3333333333333333
ALDH18A1-related De Barsy syndrome,31539,2,5,17,2,15,27,1,26,0.4,0.2,0.11764705882352941,0.4,0.037037037037037035,0.2
Erdheim-Chester disease,33533,2,41,18,17,1,23,6,17,0.4146341463414634,0.14634146341463414,0.9444444444444444,0.4146341463414634,0.2608695652173913,0.14634146341463414
Polycythemia vera,29118,4,35,19,13,6,19,7,12,0.37142857142857144,0.2,0.6842105263157895,0.37142857142857144,0.3684210526315789,0.2
Idiopathic acute eosinophilic pneumonia,33206,8,11,18,10,8,21,5,16,0.9090909090909091,0.45454545454545453,0.5555555555555556,0.9090909090909091,0.23809523809523808,0.45454545454545453
Pseudomyxoma peritonei,33551,8,12,16,11,5,17,5,12,0.9166666666666666,0.4166666666666667,0.6875,0.9166666666666666,0.29411764705882354,0.4166666666666667
Follicular lymphoma,30514,17,17,19,4,15,31,4,27,0.23529411764705882,0.23529411764705882,0.21052631578947367,0.23529411764705882,0.12903225806451613,0.23529411764705882
Spontaneous periodic hypothermia,33550,4,16,16,13,3,22,7,15,0.8125,0.4375,0.8125,0.8125,0.3181818181818182,0.4375
Reactive arthritis,32464,4,36,17,16,1,25,5,20,0.4444444444444444,0.1388888888888889,0.9411764705882353,0.4444444444444444,0.2,0.1388888888888889
Dermatofibrosarcoma protuberans,33089,9,8,15,7,8,23,4,19,0.875,0.5,0.4666666666666667,0.875,0.17391304347826086,0.5
Hereditary arginine vasopressin deficiency,29832,1,9,16,2,14,38,4,34,0.2222222222222222,0.4444444444444444,0.125,0.2222222222222222,0.10526315789473684,0.4444444444444444
Tumor necrosis factor receptor 1 associated periodic syndrome,30937,1,40,18,15,3,26,2,24,0.375,0.05,0.8333333333333334,0.375,0.07692307692307693,0.05
Autosomal agammaglobulinemia,27170,1,29,19,10,9,26,4,22,0.3448275862068966,0.13793103448275862,0.5263157894736842,0.3448275862068966,0.15384615384615385,0.13793103448275862
Lymphedema-distichiasis syndrome,30797,2,26,26,17,9,34,1,33,0.6538461538461539,0.038461538461538464,0.6538461538461539,0.6538461538461539,0.029411764705882353,0.038461538461538464
Waldenström macroglobulinemia,28306,0,45,14,3,11,29,8,21,0.06666666666666667,0.17777777777777778,0.21428571428571427,0.06666666666666667,0.27586206896551724,0.17777777777777778
Idiopathic hypersomnia,32201,9,11,20,4,16,15,3,12,0.36363636363636365,0.2727272727272727,0.2,0.36363636363636365,0.2,0.2727272727272727
Autosomal erythropoietic protoporphyria,33555,7,10,25,8,17,42,3,39,0.8,0.3,0.32,0.8,0.07142857142857142,0.3
Alpha-N-acetylgalactosaminidase deficiency type 1,30022,0,30,20,14,6,2,0,2,0.4666666666666667,0.0,0.7,0.4666666666666667,0.0,0.0
Acute intermittent porphyria,30961,8,51,25,5,20,19,7,12,0.09803921568627451,0.13725490196078433,0.2,0.09803921568627451,0.3684210526315789,0.13725490196078433
Galactose epimerase deficiency,98355,12,13,32,4,28,19,1,18,0.3076923076923077,0.07692307692307693,0.125,0.3076923076923077,0.05263157894736842,0.07692307692307693
Crigler-Najjar syndrome type 1,27412,2,14,17,10,7,24,2,22,0.7142857142857143,0.14285714285714285,0.5882352941176471,0.7142857142857143,0.08333333333333333,0.14285714285714285
Crigler-Najjar syndrome type 2,27412,2,3,17,1,16,26,0,26,0.3333333333333333,0.0,0.058823529411764705,0.3333333333333333,0.0,0.0
Holocarboxylase synthetase deficiency,28786,1,20,17,13,4,26,2,24,0.65,0.1,0.7647058823529411,0.65,0.07692307692307693,0.1
Classic phenylketonuria,31918,1,26,26,11,15,30,1,29,0.4230769230769231,0.038461538461538464,0.4230769230769231,0.4230769230769231,0.03333333333333333,0.038461538461538464
Biotinidase deficiency,28555,2,38,43,34,9,26,4,22,0.8947368421052632,0.10526315789473684,0.7906976744186046,0.8947368421052632,0.15384615384615385,0.10526315789473684
L-2-hydroxyglutaric aciduria,30308,1,12,17,5,12,39,1,38,0.4166666666666667,0.08333333333333333,0.29411764705882354,0.4166666666666667,0.02564102564102564,0.08333333333333333
Vitamin B12-unresponsive methylmalonic acidemia type mut-,33189,0,29,17,14,3,20,2,18,0.4827586206896552,0.06896551724137931,0.8235294117647058,0.4827586206896552,0.1,0.06896551724137931
ALG3-CDG,31949,3,45,20,5,15,20,3,17,0.1111111111111111,0.06666666666666667,0.25,0.1111111111111111,0.15,0.06666666666666667
"Methylmalonic acidemia with homocystinuria, type cblD",33171,7,12,18,6,12,30,2,28,0.5,0.16666666666666666,0.3333333333333333,0.5,0.06666666666666667,0.16666666666666666
Alpha-N-acetylgalactosaminidase deficiency type 3,30022,0,8,17,3,14,5,0,5,0.375,0.0,0.17647058823529413,0.375,0.0,0.0
Alpha-N-acetylgalactosaminidase deficiency type 2,28665,0,18,23,1,22,3,0,3,0.05555555555555555,0.0,0.043478260869565216,0.05555555555555555,0.0,0.0
Congenital bile acid synthesis defect type 1,28517,4,16,33,15,18,19,4,15,0.9375,0.25,0.45454545454545453,0.9375,0.21052631578947367,0.25
Fish-eye disease,30458,0,8,17,9,8,26,1,25,1.125,0.125,0.5294117647058824,1.125,0.038461538461538464,0.125
Trichorhinophalangeal syndrome type 1,27224,0,29,18,7,11,17,0,17,0.2413793103448276,0.0,0.3888888888888889,0.2413793103448276,0.0,0.0
Gaucher disease type 1,28772,5,49,110,31,79,29,10,19,0.6326530612244898,0.20408163265306123,0.2818181818181818,0.6326530612244898,0.3448275862068966,0.20408163265306123
Gaucher disease type 2,28772,1,33,28,5,23,17,2,15,0.15151515151515152,0.06060606060606061,0.17857142857142858,0.15151515151515152,0.11764705882352941,0.06060606060606061
Gaucher disease type 3,28772,0,40,33,17,16,13,6,7,0.425,0.15,0.5151515151515151,0.425,0.46153846153846156,0.15
Majeed syndrome,28357,0,32,39,34,5,17,0,17,1.0625,0.0,0.8717948717948718,1.0625,0.0,0.0
Anophthalmia/microphthalmia-esophageal atresia syndrome,30389,4,22,31,13,18,30,7,23,0.5909090909090909,0.3181818181818182,0.41935483870967744,0.5909090909090909,0.23333333333333334,0.3181818181818182
Monosomy 9q22.3 syndrome,33183,1,46,17,14,3,30,2,28,0.30434782608695654,0.043478260869565216,0.8235294117647058,0.30434782608695654,0.06666666666666667,0.043478260869565216
Bradyopsia,27501,17,2,26,3,23,28,2,26,1.5,1.0,0.11538461538461539,1.5,0.07142857142857142,1.0
Oligocone trichromacy,32826,16,2,26,2,24,32,1,31,1.0,0.5,0.07692307692307693,1.0,0.03125,0.5
Brain malformation-congenital heart disease-postaxial polydactyly syndrome,32786,2,24,18,17,1,40,5,35,0.7083333333333334,0.20833333333333334,0.9444444444444444,0.7083333333333334,0.125,0.20833333333333334
Periodontal Ehlers-Danlos syndrome,32781,12,12,28,12,16,29,2,27,1.0,0.16666666666666666,0.42857142857142855,1.0,0.06896551724137931,0.16666666666666666
B4GALT7-related spondylodysplastic Ehlers-Danlos syndrome,31142,1,37,33,9,24,23,1,22,0.24324324324324326,0.02702702702702703,0.2727272727272727,0.24324324324324326,0.043478260869565216,0.02702702702702703
X-linked Ehlers-Danlos syndrome,32968,8,10,24,7,17,27,0,27,0.7,0.0,0.2916666666666667,0.7,0.0,0.0
X-linked sideroblastic anemia,29390,2,10,20,4,16,34,2,32,0.4,0.2,0.2,0.4,0.058823529411764705,0.2
Focal facial dermal dysplasia type I,27910,2,17,22,5,17,37,0,37,0.29411764705882354,0.0,0.22727272727272727,0.29411764705882354,0.0,0.0
Hereditary painful callosities,29966,6,2,18,2,16,19,1,18,1.0,0.5,0.1111111111111111,1.0,0.05263157894736842,0.5
Seizures-intellectual disability due to hydroxylysinuria syndrome,27998,13,3,25,3,22,33,1,32,1.0,0.3333333333333333,0.12,1.0,0.030303030303030304,0.3333333333333333
Disseminated superficial actinic porokeratosis,28427,6,4,24,1,23,20,1,19,0.25,0.25,0.041666666666666664,0.25,0.05,0.25
HJV or HAMP-related hemochromatosis,28176,2,15,17,2,15,21,1,20,0.13333333333333333,0.06666666666666667,0.11764705882352941,0.13333333333333333,0.047619047619047616,0.06666666666666667
Acquired partial lipodystrophy,31864,3,17,18,6,12,39,3,36,0.35294117647058826,0.17647058823529413,0.3333333333333333,0.35294117647058826,0.07692307692307693,0.17647058823529413
"Familial partial lipodystrophy, Köbberling type",27788,2,12,17,4,13,39,4,35,0.3333333333333333,0.3333333333333333,0.23529411764705882,0.3333333333333333,0.10256410256410256,0.3333333333333333
Grange syndrome,31322,0,10,16,9,7,17,0,17,0.9,0.0,0.5625,0.9,0.0,0.0
Developmental malformations-deafness-dystonia syndrome,29667,18,21,31,1,30,27,1,26,0.047619047619047616,0.047619047619047616,0.03225806451612903,0.047619047619047616,0.037037037037037035,0.047619047619047616
Trichodysplasia-amelogenesis imperfecta syndrome,33379,2,3,10,3,7,23,0,23,1.0,0.0,0.3,1.0,0.0,0.0
Mandibulofacial dysostosis-microcephaly syndrome,30391,2,30,31,4,27,14,1,13,0.13333333333333333,0.03333333333333333,0.12903225806451613,0.13333333333333333,0.07142857142857142,0.03333333333333333
Hypotrichosis-lymphedema-telangiectasia-renal defect syndrome,30021,2,16,20,4,16,28,0,28,0.25,0.0,0.2,0.25,0.0,0.0
Rhabdoid tumor,33519,0,24,17,17,0,34,0,34,0.7083333333333334,0.0,1.0,0.7083333333333334,0.0,0.0
Liposarcoma,33520,8,9,19,9,10,34,6,28,1.0,0.6666666666666666,0.47368421052631576,1.0,0.17647058823529413,0.6666666666666666
Idiopathic steroid-sensitive nephrotic syndrome,33491,15,2,19,0,19,23,0,23,0.0,0.0,0.0,0.0,0.0,0.0
Congenital membranous nephropathy due to fetomaternal anti-neutral endopeptidase alloimmunization,33493,14,5,26,3,23,20,3,17,0.6,0.6,0.11538461538461539,0.6,0.15,0.6
3-methylglutaconic aciduria type 4,28809,5,17,17,4,13,27,3,24,0.23529411764705882,0.17647058823529413,0.23529411764705882,0.23529411764705882,0.1111111111111111,0.17647058823529413
3-methylglutaconic aciduria type 1,28809,6,13,17,0,17,29,0,29,0.0,0.0,0.0,0.0,0.0,0.0
3-methylglutaconic aciduria type 3,28809,3,9,17,4,13,32,2,30,0.4444444444444444,0.2222222222222222,0.23529411764705882,0.4444444444444444,0.0625,0.2222222222222222
Mast cell sarcoma,33168,8,9,20,10,10,24,2,22,1.1111111111111112,0.2222222222222222,0.5,1.1111111111111112,0.08333333333333333,0.2222222222222222
Diaphanospondylodysostosis,31125,0,11,18,5,13,34,0,34,0.45454545454545453,0.0,0.2777777777777778,0.45454545454545453,0.0,0.0
Progressive bifocal chorioretinal atrophy,30685,9,7,18,6,12,27,2,25,0.8571428571428571,0.2857142857142857,0.3333333333333333,0.8571428571428571,0.07407407407407407,0.2857142857142857
Cholesteryl ester storage disease,32691,8,13,24,11,13,25,3,22,0.8461538461538461,0.23076923076923078,0.4583333333333333,0.8461538461538461,0.12,0.23076923076923078
Wolman disease,32119,13,17,38,3,35,40,4,36,0.17647058823529413,0.23529411764705882,0.07894736842105263,0.17647058823529413,0.1,0.23529411764705882
Growth delay due to insulin-like growth factor I resistance,29297,1,16,32,14,18,27,2,25,0.875,0.125,0.4375,0.875,0.07407407407407407,0.125
Visceral neuropathy-brain anomalies-facial dysmorphism-developmental delay syndrome,32245,1,25,21,20,1,39,1,38,0.8,0.04,0.9523809523809523,0.8,0.02564102564102564,0.04
Psychogenic movement disorders,32586,6,3,28,3,25,24,1,23,1.0,0.3333333333333333,0.10714285714285714,1.0,0.041666666666666664,0.3333333333333333
Familial thrombocytosis,32293,1,24,16,16,0,27,3,24,0.6666666666666666,0.125,1.0,0.6666666666666666,0.1111111111111111,0.125
Radio-ulnar synostosis-amegakaryocytic thrombocytopenia syndrome,27384,2,6,17,3,14,26,1,25,0.5,0.16666666666666666,0.17647058823529413,0.5,0.038461538461538464,0.16666666666666666
Silent sinus syndrome,33371,11,3,26,3,23,22,0,22,1.0,0.0,0.11538461538461539,1.0,0.0,0.0
Dentinogenesis imperfecta-short stature-hearing loss-intellectual disability syndrome,33367,8,11,22,8,14,26,3,23,0.7272727272727273,0.2727272727272727,0.36363636363636365,0.7272727272727273,0.11538461538461539,0.2727272727272727
Transient predisposition to invasive pyogenic bacterial infection,30848,1,7,19,4,15,32,2,30,0.5714285714285714,0.2857142857142857,0.21052631578947367,0.5714285714285714,0.0625,0.2857142857142857
Cholangiocarcinoma,33045,11,8,14,7,7,20,9,11,0.875,1.125,0.5,0.875,0.45,1.125
Angel-shaped phalango-epiphyseal dysplasia,28746,0,11,15,12,3,28,0,28,1.0909090909090908,0.0,0.8,1.0909090909090908,0.0,0.0
Acrocapitofemoral dysplasia,27442,2,21,19,11,8,25,5,20,0.5238095238095238,0.23809523809523808,0.5789473684210527,0.5238095238095238,0.2,0.23809523809523808
Paraneoplastic pemphigus,32966,2,7,17,6,11,33,1,32,0.8571428571428571,0.14285714285714285,0.35294117647058826,0.8571428571428571,0.030303030303030304,0.14285714285714285
Iniencephaly,94630,8,31,28,0,28,29,2,27,0.0,0.06451612903225806,0.0,0.0,0.06896551724137931,0.06451612903225806
Craniorachischisis,32690,5,9,23,7,16,13,1,12,0.7777777777777778,0.1111111111111111,0.30434782608695654,0.7777777777777778,0.07692307692307693,0.1111111111111111
Pemphigoid gestationis,32669,4,6,11,6,5,22,3,19,1.0,0.5,0.5454545454545454,1.0,0.13636363636363635,0.5
Rhombencephalosynapsis,33065,1,30,24,23,1,8,1,7,0.7666666666666667,0.03333333333333333,0.9583333333333334,0.7666666666666667,0.125,0.03333333333333333
Loeys-Dietz syndrome,31164,3,30,39,18,21,20,6,14,0.6,0.2,0.46153846153846156,0.6,0.3,0.2
Megalencephaly-capillary malformation-polymicrogyria syndrome,31062,1,35,39,26,13,1,1,0,0.7428571428571429,0.02857142857142857,0.6666666666666666,0.7428571428571429,1.0,0.02857142857142857
Cold agglutinin disease,33080,9,14,17,13,4,29,6,23,0.9285714285714286,0.42857142857142855,0.7647058823529411,0.9285714285714286,0.20689655172413793,0.42857142857142855
Mazabraud syndrome,33123,9,5,19,5,14,29,1,28,1.0,0.2,0.2631578947368421,1.0,0.034482758620689655,0.2
Neonatal ichthyosis-sclerosing cholangitis syndrome,29850,4,15,24,13,11,21,3,18,0.8666666666666667,0.2,0.5416666666666666,0.8666666666666667,0.14285714285714285,0.2
Congenital pseudoarthrosis of the clavicle,30585,3,6,10,2,8,25,1,24,0.3333333333333333,0.16666666666666666,0.2,0.3333333333333333,0.04,0.16666666666666666
Goldberg-Shprintzen megacolon syndrome,30475,0,23,24,14,10,21,0,21,0.6086956521739131,0.0,0.5833333333333334,0.6086956521739131,0.0,0.0
Sensorineural hearing loss-early graying-essential tremor syndrome,33181,7,5,18,3,15,24,3,21,0.6,0.6,0.16666666666666666,0.6,0.125,0.6
Benign recurrent intrahepatic cholestasis,31033,7,16,17,12,5,24,6,18,0.75,0.375,0.7058823529411765,0.75,0.25,0.375
Permanent neonatal diabetes mellitus-pancreatic and cerebellar agenesis syndrome,31103,2,7,24,8,16,21,0,21,1.1428571428571428,0.0,0.3333333333333333,1.1428571428571428,0.0,0.0
Monomelic amyotrophy,28519,0,10,17,12,5,12,2,10,1.2,0.2,0.7058823529411765,1.2,0.16666666666666666,0.2
3q29 microdeletion syndrome,33028,2,44,17,5,12,32,4,28,0.11363636363636363,0.09090909090909091,0.29411764705882354,0.11363636363636363,0.125,0.09090909090909091
Lhermitte-Duclos disease,32948,2,18,17,16,1,26,2,24,0.8888888888888888,0.1111111111111111,0.9411764705882353,0.8888888888888888,0.07692307692307693,0.1111111111111111
Pulmonary blastoma,33030,8,9,18,8,10,17,7,10,0.8888888888888888,0.7777777777777778,0.4444444444444444,0.8888888888888888,0.4117647058823529,0.7777777777777778
Schisis association,32295,0,15,25,10,15,19,0,19,0.6666666666666666,0.0,0.4,0.6666666666666666,0.0,0.0
Becker nevus syndrome,29934,0,19,15,13,2,29,0,29,0.6842105263157895,0.0,0.8666666666666667,0.6842105263157895,0.0,0.0
Nevus comedonicus syndrome,31358,0,16,15,7,8,10,0,10,0.4375,0.0,0.4666666666666667,0.4375,0.0,0.0
X-linked spinocerebellar ataxia type 3,29145,2,6,18,4,14,3,1,2,0.6666666666666666,0.16666666666666666,0.2222222222222222,0.6666666666666666,0.3333333333333333,0.16666666666666666
"HSD10 disease, atypical type",32958,3,3,51,2,49,33,0,33,0.6666666666666666,0.0,0.0392156862745098,0.6666666666666666,0.0,0.0
X-linked epilepsy-learning disabilities-behavior disorders syndrome,31029,10,4,22,5,17,18,0,18,1.25,0.0,0.22727272727272727,1.25,0.0,0.0
"X-linked intellectual disability, Cabezas type",27603,5,49,54,7,47,28,2,26,0.14285714285714285,0.04081632653061224,0.12962962962962962,0.14285714285714285,0.07142857142857142,0.04081632653061224
"Deafness-intellectual disability syndrome, Martin-Probst type",29667,8,32,26,2,24,17,1,16,0.0625,0.03125,0.07692307692307693,0.0625,0.058823529411764705,0.03125
X-linked intellectual disability-macrocephaly-macroorchidism syndrome,32561,12,3,20,2,18,31,2,29,0.6666666666666666,0.6666666666666666,0.1,0.6666666666666666,0.06451612903225806,0.6666666666666666
X-linked intellectual disability-hypogammaglobulinemia-progressive neurological deterioration syndrome,32559,4,21,17,17,0,16,4,12,0.8095238095238095,0.19047619047619047,1.0,0.8095238095238095,0.25,0.19047619047619047
X-linked intellectual disability-hypotonia-facial dysmorphism-aggressive behavior syndrome,32547,0,19,17,17,0,21,0,21,0.8947368421052632,0.0,1.0,0.8947368421052632,0.0,0.0
"X-linked intellectual disability, Stevenson type",38443,17,22,25,0,25,27,1,26,0.0,0.045454545454545456,0.0,0.0,0.037037037037037035,0.045454545454545456
"X-linked intellectual disability, Shrimpton type",28944,3,5,18,1,17,26,0,26,0.2,0.0,0.05555555555555555,0.2,0.0,0.0
"X-linked intellectual disability, Pai type",28944,5,18,21,4,17,29,2,27,0.2222222222222222,0.1111111111111111,0.19047619047619047,0.2222222222222222,0.06896551724137931,0.1111111111111111
"X-linked neurodegenerative syndrome, Bertini type",32534,4,10,17,10,7,18,1,17,1.0,0.1,0.5882352941176471,1.0,0.05555555555555555,0.1
X-linked intellectual disability-retinitis pigmentosa syndrome,28653,8,2,25,2,23,25,1,24,1.0,0.5,0.08,1.0,0.04,0.5
X-linked intellectual disability-ataxia-apraxia syndrome,32533,9,5,22,4,18,17,2,15,0.8,0.4,0.18181818181818182,0.8,0.11764705882352941,0.4
Fried syndrome,32536,0,21,17,16,1,33,0,33,0.7619047619047619,0.0,0.9411764705882353,0.7619047619047619,0.0,0.0
"X-linked neurodegenerative syndrome, Hamel type",32532,2,6,23,6,17,12,0,12,1.0,0.0,0.2608695652173913,1.0,0.0,0.0
Systemic-onset juvenile idiopathic arthritis,98688,17,22,25,5,20,29,6,23,0.22727272727272727,0.2727272727272727,0.2,0.22727272727272727,0.20689655172413793,0.2727272727272727
Rheumatoid factor-positive polyarticular juvenile idiopathic arthritis,32726,8,19,19,7,12,30,6,24,0.3684210526315789,0.3157894736842105,0.3684210526315789,0.3684210526315789,0.2,0.3157894736842105
X-linked severe congenital neutropenia,27468,12,3,16,3,13,33,2,31,1.0,0.6666666666666666,0.1875,1.0,0.06060606060606061,0.6666666666666666
Benign adult familial myoclonic epilepsy,29656,2,8,16,7,9,23,2,21,0.875,0.25,0.4375,0.875,0.08695652173913043,0.25
Diffuse palmoplantar keratoderma-acrocyanosis syndrome,33067,6,2,17,1,16,6,0,6,0.5,0.0,0.058823529411764705,0.5,0.0,0.0
Alport syndrome-intellectual disability-midface hypoplasia-elliptocytosis syndrome,28039,1,22,17,13,4,32,0,32,0.5909090909090909,0.0,0.7647058823529411,0.5909090909090909,0.0,0.0
Nodular lymphocyte predominant Hodgkin lymphoma,32866,4,14,16,16,0,20,4,16,1.1428571428571428,0.2857142857142857,1.0,1.1428571428571428,0.2,0.2857142857142857
Craniofacial conodysplasia,33477,7,5,24,6,18,28,4,24,1.2,0.8,0.25,1.2,0.14285714285714285,0.8
"Mesomelic dysplasia, Savarirayan type",38211,25,15,41,3,38,38,2,36,0.2,0.13333333333333333,0.07317073170731707,0.2,0.05263157894736842,0.13333333333333333
Familial digital arthropathy-brachydactyly,27205,1,6,16,7,9,28,0,28,1.1666666666666667,0.0,0.4375,1.1666666666666667,0.0,0.0
"Microcephalic osteodysplastic dysplasia, Saul-Wilson type",29899,2,16,33,14,19,22,1,21,0.875,0.0625,0.42424242424242425,0.875,0.045454545454545456,0.0625
Astley-Kendall dysplasia,33478,0,4,7,4,3,19,0,19,1.0,0.0,0.5714285714285714,1.0,0.0,0.0
Pseudodiastrophic dysplasia,29738,0,9,17,4,13,27,0,27,0.4444444444444444,0.0,0.23529411764705882,0.4444444444444444,0.0,0.0
Spondylo-ocular syndrome,27340,1,31,25,17,8,29,1,28,0.5483870967741935,0.03225806451612903,0.68,0.5483870967741935,0.034482758620689655,0.03225806451612903
Idiopathic juvenile osteoporosis,27458,8,6,20,5,15,26,3,23,0.8333333333333334,0.5,0.25,0.8333333333333334,0.11538461538461539,0.5
Dysspondyloenchondromatosis,38339,18,23,28,1,27,22,0,22,0.043478260869565216,0.0,0.03571428571428571,0.043478260869565216,0.0,0.0
Genochondromatosis type 1,30693,0,3,14,2,12,17,0,17,0.6666666666666666,0.0,0.14285714285714285,0.6666666666666666,0.0,0.0
Genitopatellar syndrome,30118,1,38,46,31,15,18,1,17,0.8157894736842105,0.02631578947368421,0.6739130434782609,0.8157894736842105,0.05555555555555555,0.02631578947368421
Craniosynostosis-anal anomalies-porokeratosis syndrome,29126,3,35,42,29,13,41,5,36,0.8285714285714286,0.14285714285714285,0.6904761904761905,0.8285714285714286,0.12195121951219512,0.14285714285714285
Acropectoral syndrome,30936,0,3,19,3,16,18,0,18,1.0,0.0,0.15789473684210525,1.0,0.0,0.0
Keutel syndrome,31666,0,24,19,11,8,6,0,6,0.4583333333333333,0.0,0.5789473684210527,0.4583333333333333,0.0,0.0
Fetal Gaucher disease,30366,2,31,17,8,9,25,3,22,0.25806451612903225,0.0967741935483871,0.47058823529411764,0.25806451612903225,0.12,0.0967741935483871
"X-linked intellectual disability, Abidi type",28944,6,12,29,3,26,30,4,26,0.25,0.3333333333333333,0.10344827586206896,0.25,0.13333333333333333,0.3333333333333333
Syndromic X-linked intellectual disability 7,38443,12,15,27,3,24,33,4,29,0.2,0.26666666666666666,0.1111111111111111,0.2,0.12121212121212122,0.26666666666666666
Microphthalmia-ankyloblepharon-intellectual disability syndrome,32291,13,4,29,4,25,24,2,22,1.0,0.5,0.13793103448275862,1.0,0.08333333333333333,0.5
"X-linked intellectual disability, Armfield type",29211,1,38,16,14,2,23,0,23,0.3684210526315789,0.0,0.875,0.3684210526315789,0.0,0.0
"X-linked intellectual disability, Cantagrel type",28944,3,18,24,4,20,24,1,23,0.2222222222222222,0.05555555555555555,0.16666666666666666,0.2222222222222222,0.041666666666666664,0.05555555555555555
Christianson syndrome,31574,0,49,58,33,25,21,0,21,0.673469387755102,0.0,0.5689655172413793,0.673469387755102,0.0,0.0
KDM5C-related syndromic X-linked intellectual disability,38443,13,25,28,2,26,31,1,30,0.08,0.04,0.07142857142857142,0.08,0.03225806451612903,0.04
X-linked intellectual disability-cubitus valgus-dysmorphism syndrome,32093,2,17,15,14,1,36,3,33,0.8235294117647058,0.17647058823529413,0.9333333333333333,0.8235294117647058,0.08333333333333333,0.17647058823529413
MEHMO syndrome,31400,0,25,18,0,18,16,0,16,0.0,0.0,0.0,0.0,0.0,0.0
"X-linked intellectual disability, Miles-Carpenter type",28944,4,9,20,0,20,31,0,31,0.0,0.0,0.0,0.0,0.0,0.0
BRESEK syndrome,32285,0,29,20,20,0,12,0,12,0.6896551724137931,0.0,1.0,0.6896551724137931,0.0,0.0
"X-linked intellectual disability, Shashi type",28944,5,12,21,1,20,32,1,31,0.08333333333333333,0.08333333333333333,0.047619047619047616,0.08333333333333333,0.03125,0.08333333333333333
"X-linked intellectual disability, Siderius type",38443,9,12,22,0,22,23,0,23,0.0,0.0,0.0,0.0,0.0,0.0
Oculocutaneous albinism type 4,84278,11,15,25,8,17,31,9,22,0.5333333333333333,0.6,0.32,0.5333333333333333,0.2903225806451613,0.6
Oculocutaneous albinism type 1B,84278,7,17,30,7,23,33,7,26,0.4117647058823529,0.4117647058823529,0.23333333333333334,0.4117647058823529,0.21212121212121213,0.4117647058823529
Ichthyosis hystrix of Curth-Macklin,31739,9,8,21,6,15,17,2,15,0.75,0.25,0.2857142857142857,0.75,0.11764705882352941,0.25
Griscelli syndrome type 3,27582,3,3,58,3,55,26,0,26,1.0,0.0,0.05172413793103448,1.0,0.0,0.0
Griscelli syndrome type 2,27582,3,19,58,20,38,31,2,29,1.0526315789473684,0.10526315789473684,0.3448275862068966,1.0526315789473684,0.06451612903225806,0.10526315789473684
Griscelli syndrome type 1,27582,4,16,58,15,43,34,0,34,0.9375,0.0,0.25862068965517243,0.9375,0.0,0.0
Macrostomia-preauricular tags-external ophthalmoplegia syndrome,32745,9,8,25,7,18,28,1,27,0.875,0.125,0.28,0.875,0.03571428571428571,0.125
LUMBAR syndrome,32086,4,17,36,0,36,21,0,21,0.0,0.0,0.0,0.0,0.0,0.0
Desmoplastic small round cell tumor,32307,4,18,16,18,-2,25,6,19,1.0,0.3333333333333333,1.125,1.0,0.24,0.3333333333333333
Megalencephaly-polymicrogyria-postaxial polydactyly-hydrocephalus syndrome,32294,3,16,13,13,0,27,4,23,0.8125,0.25,1.0,0.8125,0.14814814814814814,0.25
Congenital primary aphakia,30592,0,13,10,6,4,23,1,22,0.46153846153846156,0.07692307692307693,0.6,0.46153846153846156,0.043478260869565216,0.07692307692307693
Narcolepsy type 2,32306,10,5,25,3,22,22,2,20,0.6,0.4,0.12,0.6,0.09090909090909091,0.4
Scrub typhus,33542,5,27,16,15,1,24,7,17,0.5555555555555556,0.25925925925925924,0.9375,0.5555555555555556,0.2916666666666667,0.25925925925925924
Severe achondroplasia-developmental delay-acanthosis nigricans syndrome,28545,0,14,34,9,25,19,1,18,0.6428571428571429,0.07142857142857142,0.2647058823529412,0.6428571428571429,0.05263157894736842,0.07142857142857142
"Platyspondylic dysplasia, Torrance type",28113,0,25,19,9,10,9,0,9,0.36,0.0,0.47368421052631576,0.36,0.0,0.0
Hypomyelination-congenital cataract syndrome,29918,1,6,24,2,22,27,0,27,0.3333333333333333,0.0,0.08333333333333333,0.3333333333333333,0.0,0.0
Camptodactyly-tall stature-scoliosis-hearing loss syndrome,30270,2,4,17,4,13,24,3,21,1.0,0.75,0.23529411764705882,1.0,0.125,0.75
Palmoplantar keratoderma-XX sex reversal-predisposition to squamous cell carcinoma syndrome,31372,3,3,17,3,14,14,3,11,1.0,1.0,0.17647058823529413,1.0,0.21428571428571427,1.0
Facial onset sensory and motor neuronopathy,33480,10,7,22,7,15,39,8,31,1.0,1.1428571428571428,0.3181818181818182,1.0,0.20512820512820512,1.1428571428571428
Hinman syndrome,30947,1,7,26,0,26,15,0,15,0.0,0.0,0.0,0.0,0.0,0.0
Fibronectin glomerulopathy,32489,7,10,17,9,8,30,4,26,0.9,0.4,0.5294117647058824,0.9,0.13333333333333333,0.4
ALG8-CDG,31949,4,48,20,4,16,22,0,22,0.08333333333333333,0.0,0.2,0.08333333333333333,0.0,0.0
Congenital ichthyosiform erythroderma,31218,3,13,18,9,9,26,3,23,0.6923076923076923,0.23076923076923078,0.5,0.6923076923076923,0.11538461538461539,0.23076923076923078
"Autosomal dominant generalized epidermolysis bullosa simplex, severe form",27434,4,44,28,11,17,32,6,26,0.25,0.13636363636363635,0.39285714285714285,0.25,0.1875,0.13636363636363635
Intermediate generalized junctional epidermolysis bullosa,27638,4,14,26,6,20,19,2,17,0.42857142857142855,0.14285714285714285,0.23076923076923078,0.42857142857142855,0.10526315789473684,0.14285714285714285
Junctional epidermolysis bullosa with pyloric atresia,28150,3,21,24,11,13,26,2,24,0.5238095238095238,0.09523809523809523,0.4583333333333333,0.5238095238095238,0.07692307692307693,0.09523809523809523
Junctional epidermolysis bullosa inversa,27638,3,25,3,2,1,35,6,29,0.08,0.24,0.6666666666666666,0.08,0.17142857142857143,0.24
Epidermolysis bullosa simplex with mottled pigmentation,29359,2,19,20,17,3,17,3,14,0.8947368421052632,0.15789473684210525,0.85,0.8947368421052632,0.17647058823529413,0.15789473684210525
Localized epidermolysis bullosa simplex,27434,1,23,30,12,18,6,1,5,0.5217391304347826,0.043478260869565216,0.4,0.5217391304347826,0.16666666666666666,0.043478260869565216
PLEC-related intermediate epidermolysis bullosa simplex without extracutaneous involvement,29474,1,12,17,5,12,18,1,17,0.4166666666666667,0.08333333333333333,0.29411764705882354,0.4166666666666667,0.05555555555555555,0.08333333333333333
Hermansky-Pudlak syndrome,27618,1,39,21,6,15,23,2,21,0.15384615384615385,0.05128205128205128,0.2857142857142857,0.15384615384615385,0.08695652173913043,0.05128205128205128
Oculocutaneous albinism type 1A,84278,16,16,35,9,26,30,7,23,0.5625,0.4375,0.2571428571428571,0.5625,0.23333333333333334,0.4375
Oculocutaneous albinism type 2,84278,5,24,24,7,17,24,6,18,0.2916666666666667,0.25,0.2916666666666667,0.2916666666666667,0.25,0.25
Late-onset junctional epidermolysis bullosa,27639,4,27,15,10,5,16,6,10,0.37037037037037035,0.2222222222222222,0.6666666666666666,0.37037037037037035,0.375,0.2222222222222222
Severe intellectual disability-epilepsy-anal anomalies-distal phalangeal hypoplasia,33467,5,16,19,13,6,31,3,28,0.8125,0.1875,0.6842105263157895,0.8125,0.0967741935483871,0.1875
Pituitary stalk interruption syndrome,32331,1,17,16,16,0,27,1,26,0.9411764705882353,0.058823529411764705,1.0,0.9411764705882353,0.037037037037037035,0.058823529411764705
Angioma serpiginosum,30271,4,4,13,0,13,42,2,40,0.0,0.5,0.0,0.0,0.047619047619047616,0.5
Acquired arginine vasopressin deficiency,29832,0,4,16,0,16,22,2,20,0.0,0.5,0.0,0.0,0.09090909090909091,0.5
Isolated epispadias,32630,2,6,11,4,7,4,0,4,0.6666666666666666,0.0,0.36363636363636365,0.6666666666666666,0.0,0.0
Hamel cerebro-palato-cardiac syndrome,32624,0,14,19,13,6,18,0,18,0.9285714285714286,0.0,0.6842105263157895,0.9285714285714286,0.0,0.0
Bladder exstrophy,31847,1,13,17,7,10,17,0,17,0.5384615384615384,0.0,0.4117647058823529,0.5384615384615384,0.0,0.0
12q14 microdeletion syndrome,32466,1,37,18,3,15,33,4,29,0.08108108108108109,0.10810810810810811,0.16666666666666666,0.08108108108108109,0.12121212121212122,0.10810810810810811
"X-linked intellectual disability, Golabi-Ito-Hall type",32625,3,19,18,19,-1,41,5,36,1.0,0.2631578947368421,1.0555555555555556,1.0,0.12195121951219512,0.2631578947368421
Deafness-infertility syndrome,28163,10,3,21,3,18,34,3,31,1.0,1.0,0.14285714285714285,1.0,0.08823529411764706,1.0
Syndactyly type 3,27398,2,3,20,4,16,31,2,29,1.3333333333333333,0.6666666666666666,0.2,1.3333333333333333,0.06451612903225806,0.6666666666666666
Syndactyly type 4,29488,1,9,18,1,17,25,2,23,0.1111111111111111,0.2222222222222222,0.05555555555555555,0.1111111111111111,0.08,0.2222222222222222
Syndactyly type 5,27398,0,8,20,3,17,31,0,31,0.375,0.0,0.15,0.375,0.0,0.0
"Brachydactyly-syndactyly, Zhao type",29488,1,7,18,7,11,11,1,10,1.0,0.14285714285714285,0.3888888888888889,1.0,0.09090909090909091,0.14285714285714285
Hurler-Scheie syndrome,27894,2,18,16,11,5,18,4,14,0.6111111111111112,0.2222222222222222,0.6875,0.6111111111111112,0.2222222222222222,0.2222222222222222
Juvenile dermatomyositis,28745,2,45,18,10,8,31,10,21,0.2222222222222222,0.2222222222222222,0.5555555555555556,0.2222222222222222,0.3225806451612903,0.2222222222222222
Brachydactyly type E,29635,4,10,30,5,25,5,0,5,0.5,0.0,0.16666666666666666,0.5,0.0,0.0
Brachydactyly type A1,29635,0,12,10,1,9,12,3,9,0.08333333333333333,0.25,0.1,0.08333333333333333,0.25,0.25
Brachydactyly type A4,29488,2,6,16,3,13,15,0,15,0.5,0.0,0.1875,0.5,0.0,0.0
Syndactyly type 1,38464,11,4,19,1,18,27,1,26,0.25,0.25,0.05263157894736842,0.25,0.037037037037037035,0.25
Syndactyly type 2,38464,6,12,35,0,35,20,0,20,0.0,0.0,0.0,0.0,0.0,0.0
"Spondyloepimetaphyseal dysplasia, Irapa type",38339,4,26,24,1,23,35,7,28,0.038461538461538464,0.2692307692307692,0.041666666666666664,0.038461538461538464,0.2,0.2692307692307692
Autosomal dominant omodysplasia,28843,0,17,18,15,3,33,0,33,0.8823529411764706,0.0,0.8333333333333334,0.8823529411764706,0.0,0.0
"Spondylometaphyseal dysplasia, Sedaghatian type",38339,17,25,35,3,32,33,3,30,0.12,0.12,0.08571428571428572,0.12,0.09090909090909091,0.12
"Brachyolmia, Maroteaux type",29676,0,8,24,7,17,22,0,22,0.875,0.0,0.2916666666666667,0.875,0.0,0.0
Achondrogenesis type 1B,27350,1,26,30,11,19,39,2,37,0.4230769230769231,0.07692307692307693,0.36666666666666664,0.4230769230769231,0.05128205128205128,0.07692307692307693
Achondrogenesis type 1A,27350,2,27,32,11,21,33,0,33,0.4074074074074074,0.0,0.34375,0.4074074074074074,0.0,0.0
Autosomal dominant brachyolmia,38181,12,6,42,1,41,22,0,22,0.16666666666666666,0.0,0.023809523809523808,0.16666666666666666,0.0,0.0
Cloverleaf skull-multiple congenital anomalies syndrome,32998,1,27,17,16,1,35,2,33,0.5925925925925926,0.07407407407407407,0.9411764705882353,0.5925925925925926,0.05714285714285714,0.07407407407407407
"Short rib-polydactyly syndrome, Verma-Naumoff type",32996,1,47,39,37,2,34,1,33,0.7872340425531915,0.02127659574468085,0.9487179487179487,0.7872340425531915,0.029411764705882353,0.02127659574468085
Crouzon syndrome-acanthosis nigricans syndrome,31353,2,28,18,15,3,27,5,22,0.5357142857142857,0.17857142857142858,0.8333333333333334,0.5357142857142857,0.18518518518518517,0.17857142857142858
Thanatophoric dysplasia type 2,30963,5,35,26,4,22,27,3,24,0.11428571428571428,0.08571428571428572,0.15384615384615385,0.11428571428571428,0.1111111111111111,0.08571428571428572
"Spondyloepiphyseal dysplasia, Kimberley type",31270,2,7,39,1,38,39,2,37,0.14285714285714285,0.2857142857142857,0.02564102564102564,0.14285714285714285,0.05128205128205128,0.2857142857142857
Fragile X-associated tremor/ataxia syndrome,30858,4,37,46,29,17,9,6,3,0.7837837837837838,0.16216216216216217,0.6304347826086957,0.7837837837837838,0.6666666666666666,0.16216216216216217
Hypocalcemic vitamin D-resistant rickets,38752,18,28,23,2,21,33,2,31,0.07142857142857142,0.07142857142857142,0.08695652173913043,0.07142857142857142,0.06060606060606061,0.07142857142857142
HNF1B-related autosomal dominant tubulointerstitial kidney disease,38907,18,29,26,5,21,30,4,26,0.1724137931034483,0.13793103448275862,0.19230769230769232,0.1724137931034483,0.13333333333333333,0.13793103448275862
Lyme disease,32950,4,24,17,16,1,20,5,15,0.6666666666666666,0.20833333333333334,0.9411764705882353,0.6666666666666666,0.25,0.20833333333333334
Ichthyosis-hypotrichosis syndrome,39370,18,2,26,0,26,34,0,34,0.0,0.0,0.0,0.0,0.0,0.0
Cryoglobulinemic vasculitis,30342,4,29,22,19,3,20,6,14,0.6551724137931034,0.20689655172413793,0.8636363636363636,0.6551724137931034,0.3,0.20689655172413793
Otopalatodigital syndrome type 1,31500,3,27,111,28,83,29,3,26,1.037037037037037,0.1111111111111111,0.25225225225225223,1.037037037037037,0.10344827586206896,0.1111111111111111
Otopalatodigital syndrome type 2,31500,0,55,21,14,7,20,0,20,0.2545454545454545,0.0,0.6666666666666666,0.2545454545454545,0.0,0.0
Brittle cornea syndrome,95503,4,34,19,3,16,21,3,18,0.08823529411764706,0.08823529411764706,0.15789473684210525,0.08823529411764706,0.14285714285714285,0.08823529411764706
Blau syndrome,35826,8,46,37,3,34,28,3,25,0.06521739130434782,0.06521739130434782,0.08108108108108109,0.06521739130434782,0.10714285714285714,0.06521739130434782
Xeroderma pigmentosum variant,31055,9,13,23,2,21,33,4,29,0.15384615384615385,0.3076923076923077,0.08695652173913043,0.15384615384615385,0.12121212121212122,0.3076923076923077
Autosomal dominant cutis laxa,27841,2,59,23,8,15,33,6,27,0.13559322033898305,0.1016949152542373,0.34782608695652173,0.13559322033898305,0.18181818181818182,0.1016949152542373
Klippel-Trénaunay syndrome,98429,7,31,18,5,13,37,5,32,0.16129032258064516,0.16129032258064516,0.2777777777777778,0.16129032258064516,0.13513513513513514,0.16129032258064516
Mandibuloacral dysplasia with type B lipodystrophy,28779,0,28,47,20,27,26,0,26,0.7142857142857143,0.0,0.425531914893617,0.7142857142857143,0.0,0.0
Mandibuloacral dysplasia with type A lipodystrophy,28779,1,30,42,27,15,37,1,36,0.9,0.03333333333333333,0.6428571428571429,0.9,0.02702702702702703,0.03333333333333333
Hereditary folate malabsorption,38628,20,25,31,3,28,30,3,27,0.12,0.12,0.0967741935483871,0.12,0.1,0.12
Primary familial polycythemia,38273,16,15,32,3,29,19,4,15,0.2,0.26666666666666666,0.09375,0.2,0.21052631578947367,0.26666666666666666
Drug-induced autoimmune hemolytic anemia,32885,5,11,18,11,7,21,3,18,1.0,0.2727272727272727,0.6111111111111112,1.0,0.14285714285714285,0.2727272727272727
Mixed-type autoimmune hemolytic anemia,32890,6,14,19,13,6,25,5,20,0.9285714285714286,0.35714285714285715,0.6842105263157895,0.9285714285714286,0.2,0.35714285714285715
Paroxysmal cold hemoglobinuria,27950,1,11,16,4,12,24,1,23,0.36363636363636365,0.09090909090909091,0.25,0.36363636363636365,0.041666666666666664,0.09090909090909091
"Autoimmune hemolytic anemia, warm type",31723,5,27,17,9,8,25,10,15,0.3333333333333333,0.37037037037037035,0.5294117647058824,0.3333333333333333,0.4,0.37037037037037035
"Deafness with labyrinthine aplasia, microtia, and microdontia",30306,3,23,21,19,2,37,7,30,0.8260869565217391,0.30434782608695654,0.9047619047619048,0.8260869565217391,0.1891891891891892,0.30434782608695654
Primary immunodeficiency syndrome due to P14/LAMTOR2 deficiency,30023,1,7,21,7,14,16,0,16,1.0,0.0,0.3333333333333333,1.0,0.0,0.0
Erythema elevatum diutinum,32639,11,8,21,9,12,24,2,22,1.125,0.25,0.42857142857142855,1.125,0.08333333333333333,0.25
Autosomal dominant hypophosphatemic rickets,27800,3,15,21,7,14,30,8,22,0.4666666666666667,0.5333333333333333,0.3333333333333333,0.4666666666666667,0.26666666666666666,0.5333333333333333
Hypomyelination-hypogonadotropic hypogonadism-hypodontia syndrome,32806,12,4,30,4,26,22,1,21,1.0,0.25,0.13333333333333333,1.0,0.045454545454545456,0.25
Neurodegeneration due to 3-hydroxyisobutyryl-CoA hydrolase deficiency,29231,1,31,21,17,4,28,3,25,0.5483870967741935,0.0967741935483871,0.8095238095238095,0.5483870967741935,0.10714285714285714,0.0967741935483871
Ichthyosis-prematurity syndrome,32812,8,5,30,5,25,19,0,19,1.0,0.0,0.16666666666666666,1.0,0.0,0.0
Vacuolar myopathy with sarcoplasmic reticulum protein aggregates,30771,0,2,15,0,15,31,0,31,0.0,0.0,0.0,0.0,0.0,0.0
Sialidosis type 2,33195,0,31,33,12,21,5,0,5,0.3870967741935484,0.0,0.36363636363636365,0.3870967741935484,0.0,0.0
Keratosis palmaris et plantaris-clinodactyly syndrome,28701,8,3,19,2,17,15,0,15,0.6666666666666666,0.0,0.10526315789473684,0.6666666666666666,0.0,0.0
"Hereditary palmoplantar keratoderma, Gamborg-Nielsen type",28989,7,2,17,1,16,10,0,10,0.5,0.0,0.058823529411764705,0.5,0.0,0.0
"Palmoplantar keratoderma, Nagashima type",30262,5,2,9,0,9,6,0,6,0.0,0.0,0.0,0.0,0.0,0.0
Mesoaxial synostotic syndactyly with phalangeal reduction,31328,0,12,19,14,5,31,0,31,1.1666666666666667,0.0,0.7368421052631579,1.1666666666666667,0.0,0.0
SLC39A13-related spondylodysplastic Ehlers-Danlos syndrome,38339,20,20,32,1,31,37,2,35,0.05,0.1,0.03125,0.05,0.05405405405405406,0.1
Congenital muscular dystrophy due to LMNA mutation,31690,0,22,17,13,4,28,2,26,0.5909090909090909,0.09090909090909091,0.7647058823529411,0.5909090909090909,0.07142857142857142,0.09090909090909091
Generalized eruptive histiocytosis,27749,6,12,21,8,13,18,2,16,0.6666666666666666,0.16666666666666666,0.38095238095238093,0.6666666666666666,0.1111111111111111,0.16666666666666666
Benign cephalic histiocytosis,32952,0,4,12,3,9,20,0,20,0.75,0.0,0.25,0.75,0.0,0.0
Juvenile xanthogranuloma,33509,3,12,22,8,14,42,0,42,0.6666666666666666,0.0,0.36363636363636365,0.6666666666666666,0.0,0.0
Xanthoma disseminatum,33508,2,6,13,6,7,17,0,17,1.0,0.0,0.46153846153846156,1.0,0.0,0.0
Rosaï-Dorfman disease,33528,5,12,16,10,6,29,4,25,0.8333333333333334,0.3333333333333333,0.625,0.8333333333333334,0.13793103448275862,0.3333333333333333
Progressive nodular histiocytosis,33521,14,4,29,4,25,30,1,29,1.0,0.25,0.13793103448275862,1.0,0.03333333333333333,0.25
Hereditary progressive mucinous histiocytosis,27837,2,6,10,4,6,26,2,24,0.6666666666666666,0.3333333333333333,0.4,0.6666666666666666,0.07692307692307693,0.3333333333333333
Segmental outgrowth-lipomatosis-arteriovenous malformation-epidermal nevus syndrome,32832,0,19,16,15,1,34,2,32,0.7894736842105263,0.10526315789473684,0.9375,0.7894736842105263,0.058823529411764705,0.10526315789473684
Arachnoiditis,28332,2,15,21,14,7,32,3,29,0.9333333333333333,0.2,0.6666666666666666,0.9333333333333333,0.09375,0.2
Drug reaction with eosinophilia and systemic symptoms,32742,2,28,21,20,1,21,6,15,0.7142857142857143,0.21428571428571427,0.9523809523809523,0.7142857142857143,0.2857142857142857,0.21428571428571427
X-linked intellectual disability-cerebellar hypoplasia syndrome,33433,4,33,55,8,47,25,5,20,0.24242424242424243,0.15151515151515152,0.14545454545454545,0.24242424242424243,0.2,0.15151515151515152
Carney triad,32735,3,21,17,16,1,25,3,22,0.7619047619047619,0.14285714285714285,0.9411764705882353,0.7619047619047619,0.12,0.14285714285714285
Encephalopathy due to prosaposin deficiency,29504,2,10,19,9,10,38,3,35,0.9,0.3,0.47368421052631576,0.9,0.07894736842105263,0.3
Microtia-eye coloboma-imperforation of the nasolacrimal duct syndrome,29526,18,4,29,3,26,23,2,21,0.75,0.5,0.10344827586206896,0.75,0.08695652173913043,0.5
Multicentric reticulohistiocytosis,32748,11,6,19,6,13,20,3,17,1.0,0.5,0.3157894736842105,1.0,0.15,0.5
17q11.2 microduplication syndrome,32869,1,16,19,2,17,25,1,24,0.125,0.0625,0.10526315789473684,0.125,0.04,0.0625
Microphthalmia with brain and digit anomalies,31093,2,23,64,13,51,17,3,14,0.5652173913043478,0.13043478260869565,0.203125,0.5652173913043478,0.17647058823529413,0.13043478260869565
Syndactyly-telecanthus-anogenital and renal malformations syndrome,29630,1,28,36,26,10,32,3,29,0.9285714285714286,0.10714285714285714,0.7222222222222222,0.9285714285714286,0.09375,0.10714285714285714
"ABeta amyloidosis, Dutch type",33133,1,10,16,9,7,31,0,31,0.9,0.0,0.5625,0.9,0.0,0.0
ACys amyloidosis,31817,4,5,22,4,18,23,0,23,0.8,0.0,0.18181818181818182,0.8,0.0,0.0
Squamous cell carcinoma of the esophagus,96953,20,8,33,6,27,25,5,20,0.75,0.625,0.18181818181818182,0.75,0.2,0.625
Klatskin tumor,32542,7,10,17,10,7,19,5,14,1.0,0.5,0.5882352941176471,1.0,0.2631578947368421,0.5
Neurogenic thoracic outlet syndrome,33124,3,8,20,7,13,24,0,24,0.875,0.0,0.35,0.875,0.0,0.0
Bathing suit ichthyosis,27791,2,18,15,14,1,20,2,18,0.7777777777777778,0.1111111111111111,0.9333333333333333,0.7777777777777778,0.1,0.1111111111111111
Familial hypofibrinogenemia,31856,7,4,20,1,19,21,3,18,0.25,0.75,0.05,0.25,0.14285714285714285,0.75
X-linked Charcot-Marie-Tooth disease type 4,27530,4,16,22,2,20,18,0,18,0.125,0.0,0.09090909090909091,0.125,0.0,0.0
X-linked Charcot-Marie-Tooth disease type 1,27530,3,16,26,2,24,18,3,15,0.125,0.1875,0.07692307692307693,0.125,0.16666666666666666,0.1875
Invasive mole,37906,12,2,27,0,27,31,0,31,0.0,0.0,0.0,0.0,0.0,0.0
Cushing syndrome due to ectopic ACTH secretion,32234,3,83,18,12,6,35,10,25,0.14457831325301204,0.12048192771084337,0.6666666666666666,0.14457831325301204,0.2857142857142857,0.12048192771084337
Atypical teratoid rhabdoid tumor,33519,0,16,17,3,14,23,0,23,0.1875,0.0,0.17647058823529413,0.1875,0.0,0.0
O'Sullivan-McLeod syndrome,27695,3,14,17,12,5,28,1,27,0.8571428571428571,0.07142857142857142,0.7058823529411765,0.8571428571428571,0.03571428571428571,0.07142857142857142
Placental site trophoblastic tumor,32514,7,4,26,3,23,18,0,18,0.75,0.0,0.11538461538461539,0.75,0.0,0.0
Hydatidiform mole,95138,15,7,29,3,26,35,3,32,0.42857142857142855,0.42857142857142855,0.10344827586206896,0.42857142857142855,0.08571428571428572,0.42857142857142855
Adenocarcinoma of the esophagus,32545,10,10,18,10,8,28,4,24,1.0,0.4,0.5555555555555556,1.0,0.14285714285714285,0.4
Well-differentiated liposarcoma,32546,6,3,21,4,17,30,0,30,1.3333333333333333,0.0,0.19047619047619047,1.3333333333333333,0.0,0.0
Pleomorphic liposarcoma,32555,10,2,23,2,21,26,0,26,1.0,0.0,0.08695652173913043,1.0,0.0,0.0
Myxoid/round cell liposarcoma,32553,8,3,20,3,17,27,1,26,1.0,0.3333333333333333,0.15,1.0,0.037037037037037035,0.3333333333333333
Lassa fever,37859,18,28,25,9,16,27,10,17,0.32142857142857145,0.35714285714285715,0.36,0.32142857142857145,0.37037037037037035,0.35714285714285715
Nipah virus disease,32352,4,17,16,15,1,19,4,15,0.8823529411764706,0.23529411764705882,0.9375,0.8823529411764706,0.21052631578947367,0.23529411764705882
Haddad syndrome,28239,0,19,29,0,29,39,0,39,0.0,0.0,0.0,0.0,0.0,0.0
LIG4 syndrome,30146,0,35,17,13,4,23,0,23,0.37142857142857144,0.0,0.7647058823529411,0.37142857142857144,0.0,0.0
Thymic carcinoma,32257,7,13,18,14,4,22,5,17,1.0769230769230769,0.38461538461538464,0.7777777777777778,1.0769230769230769,0.22727272727272727,0.38461538461538464
Dengue fever,95170,17,22,18,4,14,27,7,20,0.18181818181818182,0.3181818181818182,0.2222222222222222,0.18181818181818182,0.25925925925925924,0.3181818181818182
X-linked Charcot-Marie-Tooth disease type 5,30728,0,19,17,7,10,18,2,16,0.3684210526315789,0.10526315789473684,0.4117647058823529,0.3684210526315789,0.1111111111111111,0.10526315789473684
Adult-onset foveomacular vitelliform dystrophy,32189,8,9,18,10,8,29,5,24,1.1111111111111112,0.5555555555555556,0.5555555555555556,1.1111111111111112,0.1724137931034483,0.5555555555555556
Spastic paraplegia type 2,30156,1,17,23,7,16,20,0,20,0.4117647058823529,0.0,0.30434782608695654,0.4117647058823529,0.0,0.0
Familial afibrinogenemia,32216,15,7,23,4,19,28,1,27,0.5714285714285714,0.14285714285714285,0.17391304347826086,0.5714285714285714,0.03571428571428571,0.14285714285714285
Familial dysfibrinogenemia,32216,18,5,26,7,19,29,3,26,1.4,0.6,0.2692307692307692,1.4,0.10344827586206896,0.6
Typhoid,33474,3,27,17,18,-1,19,5,14,0.6666666666666666,0.18518518518518517,1.0588235294117647,0.6666666666666666,0.2631578947368421,0.18518518518518517
Mosaic trisomy 9 syndrome,33458,2,62,17,17,0,33,4,29,0.27419354838709675,0.06451612903225806,1.0,0.27419354838709675,0.12121212121212122,0.06451612903225806
Pontiac fever,33473,14,5,17,5,12,16,4,12,1.0,0.8,0.29411764705882354,1.0,0.25,0.8
Acetazolamide-responsive myotonia,33515,5,12,17,13,4,16,1,15,1.0833333333333333,0.08333333333333333,0.7647058823529411,1.0833333333333333,0.0625,0.08333333333333333
Kienbock disease,32480,9,7,16,7,9,18,3,15,1.0,0.42857142857142855,0.4375,1.0,0.16666666666666666,0.42857142857142855
Bohring-Opitz syndrome,31594,5,65,78,21,57,25,5,20,0.3230769230769231,0.07692307692307693,0.2692307692307692,0.3230769230769231,0.2,0.07692307692307693
Thoracic outlet syndrome,98466,12,11,27,1,26,23,2,21,0.09090909090909091,0.18181818181818182,0.037037037037037035,0.09090909090909091,0.08695652173913043,0.18181818181818182
Riboflavin transporter deficiency,32236,1,35,21,23,-2,30,4,26,0.6571428571428571,0.11428571428571428,1.0952380952380953,0.6571428571428571,0.13333333333333333,0.11428571428571428
Carney-Stratakis syndrome,28724,6,10,19,9,10,25,0,25,0.9,0.0,0.47368421052631576,0.9,0.0,0.0
Alpha-thalassemia-intellectual disability syndrome linked to chromosome 16,27529,2,32,17,11,6,32,4,28,0.34375,0.125,0.6470588235294118,0.34375,0.125,0.125
Thyroid hypoplasia,32888,3,15,20,14,6,28,6,22,0.9333333333333333,0.4,0.7,0.9333333333333333,0.21428571428571427,0.4
Thyroid hemiagenesis,32898,1,27,20,11,9,8,1,7,0.4074074074074074,0.037037037037037035,0.55,0.4074074074074074,0.125,0.037037037037037035
Athyreosis,32897,2,25,15,15,0,21,3,18,0.6,0.12,1.0,0.6,0.14285714285714285,0.12
Thyroid ectopia,32901,3,25,15,15,0,21,7,14,0.6,0.28,1.0,0.6,0.3333333333333333,0.28
"48,XXXY syndrome",32804,5,62,45,43,2,39,7,32,0.6935483870967742,0.11290322580645161,0.9555555555555556,0.6935483870967742,0.1794871794871795,0.11290322580645161
Koolen-De Vries syndrome,32595,3,60,99,29,70,37,6,31,0.48333333333333334,0.1,0.29292929292929293,0.48333333333333334,0.16216216216216217,0.1
Recombinant 8 syndrome,30425,0,46,17,14,3,19,2,17,0.30434782608695654,0.043478260869565216,0.8235294117647058,0.30434782608695654,0.10526315789473684,0.043478260869565216
Distal deletion 19p syndrome,39043,13,23,27,2,25,35,3,32,0.08695652173913043,0.13043478260869565,0.07407407407407407,0.08695652173913043,0.08571428571428572,0.13043478260869565
Distal deletion 6p syndrome,30573,3,39,54,32,22,33,3,30,0.8205128205128205,0.07692307692307693,0.5925925925925926,0.8205128205128205,0.09090909090909091,0.07692307692307693
Mosaic trisomy 8 syndrome,32491,2,42,17,15,2,24,2,22,0.35714285714285715,0.047619047619047616,0.8823529411764706,0.35714285714285715,0.08333333333333333,0.047619047619047616
20p12.3 microdeletion syndrome,39278,19,23,29,2,27,21,2,19,0.08695652173913043,0.08695652173913043,0.06896551724137931,0.08695652173913043,0.09523809523809523,0.08695652173913043
Paternal 20q13.2q13.3 microdeletion syndrome,32465,4,24,19,5,14,27,2,25,0.20833333333333334,0.08333333333333333,0.2631578947368421,0.20833333333333334,0.07407407407407407,0.08333333333333333
Trisomy 20p syndrome,39312,18,71,30,3,27,36,6,30,0.04225352112676056,0.08450704225352113,0.1,0.04225352112676056,0.16666666666666666,0.08450704225352113
Distal 22q11.2 microdeletion syndrome,30708,4,60,17,16,1,39,9,30,0.26666666666666666,0.15,0.9411764705882353,0.26666666666666666,0.23076923076923078,0.15
Distal 22q11.2 microduplication syndrome,32995,1,57,17,17,0,27,3,24,0.2982456140350877,0.05263157894736842,1.0,0.2982456140350877,0.1111111111111111,0.05263157894736842
Trisomy 1q syndrome,32991,1,42,35,33,2,28,1,27,0.7857142857142857,0.023809523809523808,0.9428571428571428,0.7857142857142857,0.03571428571428571,0.023809523809523808
2p15p16.1 microdeletion syndrome,39278,13,77,29,4,25,29,2,27,0.05194805194805195,0.025974025974025976,0.13793103448275862,0.05194805194805195,0.06896551724137931,0.025974025974025976
16p11.2p12.2 microdeletion syndrome,33186,3,43,17,6,11,31,3,28,0.13953488372093023,0.06976744186046512,0.35294117647058826,0.13953488372093023,0.0967741935483871,0.06976744186046512
16p13.11 microdeletion syndrome,33186,3,40,16,16,0,33,4,29,0.4,0.1,1.0,0.4,0.12121212121212122,0.1
16p13.11 microduplication syndrome,33180,3,19,18,14,4,32,2,30,0.7368421052631579,0.10526315789473684,0.7777777777777778,0.7368421052631579,0.0625,0.10526315789473684
16q24.3 microdeletion syndrome,32429,5,47,105,13,92,26,2,24,0.2765957446808511,0.0425531914893617,0.12380952380952381,0.2765957446808511,0.07692307692307693,0.0425531914893617
17q12 microdeletion syndrome,32429,5,21,102,8,94,33,3,30,0.38095238095238093,0.14285714285714285,0.0784313725490196,0.38095238095238093,0.09090909090909091,0.14285714285714285
17q12 microduplication syndrome,32869,1,17,19,1,18,33,4,29,0.058823529411764705,0.23529411764705882,0.05263157894736842,0.058823529411764705,0.12121212121212122,0.23529411764705882
17q23.1q23.2 microdeletion syndrome,32429,4,46,100,13,87,24,3,21,0.2826086956521739,0.06521739130434782,0.13,0.2826086956521739,0.125,0.06521739130434782
Trisomy 17p syndrome,33149,4,50,17,18,-1,29,7,22,0.36,0.14,1.0588235294117647,0.36,0.2413793103448276,0.14
Distal 7q11.23 microduplication syndrome,33336,10,14,19,10,9,28,3,25,0.7142857142857143,0.21428571428571427,0.5263157894736842,0.7142857142857143,0.10714285714285714,0.21428571428571427
Iatrogenic botulism,32473,8,13,20,9,11,27,3,24,0.6923076923076923,0.23076923076923078,0.45,0.6923076923076923,0.1111111111111111,0.23076923076923078
14q11.2 microdeletion syndrome,32466,1,25,22,2,20,27,1,26,0.08,0.04,0.09090909090909091,0.08,0.037037037037037035,0.04
Monosomy 9p syndrome,31535,4,58,66,47,19,38,8,30,0.8103448275862069,0.13793103448275862,0.7121212121212122,0.8103448275862069,0.21052631578947367,0.13793103448275862
Cleft palate-congenital heart defect-intellectual disability syndrome due to 15q14 microdeletion,28633,3,28,17,14,3,21,4,17,0.5,0.14285714285714285,0.8235294117647058,0.5,0.19047619047619047,0.14285714285714285
FOXG1 syndrome due to 14q12 microdeletion,39034,19,29,27,2,25,30,2,28,0.06896551724137931,0.06896551724137931,0.07407407407407407,0.06896551724137931,0.06666666666666667,0.06896551724137931
16p11.2p12.2 microduplication syndrome,33199,11,14,17,6,11,23,1,22,0.42857142857142855,0.07142857142857142,0.35294117647058826,0.42857142857142855,0.043478260869565216,0.07142857142857142
8p11.2 deletion syndrome,33099,2,36,25,26,-1,30,4,26,0.7222222222222222,0.1111111111111111,1.04,0.7222222222222222,0.13333333333333333,0.1111111111111111
6q25.2q25.3 microdeletion syndrome,32429,5,32,99,15,84,24,6,18,0.46875,0.1875,0.15151515151515152,0.46875,0.25,0.1875
8p23.1 duplication syndrome,33096,6,18,21,13,8,34,3,31,0.7222222222222222,0.16666666666666666,0.6190476190476191,0.7222222222222222,0.08823529411764706,0.16666666666666666
8p23.1 microdeletion syndrome,33094,2,49,45,44,1,21,4,17,0.8979591836734694,0.08163265306122448,0.9777777777777777,0.8979591836734694,0.19047619047619047,0.08163265306122448
19p13.12 microdeletion syndrome,32429,5,55,101,14,87,25,4,21,0.2545454545454545,0.07272727272727272,0.13861386138613863,0.2545454545454545,0.16,0.07272727272727272
"46,XY partial gonadal dysgenesis",38781,17,43,21,9,12,32,11,21,0.20930232558139536,0.2558139534883721,0.42857142857142855,0.20930232558139536,0.34375,0.2558139534883721
Inhalational botulism,32484,6,13,19,11,8,31,3,28,0.8461538461538461,0.23076923076923078,0.5789473684210527,0.8461538461538461,0.0967741935483871,0.23076923076923078
Distal 7q11.23 microdeletion syndrome,32429,3,12,99,4,95,28,2,26,0.3333333333333333,0.16666666666666666,0.04040404040404041,0.3333333333333333,0.07142857142857142,0.16666666666666666
Mendelian susceptibility to mycobacterial diseases due to partial IRF8 deficiency,30105,6,3,22,4,18,29,2,27,1.3333333333333333,0.6666666666666666,0.18181818181818182,1.3333333333333333,0.06896551724137931,0.6666666666666666
ABetaL34V amyloidosis,33159,2,11,16,7,9,28,0,28,0.6363636363636364,0.0,0.4375,0.6363636363636364,0.0,0.0
Ebola hemorrhagic fever,32858,3,29,16,7,9,19,7,12,0.2413793103448276,0.2413793103448276,0.4375,0.2413793103448276,0.3684210526315789,0.2413793103448276
"ABeta amyloidosis, Arctic type",33133,0,2,16,0,16,17,0,17,0.0,0.0,0.0,0.0,0.0,0.0
Chronic nonbacterial osteomyelitis/Chronic recurrent multifocal osteomyelitis,29265,3,27,19,14,5,21,5,16,0.5185185185185185,0.18518518518518517,0.7368421052631579,0.5185185185185185,0.23809523809523808,0.18518518518518517
"ABeta amyloidosis, Iowa type",33133,1,9,16,6,10,23,1,22,0.6666666666666666,0.1111111111111111,0.375,0.6666666666666666,0.043478260869565216,0.1111111111111111
"ABeta amyloidosis, Italian type",33133,1,7,17,7,10,16,0,16,1.0,0.0,0.4117647058823529,1.0,0.0,0.0
Vitamin B12-unresponsive methylmalonic acidemia type mut0,27479,0,22,19,8,11,20,1,19,0.36363636363636365,0.045454545454545456,0.42105263157894735,0.36363636363636365,0.05,0.045454545454545456
Infantile-onset ascending hereditary spastic paralysis,28074,2,11,17,7,10,27,1,26,0.6363636363636364,0.09090909090909091,0.4117647058823529,0.6363636363636364,0.037037037037037035,0.09090909090909091
Lujo hemorrhagic fever,32850,4,59,17,7,10,23,9,14,0.11864406779661017,0.15254237288135594,0.4117647058823529,0.11864406779661017,0.391304347826087,0.15254237288135594
Acral self-healing collodion baby,33143,3,6,21,6,15,16,2,14,1.0,0.3333333333333333,0.2857142857142857,1.0,0.125,0.3333333333333333
Syndromic recessive X-linked ichthyosis,29420,1,21,17,14,3,18,2,16,0.6666666666666666,0.09523809523809523,0.8235294117647058,0.6666666666666666,0.1111111111111111,0.09523809523809523
Pseudoxanthomatous diffuse cutaneous mastocytosis,33261,4,2,11,1,10,16,0,16,0.5,0.0,0.09090909090909091,0.5,0.0,0.0
8q21.11 microdeletion syndrome,32429,6,39,100,11,89,24,3,21,0.28205128205128205,0.07692307692307693,0.11,0.28205128205128205,0.125,0.07692307692307693
Keratosis linearis-ichthyosis congenita-sclerosing keratoderma syndrome,29644,10,2,22,3,19,26,1,25,1.5,0.5,0.13636363636363635,1.5,0.038461538461538464,0.5
10q22.3q23.3 microdeletion syndrome,32429,2,30,16,1,15,26,2,24,0.03333333333333333,0.06666666666666667,0.0625,0.03333333333333333,0.07692307692307693,0.06666666666666667
L1 syndrome,33504,1,16,21,15,6,14,0,14,0.9375,0.0,0.7142857142857143,0.9375,0.0,0.0
Mycophenolate mofetil embryopathy,33285,0,28,20,18,2,15,0,15,0.6428571428571429,0.0,0.9,0.6428571428571429,0.0,0.0
14q22q23 microdeletion syndrome,32429,2,40,16,3,13,25,3,22,0.075,0.075,0.1875,0.075,0.12,0.075
Bullous diffuse cutaneous mastocytosis,32208,2,7,14,5,9,19,2,17,0.7142857142857143,0.2857142857142857,0.35714285714285715,0.7142857142857143,0.10526315789473684,0.2857142857142857
Spasmus nutans,33399,6,3,22,3,19,32,2,30,1.0,0.6666666666666666,0.13636363636363635,1.0,0.0625,0.6666666666666666
Symptomatic form of Coffin-Lowry syndrome in female carriers,33213,2,21,18,15,3,34,2,32,0.7142857142857143,0.09523809523809523,0.8333333333333334,0.7142857142857143,0.058823529411764705,0.09523809523809523
10q22.3q23.3 microduplication syndrome,32869,1,21,19,15,4,30,2,28,0.7142857142857143,0.09523809523809523,0.7894736842105263,0.7142857142857143,0.06666666666666667,0.09523809523809523
"48,XYYY syndrome",32804,3,31,45,9,36,17,1,16,0.2903225806451613,0.03225806451612903,0.2,0.2903225806451613,0.058823529411764705,0.03225806451612903
Leydig cell hypoplasia,98776,14,23,28,3,25,25,4,21,0.13043478260869565,0.17391304347826086,0.10714285714285714,0.13043478260869565,0.16,0.17391304347826086
Familial thoracic aortic aneurysm and aortic dissection,32443,1,42,18,18,0,23,2,21,0.42857142857142855,0.047619047619047616,1.0,0.42857142857142855,0.08695652173913043,0.047619047619047616
Non-functioning pituitary adenoma,31063,12,58,27,12,15,30,13,17,0.20689655172413793,0.22413793103448276,0.4444444444444444,0.20689655172413793,0.43333333333333335,0.22413793103448276
Ring chromosome Y syndrome,32722,0,22,16,19,-3,20,0,20,0.8636363636363636,0.0,1.1875,0.8636363636363636,0.0,0.0
Wolfram-like syndrome,31066,2,22,16,12,4,29,3,26,0.5454545454545454,0.13636363636363635,0.75,0.5454545454545454,0.10344827586206896,0.13636363636363635
Müllerian aplasia and hyperandrogenism,27165,4,22,23,17,6,17,3,14,0.7727272727272727,0.13636363636363635,0.7391304347826086,0.7727272727272727,0.17647058823529413,0.13636363636363635
"46,XY gonadal dysgenesis-motor and sensory neuropathy syndrome",30775,1,26,17,15,2,27,1,26,0.5769230769230769,0.038461538461538464,0.8823529411764706,0.5769230769230769,0.037037037037037035,0.038461538461538464
Penile agenesis,32342,2,29,27,18,9,16,2,14,0.6206896551724138,0.06896551724137931,0.6666666666666666,0.6206896551724138,0.125,0.06896551724137931
"46,XY ovotesticular difference of sex development",39476,17,19,40,4,36,40,3,37,0.21052631578947367,0.15789473684210525,0.1,0.21052631578947367,0.075,0.15789473684210525
"46,XY difference of sex development due to isolated 17,20-lyase deficiency",32410,3,36,18,17,1,29,16,13,0.4722222222222222,0.4444444444444444,0.9444444444444444,0.4722222222222222,0.5517241379310345,0.4444444444444444
Diethylstilbestrol syndrome,33132,1,18,16,15,1,23,1,22,0.8333333333333334,0.05555555555555555,0.9375,0.8333333333333334,0.043478260869565216,0.05555555555555555
Testicular agenesis,99886,17,11,21,0,21,31,1,30,0.0,0.09090909090909091,0.0,0.0,0.03225806451612903,0.09090909090909091
Hypokalemic periodic paralysis,27428,2,22,17,14,3,22,5,17,0.6363636363636364,0.22727272727272727,0.8235294117647058,0.6363636363636364,0.22727272727272727,0.22727272727272727
STAT1-related autoimmune enteropathy and endocrinopathy-susceptibility to chronic infections syndrome,27745,1,47,17,16,1,26,4,22,0.3404255319148936,0.0851063829787234,0.9411764705882353,0.3404255319148936,0.15384615384615385,0.0851063829787234
Normosmic congenital hypogonadotropic hypogonadism,28407,7,38,43,34,9,20,7,13,0.8947368421052632,0.18421052631578946,0.7906976744186046,0.8947368421052632,0.35,0.18421052631578946
Thyroid lymphoma,32265,5,14,17,13,4,29,4,25,0.9285714285714286,0.2857142857142857,0.7647058823529411,0.9285714285714286,0.13793103448275862,0.2857142857142857
Parathyroid carcinoma,38953,6,37,6,1,5,22,8,14,0.02702702702702703,0.21621621621621623,0.16666666666666666,0.02702702702702703,0.36363636363636365,0.21621621621621623
Medullary thyroid carcinoma,32909,8,14,18,10,8,21,5,16,0.7142857142857143,0.35714285714285715,0.5555555555555556,0.7142857142857143,0.23809523809523808,0.35714285714285715
Anaplastic thyroid carcinoma,30749,5,23,19,3,16,33,10,23,0.13043478260869565,0.43478260869565216,0.15789473684210525,0.13043478260869565,0.30303030303030304,0.43478260869565216
Pituitary carcinoma,96147,10,22,20,2,18,20,2,18,0.09090909090909091,0.09090909090909091,0.1,0.09090909090909091,0.1,0.09090909090909091
Aorta coarctation,27670,0,18,17,13,4,19,1,18,0.7222222222222222,0.05555555555555555,0.7647058823529411,0.7222222222222222,0.05263157894736842,0.05555555555555555
Familial hypocalciuric hypercalcemia,27830,5,21,26,17,9,25,4,21,0.8095238095238095,0.19047619047619047,0.6538461538461539,0.8095238095238095,0.16,0.19047619047619047
Oral submucous fibrosis,32191,9,7,23,7,16,24,1,23,1.0,0.14285714285714285,0.30434782608695654,1.0,0.041666666666666664,0.14285714285714285
Attenuated Chédiak-Higashi syndrome,33060,1,15,16,14,2,20,1,19,0.9333333333333333,0.06666666666666667,0.875,0.9333333333333333,0.05,0.06666666666666667
Neonatal Marfan syndrome,38220,11,43,31,7,24,33,7,26,0.16279069767441862,0.16279069767441862,0.22580645161290322,0.16279069767441862,0.21212121212121213,0.16279069767441862
Xp22.13p22.2 duplication syndrome,33039,2,34,17,17,0,19,3,16,0.5,0.08823529411764706,1.0,0.5,0.15789473684210525,0.08823529411764706
6q terminal deletion syndrome,32311,1,49,43,43,0,35,3,32,0.8775510204081632,0.061224489795918366,1.0,0.8775510204081632,0.08571428571428572,0.061224489795918366
Xp21 deletion syndrome,32830,2,32,17,17,0,21,3,18,0.53125,0.09375,1.0,0.53125,0.14285714285714285,0.09375
Atypical Werner syndrome,32590,3,90,75,81,-6,21,6,15,0.9,0.06666666666666667,1.08,0.9,0.2857142857142857,0.06666666666666667
8p inverted duplication/deletion syndrome,39341,15,56,25,2,23,27,3,24,0.03571428571428571,0.05357142857142857,0.08,0.03571428571428571,0.1111111111111111,0.05357142857142857
Tetragametic chimerism syndrome,27635,2,18,16,17,-1,35,2,33,0.9444444444444444,0.1111111111111111,1.0625,0.9444444444444444,0.05714285714285714,0.1111111111111111
1q41q42 microdeletion syndrome,32429,5,32,99,13,86,24,5,19,0.40625,0.15625,0.13131313131313133,0.40625,0.20833333333333334,0.15625
Hypogonadotropic hypogonadism-severe microcephaly-sensorineural hearing loss-dysmorphism syndrome,33082,2,47,38,40,-2,18,5,13,0.851063829787234,0.10638297872340426,1.0526315789473684,0.851063829787234,0.2777777777777778,0.10638297872340426
Chromosome Y microdeletion syndrome,33259,3,6,17,5,12,31,2,29,0.8333333333333334,0.3333333333333333,0.29411764705882354,0.8333333333333334,0.06451612903225806,0.3333333333333333
Xq12-q13.3 duplication syndrome,32931,3,37,17,15,2,28,5,23,0.40540540540540543,0.13513513513513514,0.8823529411764706,0.40540540540540543,0.17857142857142858,0.13513513513513514
"46,XY difference of sex development-adrenal insufficiency due to CYP11A1 deficiency",28226,2,51,19,17,2,35,8,27,0.3333333333333333,0.1568627450980392,0.8947368421052632,0.3333333333333333,0.22857142857142856,0.1568627450980392
Inherited isolated adrenal insufficiency due to partial CYP11A1 deficiency,32584,2,52,30,30,0,27,7,20,0.5769230769230769,0.1346153846153846,1.0,0.5769230769230769,0.25925925925925924,0.1346153846153846
Congenital adrenal hyperplasia due to 3-beta-hydroxysteroid dehydrogenase deficiency,31078,6,36,57,20,37,28,5,23,0.5555555555555556,0.1388888888888889,0.3508771929824561,0.5555555555555556,0.17857142857142858,0.1388888888888889
H syndrome,30947,0,50,24,0,24,21,0,21,0.0,0.0,0.0,0.0,0.0,0.0
Male infertility with azoospermia or oligozoospermia due to single gene mutation,32388,11,7,20,9,11,22,3,19,1.2857142857142858,0.42857142857142855,0.45,1.2857142857142858,0.13636363636363635,0.42857142857142855
Isochromosomy Yq syndrome,32655,1,8,19,8,11,35,0,35,1.0,0.0,0.42105263157894735,1.0,0.0,0.0
Isochromosomy Yp syndrome,39578,18,6,41,0,41,40,2,38,0.0,0.3333333333333333,0.0,0.0,0.05,0.3333333333333333
Maternal uniparental disomy of chromosome X syndrome,39314,15,26,27,3,24,32,4,28,0.11538461538461539,0.15384615384615385,0.1111111111111111,0.11538461538461539,0.125,0.15384615384615385
"47,XYY syndrome",38781,26,45,60,8,52,43,10,33,0.17777777777777778,0.2222222222222222,0.13333333333333333,0.17777777777777778,0.23255813953488372,0.2222222222222222
"45,X/46,XY mixed gonadal dysgenesis",33553,5,60,31,30,1,35,6,29,0.5,0.1,0.967741935483871,0.5,0.17142857142857143,0.1
"X-linked intellectual disability, Van Esch type",27603,2,21,116,3,113,31,2,29,0.14285714285714285,0.09523809523809523,0.02586206896551724,0.14285714285714285,0.06451612903225806,0.09523809523809523
"X-linked intellectual disability, Cilliers type",32718,2,25,17,15,2,30,2,28,0.6,0.08,0.8823529411764706,0.6,0.06666666666666667,0.08
TSH-secreting pituitary adenoma,32906,4,66,21,23,-2,22,13,9,0.3484848484848485,0.19696969696969696,1.0952380952380953,0.3484848484848485,0.5909090909090909,0.19696969696969696
Prolactinoma,28409,16,50,27,16,11,30,13,17,0.32,0.26,0.5925925925925926,0.32,0.43333333333333335,0.26
"Multiple epiphyseal dysplasia, Lowry type",32128,4,20,18,3,15,32,3,29,0.15,0.15,0.16666666666666666,0.15,0.09375,0.15
Autosomal dominant otospondylomegaepiphyseal dysplasia,38104,6,12,30,1,29,26,1,25,0.08333333333333333,0.08333333333333333,0.03333333333333333,0.08333333333333333,0.038461538461538464,0.08333333333333333
Multiple epiphyseal dysplasia-macrocephaly-facial dysmorphism syndrome,31724,1,22,17,6,11,36,3,33,0.2727272727272727,0.13636363636363635,0.35294117647058826,0.2727272727272727,0.08333333333333333,0.13636363636363635
Wormian bone-multiple fractures-dentinogenesis imperfecta-skeletal dysplasia,28264,2,13,19,10,9,26,2,24,0.7692307692307693,0.15384615384615385,0.5263157894736842,0.7692307692307693,0.07692307692307693,0.15384615384615385
"Spondylometaphyseal dysplasia, A4 type",38339,11,8,26,0,26,43,1,42,0.0,0.125,0.0,0.0,0.023255813953488372,0.125
Malignant peritoneal mesothelioma,32612,10,10,19,10,9,26,5,21,1.0,0.5,0.5263157894736842,1.0,0.19230769230769232,0.5
"Familial scaphocephaly syndrome, McGillivray type",31231,2,14,18,12,6,20,1,19,0.8571428571428571,0.07142857142857142,0.6666666666666666,0.8571428571428571,0.05,0.07142857142857142
Primary peritoneal carcinoma,37975,22,6,23,4,19,26,5,21,0.6666666666666666,0.8333333333333334,0.17391304347826086,0.6666666666666666,0.19230769230769232,0.8333333333333334
Peritoneal inclusion cyst,37937,7,9,8,2,6,20,3,17,0.2222222222222222,0.3333333333333333,0.25,0.2222222222222222,0.15,0.3333333333333333
Sea-blue histiocytosis,29651,2,14,16,11,5,20,2,18,0.7857142857142857,0.14285714285714285,0.6875,0.7857142857142857,0.1,0.14285714285714285
"Localized dystrophic epidermolysis bullosa, nails only",27640,4,11,20,10,10,20,4,16,0.9090909090909091,0.36363636363636365,0.5,0.9090909090909091,0.2,0.36363636363636365
Lethal acantholytic erosive disorder,30194,7,27,29,1,28,27,0,27,0.037037037037037035,0.0,0.034482758620689655,0.037037037037037035,0.0,0.0
Hb Bart's hydrops fetalis,33272,12,12,23,8,15,27,6,21,0.6666666666666666,0.5,0.34782608695652173,0.6666666666666666,0.2222222222222222,0.5
Maffucci syndrome,29322,1,24,18,19,-1,22,1,21,0.7916666666666666,0.041666666666666664,1.0555555555555556,0.7916666666666666,0.045454545454545456,0.041666666666666664
Hypotonia-cystinuria syndrome,38935,14,14,22,0,22,29,2,27,0.0,0.14285714285714285,0.0,0.0,0.06896551724137931,0.14285714285714285
2p21 microdeletion syndrome,39278,15,19,31,2,29,28,2,26,0.10526315789473684,0.10526315789473684,0.06451612903225806,0.10526315789473684,0.07142857142857142,0.10526315789473684
Febrile infection-related epilepsy syndrome,33026,9,12,21,11,10,23,4,19,0.9166666666666666,0.3333333333333333,0.5238095238095238,0.9166666666666666,0.17391304347826086,0.3333333333333333
Peripheral demyelinating neuropathy-central dysmyelinating leukodystrophy-Waardenburg syndrome-Hirschsprung disease,31030,2,36,32,24,8,25,4,21,0.6666666666666666,0.1111111111111111,0.75,0.6666666666666666,0.16,0.1111111111111111
"X-linked intellectual disability, Najm type",28944,3,46,24,3,21,28,1,27,0.06521739130434782,0.021739130434782608,0.125,0.06521739130434782,0.03571428571428571,0.021739130434782608
"X-linked dominant chondrodysplasia, Chassaing-Lacombe type",30983,2,24,22,16,6,33,2,31,0.6666666666666666,0.08333333333333333,0.7272727272727273,0.6666666666666666,0.06060606060606061,0.08333333333333333
Adult intestinal botulism,32290,8,9,18,6,12,26,5,21,0.6666666666666666,0.5555555555555556,0.3333333333333333,0.6666666666666666,0.19230769230769232,0.5555555555555556
Intestinal botulism,32290,7,13,15,10,5,24,6,18,0.7692307692307693,0.46153846153846156,0.6666666666666666,0.7692307692307693,0.25,0.46153846153846156
Infantile LAD-like disease due to RAC2 deficiency,31219,8,4,26,0,26,24,0,24,0.0,0.0,0.0,0.0,0.0,0.0
15q13.3 microdeletion syndrome,32429,2,21,16,2,14,19,4,15,0.09523809523809523,0.19047619047619047,0.125,0.09523809523809523,0.21052631578947367,0.19047619047619047
Ledderhose disease,32471,0,5,21,5,16,12,0,12,1.0,0.0,0.23809523809523808,1.0,0.0,0.0
19q13.11 microdeletion syndrome,32429,6,40,102,11,91,29,5,24,0.275,0.125,0.10784313725490197,0.275,0.1724137931034483,0.125
17q21.31 microduplication syndrome,32869,1,25,19,4,15,30,3,27,0.16,0.12,0.21052631578947367,0.16,0.1,0.12
Congenital alveolar capillary dysplasia,32012,2,23,18,8,10,34,2,32,0.34782608695652173,0.08695652173913043,0.4444444444444444,0.34782608695652173,0.058823529411764705,0.08695652173913043
Adult polyglucosan body disease,32026,5,18,30,1,29,35,3,32,0.05555555555555555,0.16666666666666666,0.03333333333333333,0.05555555555555555,0.08571428571428572,0.16666666666666666
Combined immunodeficiency due to CRAC channel dysfunction,33069,3,23,16,17,-1,25,3,22,0.7391304347826086,0.13043478260869565,1.0625,0.7391304347826086,0.12,0.13043478260869565
Severe combined immunodeficiency due to FOXN1 deficiency,27595,8,5,20,1,19,32,0,32,0.2,0.0,0.05,0.2,0.0,0.0
CLAPO syndrome,27679,0,20,17,19,-2,9,0,9,0.95,0.0,1.1176470588235294,0.95,0.0,0.0
6q16 microdeletion syndrome,32429,5,32,103,9,94,35,2,33,0.28125,0.0625,0.08737864077669903,0.28125,0.05714285714285714,0.0625
Good syndrome,32839,1,20,15,15,0,23,1,22,0.75,0.05,1.0,0.75,0.043478260869565216,0.05
Cutis laxa-Marfanoid syndrome,31499,5,8,22,8,14,34,1,33,1.0,0.125,0.36363636363636365,1.0,0.029411764705882353,0.125
8q22.1 microdeletion syndrome,32429,4,32,102,6,96,25,1,24,0.1875,0.03125,0.058823529411764705,0.1875,0.04,0.03125
Craniosynostosis-hydrocephalus-Arnold-Chiari malformation type I-radioulnar synostosis syndrome,32286,5,41,17,17,0,24,5,19,0.4146341463414634,0.12195121951219512,1.0,0.4146341463414634,0.20833333333333334,0.12195121951219512
Arginine vasopressin deficiency,29832,1,17,16,2,14,23,7,16,0.11764705882352941,0.4117647058823529,0.125,0.11764705882352941,0.30434782608695654,0.4117647058823529
Wound botulism,32283,3,15,18,11,7,24,3,21,0.7333333333333333,0.2,0.6111111111111112,0.7333333333333333,0.125,0.2
Infant botulism,32284,1,28,17,16,1,20,2,18,0.5714285714285714,0.07142857142857142,0.9411764705882353,0.5714285714285714,0.1,0.07142857142857142
Osteosclerosis-developmental delay-craniosynostosis syndrome,32488,1,16,15,15,0,20,1,19,0.9375,0.0625,1.0,0.9375,0.05,0.0625
5q14.3 microdeletion syndrome,32429,4,24,100,13,87,28,2,26,0.5416666666666666,0.08333333333333333,0.13,0.5416666666666666,0.07142857142857142,0.08333333333333333
Foodborne botulism,32228,5,19,16,15,1,28,8,20,0.7894736842105263,0.42105263157894735,0.9375,0.7894736842105263,0.2857142857142857,0.42105263157894735
Autosomal dominant striatal neurodegeneration,27342,4,7,17,6,11,25,3,22,0.8571428571428571,0.42857142857142855,0.35294117647058826,0.8571428571428571,0.12,0.42857142857142855
Hughes-Stovin syndrome,32663,4,18,17,17,0,25,5,20,0.9444444444444444,0.2777777777777778,1.0,0.9444444444444444,0.2,0.2777777777777778
5q35 microduplication syndrome,33496,11,9,22,7,15,33,4,29,0.7777777777777778,0.4444444444444444,0.3181818181818182,0.7777777777777778,0.12121212121212122,0.4444444444444444
Cardiac anomalies-short stature-joint hypermobility-facial dysmorphism syndrome,28531,2,23,18,3,15,35,4,31,0.13043478260869565,0.17391304347826086,0.16666666666666666,0.13043478260869565,0.11428571428571428,0.17391304347826086
Toxin-mediated infectious botulism,33347,13,12,20,9,11,20,6,14,0.75,0.5,0.45,0.75,0.3,0.5
Isolated agammaglobulinemia,27170,2,28,19,13,6,29,6,23,0.4642857142857143,0.21428571428571427,0.6842105263157895,0.4642857142857143,0.20689655172413793,0.21428571428571427
Ptosis-upper ocular movement limitation-absence of lacrimal punctum syndrome,32212,0,18,16,15,1,23,2,21,0.8333333333333334,0.1111111111111111,0.9375,0.8333333333333334,0.08695652173913043,0.1111111111111111
Frontonasal dysplasia-alopecia-genital anomalies syndrome,30695,1,30,20,12,8,26,3,23,0.4,0.1,0.6,0.4,0.11538461538461539,0.1
2q23.1 microdeletion syndrome,32429,5,32,99,8,91,24,3,21,0.25,0.09375,0.08080808080808081,0.25,0.125,0.09375
8q12 microduplication syndrome,32869,1,20,19,1,18,25,1,24,0.05,0.05,0.05263157894736842,0.05,0.04,0.05
Diffuse cutaneous systemic sclerosis,32398,3,26,18,18,0,13,4,9,0.6923076923076923,0.15384615384615385,1.0,0.6923076923076923,0.3076923076923077,0.15384615384615385
17p13.3 microduplication syndrome,33180,3,19,18,1,17,30,1,29,0.05263157894736842,0.05263157894736842,0.05555555555555555,0.05263157894736842,0.03333333333333333,0.05263157894736842
Combined immunodeficiency due to DOCK8 deficiency,29937,3,18,22,13,9,29,2,27,0.7222222222222222,0.1111111111111111,0.5909090909090909,0.7222222222222222,0.06896551724137931,0.1111111111111111
Xeroderma pigmentosum-Cockayne syndrome complex,32596,2,29,19,18,1,32,4,28,0.6206896551724138,0.13793103448275862,0.9473684210526315,0.6206896551724138,0.125,0.13793103448275862
Juvenile primary lateral sclerosis,28624,12,15,19,8,11,31,3,28,0.5333333333333333,0.2,0.42105263157894735,0.5333333333333333,0.0967741935483871,0.2
1q44 microdeletion syndrome,29659,3,33,17,3,14,28,4,24,0.09090909090909091,0.12121212121212122,0.17647058823529413,0.09090909090909091,0.14285714285714285,0.12121212121212122
4q21 microdeletion syndrome,32429,5,42,104,13,91,34,3,31,0.30952380952380953,0.07142857142857142,0.125,0.30952380952380953,0.08823529411764706,0.07142857142857142
Primary orthostatic tremor,36976,14,7,14,2,12,16,2,14,0.2857142857142857,0.2857142857142857,0.14285714285714285,0.2857142857142857,0.125,0.2857142857142857
Familial clubfoot due to 17q23.1q23.2 microduplication,29529,7,4,16,5,11,14,2,12,1.25,0.5,0.3125,1.25,0.14285714285714285,0.5
Hypohidrotic ectodermal dysplasia,32453,2,31,20,7,13,25,4,21,0.22580645161290322,0.12903225806451613,0.35,0.22580645161290322,0.16,0.12903225806451613
15q11q13 microduplication syndrome,32869,1,19,18,2,16,23,3,20,0.10526315789473684,0.15789473684210525,0.1111111111111111,0.10526315789473684,0.13043478260869565,0.15789473684210525
Microcornea-posterior megalolenticonus-persistent fetal vasculature-coloboma syndrome,32668,9,7,20,4,16,23,2,21,0.5714285714285714,0.2857142857142857,0.2,0.5714285714285714,0.08695652173913043,0.2857142857142857
6p22 microdeletion syndrome,33109,2,21,20,19,1,28,2,26,0.9047619047619048,0.09523809523809523,0.95,0.9047619047619048,0.07142857142857142,0.09523809523809523
3q29 microduplication syndrome,31466,3,30,20,14,6,31,3,28,0.4666666666666667,0.1,0.7,0.4666666666666667,0.0967741935483871,0.1
2q32q33 microdeletion syndrome,32429,6,43,100,11,89,28,5,23,0.2558139534883721,0.11627906976744186,0.11,0.2558139534883721,0.17857142857142858,0.11627906976744186
2q31.1 microdeletion syndrome,32429,6,63,99,15,84,23,5,18,0.23809523809523808,0.07936507936507936,0.15151515151515152,0.23809523809523808,0.21739130434782608,0.07936507936507936
1q21.1 microduplication syndrome,32869,1,25,19,4,15,25,3,22,0.16,0.12,0.21052631578947367,0.16,0.12,0.12
1q21.1 microdeletion syndrome,32429,4,47,99,15,84,30,4,26,0.3191489361702128,0.0851063829787234,0.15151515151515152,0.3191489361702128,0.13333333333333333,0.0851063829787234
Autosomal recessive Stickler syndrome,32565,11,18,24,13,11,33,7,26,0.7222222222222222,0.3888888888888889,0.5416666666666666,0.7222222222222222,0.21212121212121213,0.3888888888888889
Isolated aniridia,32592,15,27,22,10,12,32,8,24,0.37037037037037035,0.2962962962962963,0.45454545454545453,0.37037037037037035,0.25,0.2962962962962963
Dominant beta-thalassemia,33437,2,49,17,17,0,30,6,24,0.3469387755102041,0.12244897959183673,1.0,0.3469387755102041,0.2,0.12244897959183673
Usher syndrome type 3,27268,3,17,17,2,15,23,1,22,0.11764705882352941,0.058823529411764705,0.11764705882352941,0.11764705882352941,0.043478260869565216,0.058823529411764705
Beta-thalassemia major,33437,2,50,17,17,0,28,4,24,0.34,0.08,1.0,0.34,0.14285714285714285,0.08
Usher syndrome type 1,27268,4,22,17,5,12,28,2,26,0.22727272727272727,0.09090909090909091,0.29411764705882354,0.22727272727272727,0.07142857142857142,0.09090909090909091
Usher syndrome type 2,27268,5,23,17,6,11,37,3,34,0.2608695652173913,0.13043478260869565,0.35294117647058826,0.2608695652173913,0.08108108108108109,0.13043478260869565
Classical-like Ehlers-Danlos syndrome type 1,28078,1,21,17,4,13,24,3,21,0.19047619047619047,0.14285714285714285,0.23529411764705882,0.19047619047619047,0.125,0.14285714285714285
Combined immunodeficiency due to partial RAG1 deficiency,33548,6,10,20,8,12,17,2,15,0.8,0.2,0.4,0.8,0.11764705882352941,0.2
Non-acquired combined pituitary hormone deficiency-sensorineural hearing loss-spine abnormalities syndrome,27919,1,10,18,9,9,26,0,26,0.9,0.0,0.5,0.9,0.0,0.0
Beta-thalassemia-X-linked thrombocytopenia syndrome,31589,5,6,16,7,9,20,5,15,1.1666666666666667,0.8333333333333334,0.4375,1.1666666666666667,0.25,0.8333333333333334
Alpha-thalassemia-myelodysplastic syndrome,28428,6,12,22,11,11,19,1,18,0.9166666666666666,0.08333333333333333,0.5,0.9166666666666666,0.05263157894736842,0.08333333333333333
Hemoglobin C-beta-thalassemia syndrome,33422,7,4,23,4,19,22,2,20,1.0,0.5,0.17391304347826086,1.0,0.09090909090909091,0.5
Hemoglobin E-beta-thalassemia syndrome,33424,13,4,25,5,20,28,2,26,1.25,0.5,0.2,1.25,0.07142857142857142,0.5
Delta-beta-thalassemia,33418,5,3,32,3,29,27,1,26,1.0,0.3333333333333333,0.09375,1.0,0.037037037037037035,0.3333333333333333
Persistent placoid maculopathy,32470,5,8,20,8,12,30,2,28,1.0,0.25,0.4,1.0,0.06666666666666667,0.25
Dermotrichic syndrome,33320,0,17,20,13,7,26,0,26,0.7647058823529411,0.0,0.65,0.7647058823529411,0.0,0.0
Ravine syndrome,32332,1,14,14,15,-1,27,1,26,1.0714285714285714,0.07142857142857142,1.0714285714285714,1.0714285714285714,0.037037037037037035,0.07142857142857142
Familial gestational hyperthyroidism,27661,3,15,21,9,12,16,2,14,0.6,0.13333333333333333,0.42857142857142855,0.6,0.125,0.13333333333333333
Symptomatic form of HFE-related hemochromatosis,28176,4,44,18,10,8,32,10,22,0.22727272727272727,0.22727272727272727,0.5555555555555556,0.22727272727272727,0.3125,0.22727272727272727
IRVAN syndrome,32496,0,11,19,11,8,38,0,38,1.0,0.0,0.5789473684210527,1.0,0.0,0.0
Zebra body myopathy,32218,1,22,16,16,0,22,2,20,0.7272727272727273,0.09090909090909091,1.0,0.7272727272727273,0.09090909090909091,0.09090909090909091
Interstitial granulomatous dermatitis with arthritis,33197,8,8,21,7,14,28,2,26,0.875,0.25,0.3333333333333333,0.875,0.07142857142857142,0.25
Kidney tubulopathy-dilated cardiomyopathy syndrome,32335,0,20,17,18,-1,19,0,19,0.9,0.0,1.0588235294117647,0.9,0.0,0.0
Familial isolated hypoparathyroidism due to agenesis of parathyroid gland,31288,5,8,18,8,10,30,0,30,1.0,0.0,0.4444444444444444,1.0,0.0,0.0
Familial hyperthyroidism due to mutations in TSH receptor,27204,4,17,16,11,5,31,4,27,0.6470588235294118,0.23529411764705882,0.6875,0.6470588235294118,0.12903225806451613,0.23529411764705882
PLIN1-related familial partial lipodystrophy,27788,0,16,19,2,17,9,0,9,0.125,0.0,0.10526315789473684,0.125,0.0,0.0
Idiopathic localized lipodystrophy,33043,2,11,15,7,8,29,2,27,0.6363636363636364,0.18181818181818182,0.4666666666666667,0.6363636363636364,0.06896551724137931,0.18181818181818182
Drug-induced localized lipodystrophy,33049,7,6,23,4,19,28,2,26,0.6666666666666666,0.3333333333333333,0.17391304347826086,0.6666666666666666,0.07142857142857142,0.3333333333333333
Sagliker syndrome,32644,0,13,21,11,10,24,0,24,0.8461538461538461,0.0,0.5238095238095238,0.8461538461538461,0.0,0.0
Cono-spondylar dysplasia,33540,0,26,21,20,1,19,1,18,0.7692307692307693,0.038461538461538464,0.9523809523809523,0.7692307692307693,0.05263157894736842,0.038461538461538464
Aneurysm of sinus of Valsalva,33011,6,11,19,10,9,26,2,24,0.9090909090909091,0.18181818181818182,0.5263157894736842,0.9090909090909091,0.07692307692307693,0.18181818181818182
Bazex syndrome,32801,0,15,17,11,6,24,0,24,0.7333333333333333,0.0,0.6470588235294118,0.7333333333333333,0.0,0.0
Tetrasomy 5p syndrome,39338,20,44,31,0,31,26,0,26,0.0,0.0,0.0,0.0,0.0,0.0
Autoimmune hemolytic anemia-autoimmune thrombocytopenia-primary immunodeficiency syndrome due to TPP2 deficiency,32994,6,14,24,13,11,29,4,25,0.9285714285714286,0.2857142857142857,0.5416666666666666,0.9285714285714286,0.13793103448275862,0.2857142857142857
Lichen planus pemphigoides,32627,5,10,21,9,12,24,3,21,0.9,0.3,0.42857142857142855,0.9,0.125,0.3
Monosomy 18q syndrome,32686,1,65,44,8,36,29,4,25,0.12307692307692308,0.06153846153846154,0.18181818181818182,0.12307692307692308,0.13793103448275862,0.06153846153846154
Pineoblastoma,96482,12,19,23,2,21,20,4,16,0.10526315789473684,0.21052631578947367,0.08695652173913043,0.10526315789473684,0.2,0.21052631578947367
Madras motor neuron disease,32310,4,17,17,16,1,17,2,15,0.9411764705882353,0.11764705882352941,0.9411764705882353,0.9411764705882353,0.11764705882352941,0.11764705882352941
Ganglioneuroma,33013,1,16,16,14,2,29,1,28,0.875,0.0625,0.875,0.875,0.034482758620689655,0.0625
Perioral myoclonia with absences,32756,3,10,21,9,12,29,0,29,0.9,0.0,0.42857142857142855,0.9,0.0,0.0
Elastoderma,32459,12,7,20,5,15,28,1,27,0.7142857142857143,0.14285714285714285,0.25,0.7142857142857143,0.03571428571428571,0.14285714285714285
Cap polyposis,32576,12,8,16,8,8,24,5,19,1.0,0.625,0.5,1.0,0.20833333333333334,0.625
Congenital panfollicular nevus,27712,7,6,18,3,15,15,1,14,0.5,0.16666666666666666,0.16666666666666666,0.5,0.06666666666666667,0.16666666666666666
Linear atrophoderma of Moulin,27786,8,5,21,2,19,43,2,41,0.4,0.4,0.09523809523809523,0.4,0.046511627906976744,0.4
Microcephalic primordial dwarfism-insulin resistance syndrome,33102,2,9,20,8,12,24,0,24,0.8888888888888888,0.0,0.4,0.8888888888888888,0.0,0.0
Pseudoxanthoma elasticum-like skin manifestations with retinitis pigmentosa,33256,6,11,20,12,8,34,1,33,1.0909090909090908,0.09090909090909091,0.6,1.0909090909090908,0.029411764705882353,0.09090909090909091
Chylomicron retention disease,30905,1,20,17,13,4,20,3,17,0.65,0.15,0.7647058823529411,0.65,0.15,0.15
Idiopathic hypercalciuria,29700,6,7,14,2,12,22,1,21,0.2857142857142857,0.14285714285714285,0.14285714285714285,0.2857142857142857,0.045454545454545456,0.14285714285714285
Intrauterine growth restriction-short stature-early adult-onset diabetes syndrome,33086,19,3,24,3,21,27,1,26,1.0,0.3333333333333333,0.125,1.0,0.037037037037037035,0.3333333333333333
Hyperlipidemia due to hepatic triacylglycerol lipase deficiency,31492,6,5,20,5,15,33,1,32,1.0,0.2,0.25,1.0,0.030303030303030304,0.2
Contractures-developmental delay-Pierre Robin syndrome,32988,3,36,18,16,2,29,3,26,0.4444444444444444,0.08333333333333333,0.8888888888888888,0.4444444444444444,0.10344827586206896,0.08333333333333333
HIDEA syndrome,28693,4,11,27,1,26,28,4,24,0.09090909090909091,0.36363636363636365,0.037037037037037035,0.09090909090909091,0.14285714285714285,0.36363636363636365
20q11.2 microdeletion syndrome,32429,3,19,100,5,95,30,2,28,0.2631578947368421,0.10526315789473684,0.05,0.2631578947368421,0.06666666666666667,0.10526315789473684
Distal deletion 1q syndrome,32517,1,15,20,14,6,28,1,27,0.9333333333333333,0.06666666666666667,0.7,0.9333333333333333,0.03571428571428571,0.06666666666666667
11q22.2q22.3 microdeletion syndrome,32429,2,44,18,6,12,31,2,29,0.13636363636363635,0.045454545454545456,0.3333333333333333,0.13636363636363635,0.06451612903225806,0.045454545454545456
Steroid-responsive encephalopathy associated with autoimmune thyroiditis,27715,3,25,18,17,1,30,4,26,0.68,0.16,0.9444444444444444,0.68,0.13333333333333333,0.16
Isolated sedoheptulokinase deficiency,31189,0,28,16,17,-1,31,2,29,0.6071428571428571,0.07142857142857142,1.0625,0.6071428571428571,0.06451612903225806,0.07142857142857142
AApoAIV amyloidosis,33159,5,30,20,0,20,23,1,22,0.0,0.03333333333333333,0.0,0.0,0.043478260869565216,0.03333333333333333
Autosomal dominant myopia-midfacial retrusion-sensorineural hearing loss-rhizomelic dysplasia syndrome,33282,2,19,17,17,0,31,4,27,0.8947368421052632,0.21052631578947367,1.0,0.8947368421052632,0.12903225806451613,0.21052631578947367
Evans syndrome,29415,8,13,23,3,20,22,4,18,0.23076923076923078,0.3076923076923077,0.13043478260869565,0.23076923076923078,0.18181818181818182,0.3076923076923077
Immune thrombocytopenia,83934,19,20,23,6,17,25,3,22,0.3,0.15,0.2608695652173913,0.3,0.12,0.15
Primary biliary cholangitis,31144,2,41,19,18,1,24,4,20,0.43902439024390244,0.0975609756097561,0.9473684210526315,0.43902439024390244,0.16666666666666666,0.0975609756097561
Atopic keratoconjunctivitis,32918,3,15,16,3,13,26,6,20,0.2,0.4,0.1875,0.2,0.23076923076923078,0.4
Myasthenia gravis,31650,2,44,25,20,5,23,4,19,0.45454545454545453,0.09090909090909091,0.8,0.45454545454545453,0.17391304347826086,0.09090909090909091
CAMOS syndrome,32309,0,15,15,14,1,18,0,18,0.9333333333333333,0.0,0.9333333333333333,0.9333333333333333,0.0,0.0
X-linked microcephaly-growth retardation-prognathism-cryptorchidism syndrome,32378,0,25,18,17,1,10,2,8,0.68,0.08,0.9444444444444444,0.68,0.2,0.08
COG2-CDG,32379,0,13,18,7,11,15,0,15,0.5384615384615384,0.0,0.3888888888888889,0.5384615384615384,0.0,0.0
Short stature-advanced bone age-early-onset osteoarthritis syndrome,33539,11,5,19,4,15,31,1,30,0.8,0.2,0.21052631578947367,0.8,0.03225806451612903,0.2
3p25.3 microdeletion syndrome,33211,2,51,42,42,0,30,3,27,0.8235294117647058,0.058823529411764705,1.0,0.8235294117647058,0.1,0.058823529411764705
Stargardt disease,27913,1,16,17,13,4,19,2,17,0.8125,0.125,0.7647058823529411,0.8125,0.10526315789473684,0.125
Estrogen resistance syndrome,27750,1,24,16,15,1,38,2,36,0.625,0.08333333333333333,0.9375,0.625,0.05263157894736842,0.08333333333333333
Primary hypergonadotropic hypogonadism-partial alopecia syndrome,28245,3,41,39,37,2,25,4,21,0.9024390243902439,0.0975609756097561,0.9487179487179487,0.9024390243902439,0.16,0.0975609756097561
Keppen-Lubinsky syndrome,28280,1,42,34,32,2,20,2,18,0.7619047619047619,0.047619047619047616,0.9411764705882353,0.7619047619047619,0.1,0.047619047619047616
Stiff person spectrum disorder,98549,6,32,20,1,19,25,1,24,0.03125,0.03125,0.05,0.03125,0.04,0.03125
Progressive supranuclear palsy,27828,5,32,27,15,12,27,6,21,0.46875,0.1875,0.5555555555555556,0.46875,0.2222222222222222,0.1875
Laminin subunit alpha 2-related congenital muscular dystrophy,31690,2,54,28,10,18,22,4,18,0.18518518518518517,0.07407407407407407,0.35714285714285715,0.18518518518518517,0.18181818181818182,0.07407407407407407
Leber hereditary optic neuropathy,30612,4,20,17,9,8,26,3,23,0.45,0.15,0.5294117647058824,0.45,0.11538461538461539,0.15
Aromatase deficiency,28433,2,26,16,13,3,27,2,25,0.5,0.07692307692307693,0.8125,0.5,0.07407407407407407,0.07692307692307693
Familial median cleft of the upper and lower lips,30845,3,10,15,10,5,28,2,26,1.0,0.2,0.6666666666666666,1.0,0.07142857142857142,0.2
Lissencephaly type 3-metacarpal bone dysplasia syndrome,29795,0,23,18,14,4,26,1,25,0.6086956521739131,0.043478260869565216,0.7777777777777778,0.6086956521739131,0.038461538461538464,0.043478260869565216
MEDNIK syndrome,30928,0,8,19,7,12,19,0,19,0.875,0.0,0.3684210526315789,0.875,0.0,0.0
Postorgasmic illness syndrome,35879,13,18,32,6,26,17,5,12,0.3333333333333333,0.2777777777777778,0.1875,0.3333333333333333,0.29411764705882354,0.2777777777777778
Muscular hypertrophy-hepatomegaly-polyhydramnios syndrome,32632,2,14,17,11,6,14,0,14,0.7857142857142857,0.0,0.6470588235294118,0.7857142857142857,0.0,0.0
Ketamine-induced biliary dilatation,32921,11,4,26,6,20,21,3,18,1.5,0.75,0.23076923076923078,1.5,0.14285714285714285,0.75
7p22.1 microduplication syndrome,32377,10,11,27,9,18,32,4,28,0.8181818181818182,0.36363636363636365,0.3333333333333333,0.8181818181818182,0.125,0.36363636363636365
Autosomal recessive frontotemporal pachygyria,31852,4,11,22,11,11,24,0,24,1.0,0.0,0.5,1.0,0.0,0.0
Woodhouse-Sakati syndrome,32075,1,35,17,15,2,16,1,15,0.42857142857142855,0.02857142857142857,0.8823529411764706,0.42857142857142855,0.0625,0.02857142857142857
Mitochondrial DNA-related cardiomyopathy and hearing loss,30794,11,30,29,5,24,33,8,25,0.16666666666666666,0.26666666666666666,0.1724137931034483,0.16666666666666666,0.24242424242424243,0.26666666666666666
Birdshot chorioretinopathy,31512,4,23,24,21,3,21,6,15,0.9130434782608695,0.2608695652173913,0.875,0.9130434782608695,0.2857142857142857,0.2608695652173913
Generalized eruptive keratoacanthoma,33339,2,8,23,6,17,15,1,14,0.75,0.125,0.2608695652173913,0.75,0.06666666666666667,0.125
Multiple myeloma,30494,2,31,20,19,1,27,4,23,0.6129032258064516,0.12903225806451613,0.95,0.6129032258064516,0.14814814814814814,0.12903225806451613
Congenital megacalycosis,32922,3,10,17,10,7,17,2,15,1.0,0.2,0.5882352941176471,1.0,0.11764705882352941,0.2
Herpes simplex virus stromal keratitis,32880,6,17,20,12,8,20,2,18,0.7058823529411765,0.11764705882352941,0.6,0.7058823529411765,0.1,0.11764705882352941
Transaldolase deficiency,30351,0,18,20,10,10,34,0,34,0.5555555555555556,0.0,0.5,0.5555555555555556,0.0,0.0
Congenital hypothyroidism due to maternal intake of antithyroid drugs,27711,1,26,20,7,13,42,2,40,0.2692307692307692,0.07692307692307693,0.35,0.2692307692307692,0.047619047619047616,0.07692307692307693
LIPE-related familial partial lipodystrophy,30508,0,20,19,13,6,14,0,14,0.65,0.0,0.6842105263157895,0.65,0.0,0.0
CIDEC-related familial partial lipodystrophy,30508,1,16,18,8,10,25,1,24,0.5,0.0625,0.4444444444444444,0.5,0.04,0.0625
"Short stature, Brussels type",29294,3,10,16,13,3,30,3,27,1.3,0.3,0.8125,1.3,0.1,0.3
Neovascular glaucoma,33472,4,20,15,13,2,16,7,9,0.65,0.35,0.8666666666666667,0.65,0.4375,0.35
Familial multinodular goiter,30539,12,14,20,3,17,30,2,28,0.21428571428571427,0.14285714285714285,0.15,0.21428571428571427,0.06666666666666667,0.14285714285714285
Developmental and speech delay due to SOX5 deficiency,32780,3,31,29,28,1,31,4,27,0.9032258064516129,0.12903225806451613,0.9655172413793104,0.9032258064516129,0.12903225806451613,0.12903225806451613
Idiopathic pulmonary arterial hypertension,27688,6,18,16,17,-1,20,7,13,0.9444444444444444,0.3888888888888889,1.0625,0.9444444444444444,0.35,0.3888888888888889
Eiken syndrome,27233,1,23,17,15,2,28,1,27,0.6521739130434783,0.043478260869565216,0.8823529411764706,0.6521739130434783,0.03571428571428571,0.043478260869565216
Combined hamartoma of the retina and retinal pigment epithelium,32683,12,7,23,7,16,33,1,32,1.0,0.14285714285714285,0.30434782608695654,1.0,0.030303030303030304,0.14285714285714285
Familial anetoderma,32454,5,6,21,6,15,22,0,22,1.0,0.0,0.2857142857142857,1.0,0.0,0.0
Leukoencephalopathy with bilateral anterior temporal lobe cysts,32765,5,14,19,12,7,23,0,23,0.8571428571428571,0.0,0.631578947368421,0.8571428571428571,0.0,0.0
Infantile digital fibromatosis,32463,4,5,16,5,11,23,1,22,1.0,0.2,0.3125,1.0,0.043478260869565216,0.2
Cardiomyopathy-hypotonia-lactic acidosis syndrome,29195,4,11,19,11,8,18,2,16,1.0,0.18181818181818182,0.5789473684210527,1.0,0.1111111111111111,0.18181818181818182
DEND syndrome,27812,1,19,18,17,1,35,1,34,0.8947368421052632,0.05263157894736842,0.9444444444444444,0.8947368421052632,0.02857142857142857,0.05263157894736842
GNE myopathy,27807,2,28,35,28,7,21,2,19,1.0,0.07142857142857142,0.8,1.0,0.09523809523809523,0.07142857142857142
Autosomal recessive spastic paraplegia type 57,27668,4,14,22,4,18,36,2,34,0.2857142857142857,0.14285714285714285,0.18181818181818182,0.2857142857142857,0.05555555555555555,0.14285714285714285
Burkitt lymphoma,30075,1,14,16,13,3,21,2,19,0.9285714285714286,0.14285714285714285,0.8125,0.9285714285714286,0.09523809523809523,0.14285714285714285
PPARG-related familial partial lipodystrophy,27788,0,36,18,11,7,9,0,9,0.3055555555555556,0.0,0.6111111111111112,0.3055555555555556,0.0,0.0
Infantile nephropathic cystinosis,27421,1,27,19,9,10,13,2,11,0.3333333333333333,0.07407407407407407,0.47368421052631576,0.3333333333333333,0.15384615384615385,0.07407407407407407
RIN2 syndrome,29596,1,28,20,12,8,32,1,31,0.42857142857142855,0.03571428571428571,0.6,0.42857142857142855,0.03125,0.03571428571428571
Pseudoprogeria syndrome,28486,1,20,19,17,2,32,3,29,0.85,0.15,0.8947368421052632,0.85,0.09375,0.15
Osteosarcoma,31481,3,12,14,8,6,19,4,15,0.6666666666666666,0.3333333333333333,0.5714285714285714,0.6666666666666666,0.21052631578947367,0.3333333333333333
Insulin autoimmune syndrome,33029,5,13,23,11,12,24,1,23,0.8461538461538461,0.07692307692307693,0.4782608695652174,0.8461538461538461,0.041666666666666664,0.07692307692307693
Acrocephalopolydactyly,28752,1,19,19,5,14,29,1,28,0.2631578947368421,0.05263157894736842,0.2631578947368421,0.2631578947368421,0.034482758620689655,0.05263157894736842
AKT2-related familial partial lipodystrophy,33204,1,12,26,11,15,12,1,11,0.9166666666666666,0.08333333333333333,0.4230769230769231,0.9166666666666666,0.08333333333333333,0.08333333333333333
Atypical juvenile parkinsonism,32974,3,27,16,17,-1,22,6,16,0.6296296296296297,0.2222222222222222,1.0625,0.6296296296296297,0.2727272727272727,0.2222222222222222
Friedreich ataxia,30072,2,53,18,12,6,9,3,6,0.22641509433962265,0.05660377358490566,0.6666666666666666,0.22641509433962265,0.3333333333333333,0.05660377358490566
3MC syndrome,28191,0,30,37,14,23,10,0,10,0.4666666666666667,0.0,0.3783783783783784,0.4666666666666667,0.0,0.0
Gonadoblastoma,38782,6,11,15,3,12,25,3,22,0.2727272727272727,0.2727272727272727,0.2,0.2727272727272727,0.12,0.2727272727272727
Distal 16p11.2 microdeletion syndrome,33190,1,26,17,18,-1,28,1,27,0.6923076923076923,0.038461538461538464,1.0588235294117647,0.6923076923076923,0.03571428571428571,0.038461538461538464
Paternal uniparental disomy of chromosome X syndrome,39314,22,18,35,4,31,36,4,32,0.2222222222222222,0.2222222222222222,0.11428571428571428,0.2222222222222222,0.1111111111111111,0.2222222222222222
FGFR2-related bent bone dysplasia,28410,0,27,18,15,3,23,0,23,0.5555555555555556,0.0,0.8333333333333334,0.5555555555555556,0.0,0.0
Familial isolated hyperparathyroidism,32242,8,14,20,11,9,20,5,15,0.7857142857142857,0.35714285714285715,0.55,0.7857142857142857,0.25,0.35714285714285715
AL amyloidosis,30929,14,55,32,4,28,28,4,24,0.07272727272727272,0.07272727272727272,0.125,0.07272727272727272,0.14285714285714285,0.07272727272727272
Wild type ATTR amyloidosis,33505,3,32,16,15,1,29,3,26,0.46875,0.09375,0.9375,0.46875,0.10344827586206896,0.09375
Congenital hyperinsulinism due to HNF4A deficiency,32482,4,33,19,13,6,36,2,34,0.3939393939393939,0.06060606060606061,0.6842105263157895,0.3939393939393939,0.05555555555555555,0.06060606060606061
15q overgrowth syndrome,33237,2,65,16,16,0,40,7,33,0.24615384615384617,0.1076923076923077,1.0,0.24615384615384617,0.175,0.1076923076923077
Insulin-resistance syndrome type B,33489,4,50,49,51,-2,31,7,24,1.02,0.14,1.0408163265306123,1.02,0.22580645161290322,0.14
Pituitary gigantism,33518,2,20,17,17,0,34,2,32,0.85,0.1,1.0,0.85,0.058823529411764705,0.1
Transient neonatal diabetes mellitus,27653,3,23,25,11,14,20,2,18,0.4782608695652174,0.08695652173913043,0.44,0.4782608695652174,0.1,0.08695652173913043
Overgrowth-macrocephaly-facial dysmorphism syndrome,32695,1,26,18,20,-2,7,2,5,0.7692307692307693,0.07692307692307693,1.1111111111111112,0.7692307692307693,0.2857142857142857,0.07692307692307693
Male infertility with teratozoospermia due to single gene mutation,32368,7,8,22,9,13,18,2,16,1.125,0.25,0.4090909090909091,1.125,0.1111111111111111,0.25
Acanthosis nigricans-insulin resistance-muscle cramps-acral enlargement syndrome,28821,3,9,23,6,17,11,1,10,0.6666666666666666,0.1111111111111111,0.2608695652173913,0.6666666666666666,0.09090909090909091,0.1111111111111111
Rapid-onset childhood obesity-hypothalamic dysfunction-hypoventilation-autonomic dysregulation syndrome,27767,2,67,29,26,3,17,2,15,0.3880597014925373,0.029850746268656716,0.896551724137931,0.3880597014925373,0.11764705882352941,0.029850746268656716
Isolated permanent neonatal diabetes mellitus,27653,2,35,16,14,2,29,2,27,0.4,0.05714285714285714,0.875,0.4,0.06896551724137931,0.05714285714285714
Growth delay due to insulin-like growth factor type 1 deficiency,30465,2,42,17,13,4,22,3,19,0.30952380952380953,0.07142857142857142,0.7647058823529411,0.30952380952380953,0.13636363636363635,0.07142857142857142
Familial hyperprolactinemia,28375,6,9,22,8,14,28,4,24,0.8888888888888888,0.4444444444444444,0.36363636363636365,0.8888888888888888,0.14285714285714285,0.4444444444444444
Lysosomal acid lipase deficiency,28518,1,49,31,27,4,25,5,20,0.5510204081632653,0.10204081632653061,0.8709677419354839,0.5510204081632653,0.2,0.10204081632653061
Duplication of the pituitary gland,33268,1,34,23,22,1,40,2,38,0.6470588235294118,0.058823529411764705,0.9565217391304348,0.6470588235294118,0.05,0.058823529411764705
Ovarian hyperstimulation syndrome,29924,3,17,16,15,1,23,4,19,0.8823529411764706,0.23529411764705882,0.9375,0.8823529411764706,0.17391304347826086,0.23529411764705882
Ovarian fibroma,33050,1,11,13,7,6,27,1,26,0.6363636363636364,0.09090909090909091,0.5384615384615384,0.6363636363636364,0.037037037037037035,0.09090909090909091
Ovarian fibrothecoma,33050,5,15,13,12,1,34,7,27,0.8,0.4666666666666667,0.9230769230769231,0.8,0.20588235294117646,0.4666666666666667
Cataract-growth hormone deficiency-sensory neuropathy-sensorineural hearing loss-skeletal dysplasia syndrome,30859,3,24,18,6,12,25,5,20,0.25,0.20833333333333334,0.3333333333333333,0.25,0.2,0.20833333333333334
Intellectual disability-seizures-macrocephaly-obesity syndrome,32266,6,50,24,20,4,31,5,26,0.4,0.1,0.8333333333333334,0.4,0.16129032258064516,0.1
1p21.3 microdeletion syndrome,39278,16,25,31,2,29,30,2,28,0.08,0.08,0.06451612903225806,0.08,0.06666666666666667,0.08
Trisomy 18p syndrome,33439,1,28,24,19,5,27,1,26,0.6785714285714286,0.03571428571428571,0.7916666666666666,0.6785714285714286,0.037037037037037035,0.03571428571428571
Developmental delay-language impairment-dopa responsive dystonia-parkinsonism syndrome due to 2q24 microdeletion,33271,1,28,19,19,0,23,1,22,0.6785714285714286,0.03571428571428571,1.0,0.6785714285714286,0.043478260869565216,0.03571428571428571
Distal Xq28 microduplication syndrome,33059,3,43,39,36,3,29,4,25,0.8372093023255814,0.09302325581395349,0.9230769230769231,0.8372093023255814,0.13793103448275862,0.09302325581395349
Benign schwannoma,27820,2,25,22,23,-1,26,3,23,0.92,0.12,1.0454545454545454,0.92,0.11538461538461539,0.12
SHOX-related short stature,31845,1,16,15,14,1,29,4,25,0.875,0.25,0.9333333333333333,0.875,0.13793103448275862,0.25
X small rings syndrome,32871,0,40,18,20,-2,22,3,19,0.5,0.075,1.1111111111111112,0.5,0.13636363636363635,0.075
Intellectual disability-obesity-brain malformations-facial dysmorphism syndrome,32754,5,31,24,23,1,38,5,33,0.7419354838709677,0.16129032258064516,0.9583333333333334,0.7419354838709677,0.13157894736842105,0.16129032258064516
Autosomal dominant hyperinsulinism due to Kir6.2 deficiency,98643,19,29,30,4,26,32,3,29,0.13793103448275862,0.10344827586206896,0.13333333333333333,0.13793103448275862,0.09375,0.10344827586206896
Autosomal dominant hyperinsulinism due to SUR1 deficiency,98642,16,28,30,5,25,25,1,24,0.17857142857142858,0.03571428571428571,0.16666666666666666,0.17857142857142858,0.04,0.03571428571428571
Familial multiple lipomatosis,30054,1,22,18,16,2,29,1,28,0.7272727272727273,0.045454545454545456,0.8888888888888888,0.7272727272727273,0.034482758620689655,0.045454545454545456
Deafness-hypogonadism syndrome,32269,1,18,16,16,0,24,1,23,0.8888888888888888,0.05555555555555555,1.0,0.8888888888888888,0.041666666666666664,0.05555555555555555
Chondroectodermal dysplasia with night blindness,32782,3,28,16,15,1,27,2,25,0.5357142857142857,0.07142857142857142,0.9375,0.5357142857142857,0.07407407407407407,0.07142857142857142
Short stature due to primary acid-labile subunit deficiency,31056,4,7,19,8,11,30,3,27,1.1428571428571428,0.42857142857142855,0.42105263157894735,1.1428571428571428,0.1,0.42857142857142855
Insulinoma,32272,4,34,27,25,2,19,3,16,0.7352941176470589,0.08823529411764706,0.9259259259259259,0.7352941176470589,0.15789473684210525,0.08823529411764706
Progressive non-fluent aphasia,27776,0,32,18,17,1,6,2,4,0.53125,0.0625,0.9444444444444444,0.53125,0.3333333333333333,0.0625
LMNA-related cardiocutaneous progeria syndrome,33408,8,27,30,9,21,34,1,33,0.3333333333333333,0.037037037037037035,0.3,0.3333333333333333,0.029411764705882353,0.037037037037037035
Behavioral variant of frontotemporal dementia,32688,3,40,32,30,2,28,6,22,0.75,0.15,0.9375,0.75,0.21428571428571427,0.15
Hyperinsulinism due to UCP2 deficiency,33032,1,26,17,7,10,30,3,27,0.2692307692307692,0.11538461538461539,0.4117647058823529,0.2692307692307692,0.1,0.11538461538461539
Non-insulinoma pancreatogenous hypoglycemia syndrome,33196,3,21,17,17,0,25,3,22,0.8095238095238095,0.14285714285714285,1.0,0.8095238095238095,0.12,0.14285714285714285
Severe early-onset obesity-insulin resistance syndrome due to SH2B1 deficiency,27694,8,11,24,9,15,28,4,24,0.8181818181818182,0.36363636363636365,0.375,0.8181818181818182,0.14285714285714285,0.36363636363636365
Hyperinsulinism due to HNF1A deficiency,32795,2,30,16,7,9,31,0,31,0.23333333333333334,0.0,0.4375,0.23333333333333334,0.0,0.0
Congenital bilateral absence of vas deferens,32340,12,6,25,5,20,26,0,26,0.8333333333333334,0.0,0.2,0.8333333333333334,0.0,0.0
Obesity due to SIM1 deficiency,27826,2,17,23,14,9,45,4,41,0.8235294117647058,0.23529411764705882,0.6086956521739131,0.8235294117647058,0.08888888888888889,0.23529411764705882
Dysbetalipoproteinemia,31925,5,26,18,1,17,24,6,18,0.038461538461538464,0.23076923076923078,0.05555555555555555,0.038461538461538464,0.25,0.23076923076923078
Familial hyperaldosteronism type II,27723,5,14,18,9,9,30,6,24,0.6428571428571429,0.42857142857142855,0.5,0.6428571428571429,0.2,0.42857142857142855
Genetic transient congenital hypothyroidism,38624,11,21,33,1,32,36,2,34,0.047619047619047616,0.09523809523809523,0.030303030303030304,0.047619047619047616,0.05555555555555555,0.09523809523809523
Pancreatic colipase deficiency,27784,14,7,20,8,12,33,3,30,1.1428571428571428,0.42857142857142855,0.4,1.1428571428571428,0.09090909090909091,0.42857142857142855
Hypercholesterolemia due to cholesterol 7alpha-hydroxylase deficiency,32526,5,15,18,14,4,25,4,21,0.9333333333333333,0.26666666666666666,0.7777777777777778,0.9333333333333333,0.16,0.26666666666666666
Familial papillary thyroid carcinoma with renal papillary neoplasia,32194,0,14,17,11,6,19,0,19,0.7857142857142857,0.0,0.6470588235294118,0.7857142857142857,0.0,0.0
Familial aortic dissection,32443,1,19,18,11,7,21,1,20,0.5789473684210527,0.05263157894736842,0.6111111111111112,0.5789473684210527,0.047619047619047616,0.05263157894736842
Short fifth metacarpals-insulin resistance syndrome,32983,8,6,17,4,13,26,0,26,0.6666666666666666,0.0,0.23529411764705882,0.6666666666666666,0.0,0.0
Familial papillary or follicular thyroid carcinoma,33296,0,15,10,11,-1,12,0,12,0.7333333333333333,0.0,1.1,0.7333333333333333,0.0,0.0
Short stature due to GHSR deficiency,30142,4,11,16,13,3,26,6,20,1.1818181818181819,0.5454545454545454,0.8125,1.1818181818181819,0.23076923076923078,0.5454545454545454
Short stature due to partial GHR deficiency,28365,13,7,22,9,13,26,5,21,1.2857142857142858,0.7142857142857143,0.4090909090909091,1.2857142857142858,0.19230769230769232,0.7142857142857143
Gangliocytoma,33037,0,26,17,17,0,24,1,23,0.6538461538461539,0.038461538461538464,1.0,0.6538461538461539,0.041666666666666664,0.038461538461538464
Pancreatoblastoma,33163,10,9,19,9,10,17,5,12,1.0,0.5555555555555556,0.47368421052631576,1.0,0.29411764705882354,0.5555555555555556
Leukoencephalopathy-palmoplantar keratoderma syndrome,33009,2,16,16,15,1,36,4,32,0.9375,0.25,0.9375,0.9375,0.1111111111111111,0.25
Internal carotid absence,30453,15,5,33,3,30,37,2,35,0.6,0.4,0.09090909090909091,0.6,0.05405405405405406,0.4
TEMPI syndrome,33192,0,14,18,12,6,21,0,21,0.8571428571428571,0.0,0.6666666666666666,0.8571428571428571,0.0,0.0
Pituicytoma,33510,6,20,24,12,12,32,3,29,0.6,0.15,0.5,0.6,0.09375,0.15
Cutaneous collagenous vasculopathy,33258,5,10,19,10,9,28,6,22,1.0,0.6,0.5263157894736842,1.0,0.21428571428571427,0.6
Thyrotoxic periodic paralysis,27771,3,42,15,14,1,25,4,21,0.3333333333333333,0.09523809523809523,0.9333333333333333,0.3333333333333333,0.16,0.09523809523809523
Weaver-Williams syndrome,33364,0,7,24,6,18,20,0,20,0.8571428571428571,0.0,0.25,0.8571428571428571,0.0,0.0
Kimura disease,33450,1,5,19,6,13,31,1,30,1.2,0.2,0.3157894736842105,1.2,0.03225806451612903,0.2
"Combined pituitary hormone deficiencies, genetic forms",38320,15,39,26,9,17,38,9,29,0.23076923076923078,0.23076923076923078,0.34615384615384615,0.23076923076923078,0.23684210526315788,0.23076923076923078
Isolated follicle stimulating hormone deficiency,27680,3,22,23,5,18,20,4,16,0.22727272727272727,0.18181818181818182,0.21739130434782608,0.22727272727272727,0.2,0.18181818181818182
Eosinophilic gastroenteritis,37746,16,21,19,6,13,17,6,11,0.2857142857142857,0.2857142857142857,0.3157894736842105,0.2857142857142857,0.35294117647058826,0.2857142857142857
Familial nasal acilia,32082,10,8,17,3,14,20,3,17,0.375,0.375,0.17647058823529413,0.375,0.15,0.375
Congenital pancreatic cyst,32862,9,6,18,7,11,24,3,21,1.1666666666666667,0.5,0.3888888888888889,1.1666666666666667,0.125,0.5
Lelis syndrome,33202,0,22,18,18,0,16,0,16,0.8181818181818182,0.0,1.0,0.8181818181818182,0.0,0.0
Non-acquired panhypopituitarism,32600,2,27,17,2,15,26,6,20,0.07407407407407407,0.2222222222222222,0.11764705882352941,0.07407407407407407,0.23076923076923078,0.2222222222222222
Hydrocephalus-obesity-hypogonadism syndrome,33486,2,16,16,13,3,20,3,17,0.8125,0.1875,0.8125,0.8125,0.15,0.1875
Wells syndrome,27731,3,9,22,7,15,35,1,34,0.7777777777777778,0.1111111111111111,0.3181818181818182,0.7777777777777778,0.02857142857142857,0.1111111111111111
Susac syndrome,33010,4,23,21,20,1,22,6,16,0.8695652173913043,0.2608695652173913,0.9523809523809523,0.8695652173913043,0.2727272727272727,0.2608695652173913
Lethal recessive chondrodysplasia,30248,0,12,20,1,19,27,1,26,0.08333333333333333,0.08333333333333333,0.05,0.08333333333333333,0.037037037037037035,0.08333333333333333
Spastic paraplegia-Paget disease of bone syndrome,32867,0,15,16,15,1,30,0,30,1.0,0.0,0.9375,1.0,0.0,0.0
Aorto-ventricular tunnel,98820,12,8,23,1,22,22,0,22,0.125,0.0,0.043478260869565216,0.125,0.0,0.0
Central neurocytoma,32261,3,19,17,16,1,28,6,22,0.8421052631578947,0.3157894736842105,0.9411764705882353,0.8421052631578947,0.21428571428571427,0.3157894736842105
Bilateral acute depigmentation of the iris,33085,6,10,20,11,9,22,2,20,1.1,0.2,0.55,1.1,0.09090909090909091,0.2
Kikuchi-Fujimoto disease,32790,5,50,26,29,-3,25,13,12,0.58,0.26,1.1153846153846154,0.58,0.52,0.26
Cogan syndrome,32356,3,20,16,18,-2,25,6,19,0.9,0.3,1.125,0.9,0.24,0.3
Arginine vasopressin resistance,29832,0,21,16,4,12,23,2,21,0.19047619047619047,0.09523809523809523,0.25,0.19047619047619047,0.08695652173913043,0.09523809523809523
Functioning gonadotropic adenoma,32910,2,34,27,28,-1,24,5,19,0.8235294117647058,0.14705882352941177,1.037037037037037,0.8235294117647058,0.20833333333333334,0.14705882352941177
Juvenile temporal arteritis,27692,3,8,24,0,24,19,1,18,0.0,0.125,0.0,0.0,0.05263157894736842,0.125
Middle ear neuroendocrine tumor,33112,6,11,16,9,7,22,1,21,0.8181818181818182,0.09090909090909091,0.5625,0.8181818181818182,0.045454545454545456,0.09090909090909091
Familial hyperaldosteronism type I,27723,3,15,18,9,9,21,4,17,0.6,0.26666666666666666,0.5,0.6,0.19047619047619047,0.26666666666666666
Familial hypoaldosteronism,33456,1,19,16,16,0,27,4,23,0.8421052631578947,0.21052631578947367,1.0,0.8421052631578947,0.14814814814814814,0.21052631578947367
Primary hyperaldosteronism-seizures-neurological abnormalities syndrome,27832,1,30,19,18,1,20,4,16,0.6,0.13333333333333333,0.9473684210526315,0.6,0.2,0.13333333333333333
Vulvovaginal gingival syndrome,32315,4,13,19,14,5,19,4,15,1.0769230769230769,0.3076923076923077,0.7368421052631579,1.0769230769230769,0.21052631578947367,0.3076923076923077
Isaacs syndrome,32662,7,13,16,11,5,27,5,22,0.8461538461538461,0.38461538461538464,0.6875,0.8461538461538461,0.18518518518518517,0.38461538461538464
Epidermal nevus syndrome,32761,1,26,18,17,1,18,3,15,0.6538461538461539,0.11538461538461539,0.9444444444444444,0.6538461538461539,0.16666666666666666,0.11538461538461539
Granulomatous slack skin,33452,4,10,14,12,2,26,3,23,1.2,0.3,0.8571428571428571,1.2,0.11538461538461539,0.3
Acute adrenal insufficiency,38666,15,44,20,7,13,17,7,10,0.1590909090909091,0.1590909090909091,0.35,0.1590909090909091,0.4117647058823529,0.1590909090909091
Addison disease,30813,4,56,18,12,6,18,6,12,0.21428571428571427,0.10714285714285714,0.6666666666666666,0.21428571428571427,0.3333333333333333,0.10714285714285714
Acquired generalized lipodystrophy,31864,1,28,26,15,11,32,5,27,0.5357142857142857,0.17857142857142858,0.5769230769230769,0.5357142857142857,0.15625,0.17857142857142858
Adrenocortical carcinoma with pure aldosterone hypersecretion,32820,4,18,16,16,0,19,5,14,0.8888888888888888,0.2777777777777778,1.0,0.8888888888888888,0.2631578947368421,0.2777777777777778
Ectopic aldosterone-producing tumor,32811,10,13,17,11,6,34,7,27,0.8461538461538461,0.5384615384615384,0.6470588235294118,0.8461538461538461,0.20588235294117646,0.5384615384615384
Familial hyperaldosteronism type III,27723,2,17,18,13,5,29,5,24,0.7647058823529411,0.29411764705882354,0.7222222222222222,0.7647058823529411,0.1724137931034483,0.29411764705882354
Familial pseudohyperkalemia,27444,5,6,16,5,11,20,1,19,0.8333333333333334,0.16666666666666666,0.3125,0.8333333333333334,0.05,0.16666666666666666
Primary unilateral adrenal hyperplasia,32943,6,15,17,15,2,22,4,18,1.0,0.26666666666666666,0.8823529411764706,1.0,0.18181818181818182,0.26666666666666666
Aseptic abscess syndrome,32413,3,17,16,15,1,27,4,23,0.8823529411764706,0.23529411764705882,0.9375,0.8823529411764706,0.14814814814814814,0.23529411764705882
Plummer-Vinson syndrome,33448,6,16,17,12,5,16,3,13,0.75,0.1875,0.7058823529411765,0.75,0.1875,0.1875
Myoclonic epilepsy of infancy,33036,0,21,20,18,2,14,0,14,0.8571428571428571,0.0,0.9,0.8571428571428571,0.0,0.0
Hyperparathyroidism-jaw tumor syndrome,30026,1,35,27,22,5,18,1,17,0.6285714285714286,0.02857142857142857,0.8148148148148148,0.6285714285714286,0.05555555555555555,0.02857142857142857
Generalized glucocorticoid resistance syndrome,32087,2,21,17,13,4,15,5,10,0.6190476190476191,0.23809523809523808,0.7647058823529411,0.6190476190476191,0.3333333333333333,0.23809523809523808
Idiopathic isolated micropenis,27742,5,3,25,3,22,19,0,19,1.0,0.0,0.12,1.0,0.0,0.0
Congenital isolated ACTH deficiency,27685,4,11,33,5,28,28,4,24,0.45454545454545453,0.36363636363636365,0.15151515151515152,0.45454545454545453,0.14285714285714285,0.36363636363636365
Congenital tricuspid stenosis,27663,21,9,23,2,21,29,2,27,0.2222222222222222,0.2222222222222222,0.08695652173913043,0.2222222222222222,0.06896551724137931,0.2222222222222222
Body skin hyperlaxity due to vitamin K-dependent coagulation factor deficiency,29300,0,8,16,11,5,27,1,26,1.375,0.125,0.6875,1.375,0.037037037037037035,0.125
Maternal uniparental disomy of chromosome 9 syndrome,32675,0,21,17,17,0,26,0,26,0.8095238095238095,0.0,1.0,0.8095238095238095,0.0,0.0
Paternal uniparental disomy of chromosome 5 syndrome,32667,3,13,33,8,25,18,0,18,0.6153846153846154,0.0,0.24242424242424243,0.6153846153846154,0.0,0.0
Severe congenital hypochromic anemia with ringed sideroblasts,30402,3,20,18,16,2,30,3,27,0.8,0.15,0.8888888888888888,0.8,0.1,0.15
Congenital dyserythropoietic anemia type III,28183,2,20,21,14,7,25,6,19,0.7,0.3,0.6666666666666666,0.7,0.24,0.3
Ring chromosome 7 syndrome,32373,1,58,22,21,1,33,3,30,0.3620689655172414,0.05172413793103448,0.9545454545454546,0.3620689655172414,0.09090909090909091,0.05172413793103448
Congenital alpha2-antiplasmin deficiency,31680,5,12,18,13,5,23,4,19,1.0833333333333333,0.3333333333333333,0.7222222222222222,1.0833333333333333,0.17391304347826086,0.3333333333333333
Classic glucose transporter type 1 deficiency syndrome,31483,2,33,23,23,0,22,2,20,0.696969696969697,0.06060606060606061,1.0,0.696969696969697,0.09090909090909091,0.06060606060606061
N syndrome,28524,1,11,19,8,11,33,0,33,0.7272727272727273,0.0,0.42105263157894735,0.7272727272727273,0.0,0.0
Pineocytoma,33055,4,13,18,12,6,39,5,34,0.9230769230769231,0.38461538461538464,0.6666666666666666,0.9230769230769231,0.1282051282051282,0.38461538461538464
Papillary tumor of the pineal region,39302,11,14,21,4,17,34,9,25,0.2857142857142857,0.6428571428571429,0.19047619047619047,0.2857142857142857,0.2647058823529412,0.6428571428571429
Congenital factor XI deficiency,29969,7,9,21,11,10,18,4,14,1.2222222222222223,0.4444444444444444,0.5238095238095238,1.2222222222222223,0.2222222222222222,0.4444444444444444
Hereditary arterial and articular multiple calcification syndrome,28242,1,7,18,7,11,31,1,30,1.0,0.14285714285714285,0.3888888888888889,1.0,0.03225806451612903,0.14285714285714285
Hemolytic anemia due to red cell pyruvate kinase deficiency,31607,2,15,19,14,5,35,4,31,0.9333333333333333,0.26666666666666666,0.7368421052631579,0.9333333333333333,0.11428571428571428,0.26666666666666666
Congenital factor VII deficiency,28673,3,12,15,11,4,25,4,21,0.9166666666666666,0.3333333333333333,0.7333333333333333,0.9166666666666666,0.16,0.3333333333333333
Familial cerebral cavernous malformation,33380,6,25,19,15,4,34,6,28,0.6,0.24,0.7894736842105263,0.6,0.17647058823529413,0.24
Familial bicuspid aortic valve,33281,7,12,20,8,12,19,1,18,0.6666666666666666,0.08333333333333333,0.4,0.6666666666666666,0.05263157894736842,0.08333333333333333
Squamous cell carcinoma of the anal canal,32970,7,12,18,11,7,24,3,21,0.9166666666666666,0.25,0.6111111111111112,0.9166666666666666,0.125,0.25
Adenocarcinoma of the anal canal,38141,15,12,23,2,21,25,2,23,0.16666666666666666,0.16666666666666666,0.08695652173913043,0.16666666666666666,0.08,0.16666666666666666
"Spondyloepimetaphyseal dysplasia, matrilin-3 type",38339,5,11,17,1,16,23,1,22,0.09090909090909091,0.09090909090909091,0.058823529411764705,0.09090909090909091,0.043478260869565216,0.09090909090909091
"Craniometadiaphyseal dysplasia, wormian bone type",32101,0,26,40,25,15,21,1,20,0.9615384615384616,0.038461538461538464,0.625,0.9615384615384616,0.047619047619047616,0.038461538461538464
Spondyloepiphyseal dysplasia-craniosynostosis-cleft palate-cataracts-intellectual disability syndrome,31488,5,41,32,8,24,27,3,24,0.1951219512195122,0.07317073170731707,0.25,0.1951219512195122,0.1111111111111111,0.07317073170731707
Familial short QT syndrome,27655,5,9,21,5,16,23,4,19,0.5555555555555556,0.4444444444444444,0.23809523809523808,0.5555555555555556,0.17391304347826086,0.4444444444444444
Osteoporosis-oculocutaneous hypopigmentation syndrome,27401,5,12,17,11,6,29,4,25,0.9166666666666666,0.3333333333333333,0.6470588235294118,0.9166666666666666,0.13793103448275862,0.3333333333333333
Primary hyperoxaluria type 1,29946,2,19,19,4,15,11,1,10,0.21052631578947367,0.05263157894736842,0.21052631578947367,0.21052631578947367,0.09090909090909091,0.05263157894736842
Hypergonadotropic hypogonadism-cataract syndrome,28407,3,13,17,7,10,34,7,27,0.5384615384615384,0.5384615384615384,0.4117647058823529,0.5384615384615384,0.20588235294117646,0.5384615384615384
Circumscribed palmoplantar hypokeratosis,33083,7,5,17,5,12,17,2,15,1.0,0.4,0.29411764705882354,1.0,0.11764705882352941,0.4
Amoebic keratitis,33229,5,15,16,13,3,17,6,11,0.8666666666666667,0.4,0.8125,0.8666666666666667,0.35294117647058826,0.4
Thrombotic thrombocytopenic purpura,29935,4,22,17,8,9,21,7,14,0.36363636363636365,0.3181818181818182,0.47058823529411764,0.36363636363636365,0.3333333333333333,0.3181818181818182
Hypoparathyroidism-sensorineural deafness-renal disease syndrome,30648,1,22,22,17,5,18,1,17,0.7727272727272727,0.045454545454545456,0.7727272727272727,0.7727272727272727,0.05555555555555555,0.045454545454545456
Anonychia with flexural pigmentation,31744,1,13,18,11,7,16,1,15,0.8461538461538461,0.07692307692307693,0.6111111111111112,0.8461538461538461,0.0625,0.07692307692307693
Hypogonadotropic hypogonadism-retinitis pigmentosa syndrome,33522,3,20,18,18,0,32,5,27,0.9,0.25,1.0,0.9,0.15625,0.25
Congenital sucrase-isomaltase deficiency,98349,16,14,23,9,14,21,9,12,0.6428571428571429,0.6428571428571429,0.391304347826087,0.6428571428571429,0.42857142857142855,0.6428571428571429
Retinopathy of prematurity,32877,8,15,20,12,8,27,6,21,0.8,0.4,0.6,0.8,0.2222222222222222,0.4
Autosomal dominant Charcot-Marie-Tooth disease type 2F,94966,17,12,23,1,22,26,2,24,0.08333333333333333,0.16666666666666666,0.043478260869565216,0.08333333333333333,0.07692307692307693,0.16666666666666666
Osteochondritis dissecans,27943,3,17,26,14,12,26,7,19,0.8235294117647058,0.4117647058823529,0.5384615384615384,0.8235294117647058,0.2692307692307692,0.4117647058823529
AA amyloidosis,33159,8,32,25,1,24,24,1,23,0.03125,0.03125,0.04,0.03125,0.041666666666666664,0.03125
Radiation proctitis,32916,7,19,20,14,6,22,6,16,0.7368421052631579,0.3157894736842105,0.7,0.7368421052631579,0.2727272727272727,0.3157894736842105
Spinocerebellar ataxia type 11,27402,7,11,27,2,25,9,2,7,0.18181818181818182,0.18181818181818182,0.07407407407407407,0.18181818181818182,0.2222222222222222,0.18181818181818182
Spinocerebellar ataxia type 3,27402,6,16,33,1,32,16,3,13,0.0625,0.1875,0.030303030303030304,0.0625,0.1875,0.1875
Paroxysmal exertion-induced dyskinesia,29166,1,17,18,5,13,21,1,20,0.29411764705882354,0.058823529411764705,0.2777777777777778,0.29411764705882354,0.047619047619047616,0.058823529411764705
Maternal uniparental disomy of chromosome 6 syndrome,32677,2,21,17,16,1,26,2,24,0.7619047619047619,0.09523809523809523,0.9411764705882353,0.7619047619047619,0.07692307692307693,0.09523809523809523
Maternal uniparental disomy of chromosome 1 syndrome,33160,1,29,26,27,-1,30,2,28,0.9310344827586207,0.06896551724137931,1.0384615384615385,0.9310344827586207,0.06666666666666667,0.06896551724137931
Spinocerebellar ataxia type 5,27402,10,4,23,4,19,11,2,9,1.0,0.5,0.17391304347826086,1.0,0.18181818181818182,0.5
Paternal uniparental disomy of chromosome 6 syndrome,32666,0,30,17,16,1,26,1,25,0.5333333333333333,0.03333333333333333,0.9411764705882353,0.5333333333333333,0.038461538461538464,0.03333333333333333
Hemihyperplasia-multiple lipomatosis syndrome,32607,0,19,17,16,1,21,0,21,0.8421052631578947,0.0,0.9411764705882353,0.8421052631578947,0.0,0.0
Paternal uniparental disomy of chromosome 1 syndrome,33161,2,29,16,16,0,30,2,28,0.5517241379310345,0.06896551724137931,1.0,0.5517241379310345,0.06666666666666667,0.06896551724137931
Maternal uniparental disomy of chromosome 4 syndrome,32678,3,39,18,19,-1,31,3,28,0.48717948717948717,0.07692307692307693,1.0555555555555556,0.48717948717948717,0.0967741935483871,0.07692307692307693
Primary hyperoxaluria type 3,29946,2,9,23,5,18,17,1,16,0.5555555555555556,0.1111111111111111,0.21739130434782608,0.5555555555555556,0.058823529411764705,0.1111111111111111
Primary hyperoxaluria type 2,29946,2,6,16,4,12,9,2,7,0.6666666666666666,0.3333333333333333,0.25,0.6666666666666666,0.2222222222222222,0.3333333333333333
Congenital glucokinase-related hyperinsulinism,31796,2,13,16,10,6,26,2,24,0.7692307692307693,0.15384615384615385,0.625,0.7692307692307693,0.07692307692307693,0.15384615384615385
Placental insufficiency,33231,2,20,16,15,1,30,5,25,0.75,0.25,0.9375,0.75,0.16666666666666666,0.25
Pulmonary fibrosis-hepatic hyperplasia-bone marrow hypoplasia syndrome,32389,2,16,16,17,-1,22,3,19,1.0625,0.1875,1.0625,1.0625,0.13636363636363635,0.1875
Maternal uniparental disomy of chromosome 2 syndrome,32679,0,28,17,17,0,41,0,41,0.6071428571428571,0.0,1.0,0.6071428571428571,0.0,0.0
Dermochondrocorneal dystrophy,30236,0,7,17,4,13,23,1,22,0.5714285714285714,0.14285714285714285,0.23529411764705882,0.5714285714285714,0.043478260869565216,0.14285714285714285
Hereditary breast and/or ovarian cancer syndrome,83817,10,7,16,1,15,27,3,24,0.14285714285714285,0.42857142857142855,0.0625,0.14285714285714285,0.1111111111111111,0.42857142857142855
Kleefstra syndrome due to 9q34 microdeletion,32652,3,55,17,15,2,25,5,20,0.2727272727272727,0.09090909090909091,0.8823529411764706,0.2727272727272727,0.2,0.09090909090909091
Pediatric hepatocellular carcinoma,32621,5,9,17,9,8,16,2,14,1.0,0.2222222222222222,0.5294117647058824,1.0,0.125,0.2222222222222222
Microphthalmia with linear skin defects syndrome,32750,3,77,71,67,4,34,8,26,0.8701298701298701,0.1038961038961039,0.9436619718309859,0.8701298701298701,0.23529411764705882,0.1038961038961039
Microcephaly-lymphedema-chorioretinopathy syndrome,30010,0,67,28,16,12,29,10,19,0.23880597014925373,0.14925373134328357,0.5714285714285714,0.23880597014925373,0.3448275862068966,0.14925373134328357
Neu-Laxova syndrome,31697,2,63,26,20,6,35,3,32,0.31746031746031744,0.047619047619047616,0.7692307692307693,0.31746031746031744,0.08571428571428572,0.047619047619047616
Mietens syndrome,30953,0,32,34,25,9,43,0,43,0.78125,0.0,0.7352941176470589,0.78125,0.0,0.0
"Blepharophimosis-intellectual disability syndrome, SBBYS type",35826,18,43,26,4,22,20,4,16,0.09302325581395349,0.09302325581395349,0.15384615384615385,0.09302325581395349,0.2,0.09302325581395349
Ear-patella-short stature syndrome,29471,4,49,17,2,15,32,3,29,0.04081632653061224,0.061224489795918366,0.11764705882352941,0.04081632653061224,0.09375,0.061224489795918366
Chronic inflammatory demyelinating polyneuropathy,27761,1,21,18,10,8,31,3,28,0.47619047619047616,0.14285714285714285,0.5555555555555556,0.47619047619047616,0.0967741935483871,0.14285714285714285
Baraitser-Winter cerebrofrontofacial syndrome,33405,3,62,21,21,0,30,6,24,0.3387096774193548,0.0967741935483871,1.0,0.3387096774193548,0.2,0.0967741935483871
Ichthyosis follicularis-alopecia-photophobia syndrome,38721,17,78,20,2,18,34,4,30,0.02564102564102564,0.05128205128205128,0.1,0.02564102564102564,0.11764705882352941,0.05128205128205128
Nicolaides-Baraitser syndrome,31904,0,50,17,1,16,40,3,37,0.02,0.06,0.058823529411764705,0.02,0.075,0.06
Filippi syndrome,31620,0,40,46,32,14,41,1,40,0.8,0.025,0.6956521739130435,0.8,0.024390243902439025,0.025
Wild type ABeta2M amyloidosis,33133,0,27,16,1,15,31,2,29,0.037037037037037035,0.07407407407407407,0.0625,0.037037037037037035,0.06451612903225806,0.07407407407407407
Hemophilia B,27361,3,14,25,9,16,25,5,20,0.6428571428571429,0.35714285714285715,0.36,0.6428571428571429,0.2,0.35714285714285715
Hemophilia A,32220,7,14,16,5,11,27,6,21,0.35714285714285715,0.42857142857142855,0.3125,0.35714285714285715,0.2222222222222222,0.42857142857142855
Autosomal semi-dominant severe lipodystrophic laminopathy,32642,0,49,24,25,-1,22,0,22,0.5102040816326531,0.0,1.0416666666666667,0.5102040816326531,0.0,0.0
"GM2 gangliosidosis, AB variant",38766,18,25,45,1,44,26,1,25,0.04,0.04,0.022222222222222223,0.04,0.038461538461538464,0.04
Duchenne muscular dystrophy,32149,2,15,17,8,9,37,5,32,0.5333333333333333,0.3333333333333333,0.47058823529411764,0.5333333333333333,0.13513513513513514,0.3333333333333333
Bronchopulmonary dysplasia,37877,14,27,18,6,12,23,5,18,0.2222222222222222,0.18518518518518517,0.3333333333333333,0.2222222222222222,0.21739130434782608,0.18518518518518517
Neurofibroma,27275,3,28,27,0,27,47,3,44,0.0,0.10714285714285714,0.0,0.0,0.06382978723404255,0.10714285714285714
Meningioma,33215,1,74,28,22,6,33,8,25,0.2972972972972973,0.10810810810810811,0.7857142857142857,0.2972972972972973,0.24242424242424243,0.10810810810810811
Pyruvate dehydrogenase E3 deficiency,31168,4,28,31,24,7,25,2,23,0.8571428571428571,0.07142857142857142,0.7741935483870968,0.8571428571428571,0.08,0.07142857142857142
Familial atrial myxoma,27881,1,18,16,15,1,24,1,23,0.8333333333333334,0.05555555555555555,0.9375,0.8333333333333334,0.041666666666666664,0.05555555555555555
PRKAR1B-related neurodegenerative dementia with intermediate filaments,27744,3,23,18,18,0,21,2,19,0.782608695652174,0.08695652173913043,1.0,0.782608695652174,0.09523809523809523,0.08695652173913043
Congenital glaucoma,33033,14,18,19,2,17,24,4,20,0.1111111111111111,0.2222222222222222,0.10526315789473684,0.1111111111111111,0.16666666666666666,0.2222222222222222
Medulloblastoma,31067,3,34,32,31,1,22,5,17,0.9117647058823529,0.14705882352941177,0.96875,0.9117647058823529,0.22727272727272727,0.14705882352941177
Walker-Warburg syndrome,32027,1,51,33,2,31,24,3,21,0.0392156862745098,0.058823529411764705,0.06060606060606061,0.0392156862745098,0.125,0.058823529411764705
Ullrich congenital muscular dystrophy,27258,1,31,19,11,8,27,3,24,0.3548387096774194,0.0967741935483871,0.5789473684210527,0.3548387096774194,0.1111111111111111,0.0967741935483871
Drug-induced lupus erythematosus,32190,6,23,21,16,5,21,7,14,0.6956521739130435,0.30434782608695654,0.7619047619047619,0.6956521739130435,0.3333333333333333,0.30434782608695654
Hereditary angioedema type 1,29854,7,26,28,24,4,24,10,14,0.9230769230769231,0.38461538461538464,0.8571428571428571,0.9230769230769231,0.4166666666666667,0.38461538461538464
POEMS syndrome,33287,5,51,37,38,-1,26,7,19,0.7450980392156863,0.13725490196078433,1.027027027027027,0.7450980392156863,0.2692307692307692,0.13725490196078433
"46,XX difference of sex development-skeletal anomalies syndrome",27795,1,12,18,11,7,50,0,50,0.9166666666666666,0.0,0.6111111111111112,0.9166666666666666,0.0,0.0
Severe neurodegenerative syndrome with lipodystrophy,31872,1,37,36,34,2,24,2,22,0.918918918918919,0.05405405405405406,0.9444444444444444,0.918918918918919,0.08333333333333333,0.05405405405405406
Dextrocardia,30952,0,26,20,3,17,29,1,28,0.11538461538461539,0.038461538461538464,0.15,0.11538461538461539,0.034482758620689655,0.038461538461538464
Infantile systemic hyalinosis,33337,0,37,18,19,-1,27,4,23,0.5135135135135135,0.10810810810810811,1.0555555555555556,0.5135135135135135,0.14814814814814814,0.10810810810810811
Occipital horn syndrome,30923,2,70,18,19,-1,17,3,14,0.2714285714285714,0.04285714285714286,1.0555555555555556,0.2714285714285714,0.17647058823529413,0.04285714285714286
Arterial tortuosity syndrome,29806,3,61,27,13,14,24,5,19,0.21311475409836064,0.08196721311475409,0.48148148148148145,0.21311475409836064,0.20833333333333334,0.08196721311475409
Progeria-short stature-pigmented nevi syndrome,29625,5,56,57,45,12,37,6,31,0.8035714285714286,0.10714285714285714,0.7894736842105263,0.8035714285714286,0.16216216216216217,0.10714285714285714
Autosomal dominant Robinow syndrome,29073,1,80,17,10,7,32,2,30,0.125,0.025,0.5882352941176471,0.125,0.0625,0.025
Desmosterolosis,30138,0,57,69,62,7,47,0,47,1.087719298245614,0.0,0.8985507246376812,1.087719298245614,0.0,0.0
Oculoectodermal syndrome,29016,0,36,17,6,11,28,2,26,0.16666666666666666,0.05555555555555555,0.35294117647058826,0.16666666666666666,0.07142857142857142,0.05555555555555555
Secondary syringomyelia,31462,9,26,16,1,15,25,3,22,0.038461538461538464,0.11538461538461539,0.0625,0.038461538461538464,0.12,0.11538461538461539
Genetic hyperferritinemia without iron overload,27831,12,8,28,3,25,19,1,18,0.375,0.125,0.10714285714285714,0.375,0.05263157894736842,0.125
Adenohypophysitis,32603,1,32,25,19,6,19,1,18,0.59375,0.03125,0.76,0.59375,0.05263157894736842,0.03125
Panhypophysitis,32600,1,35,18,17,1,19,2,17,0.4857142857142857,0.05714285714285714,0.9444444444444444,0.4857142857142857,0.10526315789473684,0.05714285714285714
Perlman syndrome,29079,0,38,17,12,5,21,0,21,0.3157894736842105,0.0,0.7058823529411765,0.3157894736842105,0.0,0.0
Sheehan syndrome,32905,3,49,17,17,0,28,3,25,0.3469387755102041,0.061224489795918366,1.0,0.3469387755102041,0.10714285714285714,0.061224489795918366
Lenz-Majewski hyperostotic dwarfism,30033,2,58,18,13,5,24,4,20,0.22413793103448276,0.06896551724137931,0.7222222222222222,0.22413793103448276,0.16666666666666666,0.06896551724137931
Osteopathia striata-cranial sclerosis syndrome,30098,2,44,25,9,16,9,3,6,0.20454545454545456,0.06818181818181818,0.36,0.20454545454545456,0.3333333333333333,0.06818181818181818
NK-cell enteropathy,33479,7,14,18,10,8,24,4,20,0.7142857142857143,0.2857142857142857,0.5555555555555556,0.7142857142857143,0.16666666666666666,0.2857142857142857
Focal facial dermal dysplasia type IV,27910,1,17,67,14,53,24,1,23,0.8235294117647058,0.058823529411764705,0.208955223880597,0.8235294117647058,0.041666666666666664,0.058823529411764705
Interstitial cystitis,33249,3,19,15,11,4,18,3,15,0.5789473684210527,0.15789473684210525,0.7333333333333333,0.5789473684210527,0.16666666666666666,0.15789473684210525
Autosomal dominant optic atrophy and cataract,27858,3,35,41,13,28,27,5,22,0.37142857142857144,0.14285714285714285,0.3170731707317073,0.37142857142857144,0.18518518518518517,0.14285714285714285
X-linked endothelial corneal dystrophy,29476,11,7,19,8,11,24,3,21,1.1428571428571428,0.42857142857142855,0.42105263157894735,1.1428571428571428,0.125,0.42857142857142855
Encephalocraniocutaneous lipomatosis,30513,2,55,16,14,2,33,4,29,0.2545454545454545,0.07272727272727272,0.875,0.2545454545454545,0.12121212121212122,0.07272727272727272
Thrombocytopenia with congenital dyserythropoietic anemia,33233,7,9,22,8,14,29,2,27,0.8888888888888888,0.2222222222222222,0.36363636363636365,0.8888888888888888,0.06896551724137931,0.2222222222222222
Obesity due to melanocortin 4 receptor deficiency,32571,19,10,27,6,21,31,6,25,0.6,0.6,0.2222222222222222,0.6,0.1935483870967742,0.6
Obesity due to leptin receptor gene deficiency,27508,2,21,25,16,9,19,2,17,0.7619047619047619,0.09523809523809523,0.64,0.7619047619047619,0.10526315789473684,0.09523809523809523
Obesity due to congenital leptin deficiency,29143,0,20,18,13,5,34,2,32,0.65,0.1,0.7222222222222222,0.65,0.058823529411764705,0.1
Lynch syndrome,31841,4,62,11,5,6,22,5,17,0.08064516129032258,0.08064516129032258,0.45454545454545453,0.08064516129032258,0.22727272727272727,0.08064516129032258
Sarcoidosis,32967,0,77,17,16,1,30,6,24,0.2077922077922078,0.07792207792207792,0.9411764705882353,0.2077922077922078,0.2,0.07792207792207792
Vernal keratoconjunctivitis,32918,4,23,20,12,8,20,8,12,0.5217391304347826,0.34782608695652173,0.6,0.5217391304347826,0.4,0.34782608695652173
Familial Alzheimer-like prion disease,31527,6,12,16,1,15,24,3,21,0.08333333333333333,0.25,0.0625,0.08333333333333333,0.125,0.25
Adenylosuccinate lyase deficiency,31130,3,17,27,6,21,27,1,26,0.35294117647058826,0.058823529411764705,0.2222222222222222,0.35294117647058826,0.037037037037037035,0.058823529411764705
ALG13-CDG,31434,1,19,26,1,25,22,1,21,0.05263157894736842,0.05263157894736842,0.038461538461538464,0.05263157894736842,0.045454545454545456,0.05263157894736842
Brain dopamine-serotonin vesicular transport disease,32882,2,31,18,16,2,31,2,29,0.5161290322580645,0.06451612903225806,0.8888888888888888,0.5161290322580645,0.06451612903225806,0.06451612903225806
Juvenile absence epilepsy,33115,0,13,24,12,12,19,3,16,0.9230769230769231,0.23076923076923078,0.5,0.9230769230769231,0.15789473684210525,0.23076923076923078
Pituitary apoplexy,32738,4,41,32,33,-1,33,7,26,0.8048780487804879,0.17073170731707318,1.03125,0.8048780487804879,0.21212121212121213,0.17073170731707318
Pituitary dermoid and epidermoid cysts,32900,4,24,17,17,0,44,5,39,0.7083333333333334,0.20833333333333334,1.0,0.7083333333333334,0.11363636363636363,0.20833333333333334
Early-onset Lafora body disease,31763,3,12,16,9,7,33,4,29,0.75,0.3333333333333333,0.5625,0.75,0.12121212121212122,0.3333333333333333
Late-onset isolated ACTH deficiency,27685,5,41,33,34,-1,27,10,17,0.8292682926829268,0.24390243902439024,1.0303030303030303,0.8292682926829268,0.37037037037037035,0.24390243902439024
Tangier disease,30143,3,22,25,14,11,26,1,25,0.6363636363636364,0.045454545454545456,0.56,0.6363636363636364,0.038461538461538464,0.045454545454545456
Severe X-linked mitochondrial encephalomyopathy,30819,2,23,19,11,8,30,2,28,0.4782608695652174,0.08695652173913043,0.5789473684210527,0.4782608695652174,0.06666666666666667,0.08695652173913043
VIPoma,27660,2,41,18,17,1,20,4,16,0.4146341463414634,0.0975609756097561,0.9444444444444444,0.4146341463414634,0.2,0.0975609756097561
Glycine encephalopathy,28289,3,13,17,10,7,26,2,24,0.7692307692307693,0.15384615384615385,0.5882352941176471,0.7692307692307693,0.07692307692307693,0.15384615384615385
American trypanosomiasis,32503,1,27,19,1,18,37,9,28,0.037037037037037035,0.3333333333333333,0.05263157894736842,0.037037037037037035,0.24324324324324326,0.3333333333333333
RFT1-CDG,30571,4,22,31,22,9,28,4,24,1.0,0.18181818181818182,0.7096774193548387,1.0,0.14285714285714285,0.18181818181818182
SSR4-CDG,100022,6,28,27,0,27,33,3,30,0.0,0.10714285714285714,0.0,0.0,0.09090909090909091,0.10714285714285714
SLC35A1-CDG,29977,0,13,21,10,11,22,0,22,0.7692307692307693,0.0,0.47619047619047616,0.7692307692307693,0.0,0.0
STT3A-CDG,30045,2,13,17,10,7,24,1,23,0.7692307692307693,0.07692307692307693,0.5882352941176471,0.7692307692307693,0.041666666666666664,0.07692307692307693
STT3B-CDG,32157,1,17,16,13,3,27,1,26,0.7647058823529411,0.058823529411764705,0.8125,0.7647058823529411,0.037037037037037035,0.058823529411764705
Chronic myeloid leukemia,30039,2,11,14,9,5,32,3,29,0.8181818181818182,0.2727272727272727,0.6428571428571429,0.8181818181818182,0.09375,0.2727272727272727
Acral peeling skin syndrome,27197,6,12,18,8,10,21,5,16,0.6666666666666666,0.4166666666666667,0.4444444444444444,0.6666666666666666,0.23809523809523808,0.4166666666666667
Kaposi sarcoma,99253,17,26,19,4,15,25,4,21,0.15384615384615385,0.15384615384615385,0.21052631578947367,0.15384615384615385,0.16,0.15384615384615385
PPoma,32273,4,32,19,11,8,32,5,27,0.34375,0.15625,0.5789473684210527,0.34375,0.15625,0.15625
Moyamoya disease with early-onset achalasia,28581,1,8,16,6,10,17,0,17,0.75,0.0,0.375,0.75,0.0,0.0
Zollinger-Ellison syndrome,32875,3,34,22,23,-1,22,6,16,0.6764705882352942,0.17647058823529413,1.0454545454545454,0.6764705882352942,0.2727272727272727,0.17647058823529413
"Pseudoleprechaunism syndrome, Patterson type",27308,1,29,37,24,13,18,1,17,0.8275862068965517,0.034482758620689655,0.6486486486486487,0.8275862068965517,0.05555555555555555,0.034482758620689655
Colchicine poisoning,33018,1,29,17,17,0,24,6,18,0.5862068965517241,0.20689655172413793,1.0,0.5862068965517241,0.25,0.20689655172413793
AICA-ribosiduria,30286,1,10,19,7,12,26,0,26,0.7,0.0,0.3684210526315789,0.7,0.0,0.0
Glucagonoma,32267,4,42,29,26,3,27,7,20,0.6190476190476191,0.16666666666666666,0.896551724137931,0.6190476190476191,0.25925925925925924,0.16666666666666666
Malaria,33128,3,16,18,15,3,17,5,12,0.9375,0.3125,0.8333333333333334,0.9375,0.29411764705882354,0.3125
Leishmaniasis,38998,16,25,32,5,27,25,8,17,0.2,0.32,0.15625,0.2,0.32,0.32
Uveal melanoma,33172,3,17,17,17,0,18,4,14,1.0,0.23529411764705882,1.0,1.0,0.2222222222222222,0.23529411764705882
GRFoma,32281,2,38,17,16,1,43,7,36,0.42105263157894735,0.18421052631578946,0.9411764705882353,0.42105263157894735,0.16279069767441862,0.18421052631578946
Somatostatinoma,96642,14,35,24,6,18,27,5,22,0.17142857142857143,0.14285714285714285,0.25,0.17142857142857143,0.18518518518518517,0.14285714285714285
RHYNS syndrome,29684,0,19,18,13,5,13,0,13,0.6842105263157895,0.0,0.7222222222222222,0.6842105263157895,0.0,0.0
Åland Islands eye disease,27416,4,9,22,8,14,27,2,25,0.8888888888888888,0.2222222222222222,0.36363636363636365,0.8888888888888888,0.07407407407407407,0.2222222222222222
7q11.23 microduplication syndrome,32059,3,95,57,48,9,27,7,20,0.5052631578947369,0.07368421052631578,0.8421052631578947,0.5052631578947369,0.25925925925925924,0.07368421052631578
Hepatic veno-occlusive disease,32827,10,12,20,13,7,28,5,23,1.0833333333333333,0.4166666666666667,0.65,1.0833333333333333,0.17857142857142858,0.4166666666666667
Mercury poisoning,32280,2,21,16,16,0,38,4,34,0.7619047619047619,0.19047619047619047,1.0,0.7619047619047619,0.10526315789473684,0.19047619047619047
Sickle cell anemia,28921,4,37,17,13,4,29,6,23,0.35135135135135137,0.16216216216216217,0.7647058823529411,0.35135135135135137,0.20689655172413793,0.16216216216216217
Ring chromosome 13 syndrome,32681,1,42,17,17,0,33,3,30,0.40476190476190477,0.07142857142857142,1.0,0.40476190476190477,0.09090909090909091,0.07142857142857142
Monosomy 13q34 syndrome,32684,1,35,31,30,1,31,2,29,0.8571428571428571,0.05714285714285714,0.967741935483871,0.8571428571428571,0.06451612903225806,0.05714285714285714
Urocanic aciduria,38526,8,11,23,0,23,42,0,42,0.0,0.0,0.0,0.0,0.0,0.0
20q13.33 microdeletion syndrome,32429,6,43,105,17,88,32,5,27,0.3953488372093023,0.11627906976744186,0.1619047619047619,0.3953488372093023,0.15625,0.11627906976744186
Microtriplication 11q24.1 syndrome,27698,2,39,18,19,-1,16,3,13,0.48717948717948717,0.07692307692307693,1.0555555555555556,0.48717948717948717,0.1875,0.07692307692307693
Pancreatic hypoplasia-diabetes-congenital heart disease syndrome,30063,2,40,21,19,2,30,2,28,0.475,0.05,0.9047619047619048,0.475,0.06666666666666667,0.05
SERKAL syndrome,27931,0,15,19,9,10,15,0,15,0.6,0.0,0.47368421052631576,0.6,0.0,0.0
Lennox-Gastaut syndrome,29865,4,25,20,13,7,33,3,30,0.52,0.12,0.65,0.52,0.09090909090909091,0.12
BNAR syndrome,32053,5,7,21,6,15,15,0,15,0.8571428571428571,0.0,0.2857142857142857,0.8571428571428571,0.0,0.0
Amyotrophic lateral sclerosis,31996,2,47,42,11,31,23,10,13,0.23404255319148937,0.2127659574468085,0.2619047619047619,0.23404255319148937,0.43478260869565216,0.2127659574468085
Symphalangism with multiple anomalies of hands and feet,31741,0,22,28,24,4,34,0,34,1.0909090909090908,0.0,0.8571428571428571,1.0909090909090908,0.0,0.0
6-pyruvoyl-tetrahydropterin synthase deficiency,31733,4,31,19,19,0,29,4,25,0.6129032258064516,0.12903225806451613,1.0,0.6129032258064516,0.13793103448275862,0.12903225806451613
Hypoinsulinemic hypoglycemia and body hemihypertrophy,27764,3,14,21,10,11,23,1,22,0.7142857142857143,0.07142857142857142,0.47619047619047616,0.7142857142857143,0.043478260869565216,0.07142857142857142
FADD-related immunodeficiency,30359,1,8,16,8,8,29,0,29,1.0,0.0,0.5,1.0,0.0,0.0
Kyphoscoliotic Ehlers-Danlos syndrome due to FKBP22 deficiency,33340,4,23,17,9,8,34,3,31,0.391304347826087,0.13043478260869565,0.5294117647058824,0.391304347826087,0.08823529411764706,0.13043478260869565
Hyperinsulinism due to INSR deficiency,28937,6,9,19,9,10,32,3,29,1.0,0.3333333333333333,0.47368421052631576,1.0,0.09375,0.3333333333333333
Systemic primary carnitine deficiency,29130,12,9,21,1,20,26,1,25,0.1111111111111111,0.1111111111111111,0.047619047619047616,0.1111111111111111,0.038461538461538464,0.1111111111111111
Papular xanthoma,33506,9,4,20,3,17,16,0,16,0.75,0.0,0.15,0.75,0.0,0.0
Multiple endocrine neoplasia type 4,28426,6,39,39,11,28,32,6,26,0.28205128205128205,0.15384615384615385,0.28205128205128205,0.28205128205128205,0.1875,0.15384615384615385
Monosomy 22 syndrome,32660,1,40,18,18,0,24,2,22,0.45,0.05,1.0,0.45,0.08333333333333333,0.05
"Spondyloepimetaphyseal dysplasia, aggrecan type",38339,4,17,21,2,19,19,0,19,0.11764705882352941,0.0,0.09523809523809523,0.11764705882352941,0.0,0.0
CHST3-related skeletal dysplasia,27279,4,26,115,26,89,26,1,25,1.0,0.038461538461538464,0.22608695652173913,1.0,0.038461538461538464,0.038461538461538464
Sensorineural deafness with dilated cardiomyopathy,98109,16,5,24,1,23,18,0,18,0.2,0.0,0.041666666666666664,0.2,0.0,0.0
Congenital fibrinogen deficiency,30267,1,26,16,14,2,21,4,17,0.5384615384615384,0.15384615384615385,0.875,0.5384615384615384,0.19047619047619047,0.15384615384615385
Atypical hemolytic uremic syndrome,30066,3,13,21,5,16,18,4,14,0.38461538461538464,0.3076923076923077,0.23809523809523808,0.38461538461538464,0.2222222222222222,0.3076923076923077
Oculocutaneous albinism type 5,84278,6,7,25,7,18,24,4,20,1.0,0.5714285714285714,0.28,1.0,0.16666666666666666,0.5714285714285714
Primary sclerosing cholangitis,27700,5,55,32,32,0,19,8,11,0.5818181818181818,0.14545454545454545,1.0,0.5818181818181818,0.42105263157894735,0.14545454545454545
Centrifugal lipodystrophy,33048,6,10,16,9,7,29,3,26,0.9,0.3,0.5625,0.9,0.10344827586206896,0.3
Panniculitis-induced localized lipodystrophy,33044,3,9,20,9,11,20,0,20,1.0,0.0,0.45,1.0,0.0,0.0
Emanuel syndrome,31692,0,80,69,65,4,26,0,26,0.8125,0.0,0.9420289855072463,0.8125,0.0,0.0
Tetrasomy 9p syndrome,39342,15,82,25,2,23,31,2,29,0.024390243902439025,0.024390243902439025,0.08,0.024390243902439025,0.06451612903225806,0.024390243902439025
X-linked adrenoleukodystrophy,32783,1,36,41,9,32,39,6,33,0.25,0.16666666666666666,0.21951219512195122,0.25,0.15384615384615385,0.16666666666666666
Pressure-induced localized lipoatrophy,33041,2,7,22,7,15,17,0,17,1.0,0.0,0.3181818181818182,1.0,0.0,0.0
"Primary dystonia, DYT13 type",27743,8,14,70,14,56,29,3,26,1.0,0.21428571428571427,0.2,1.0,0.10344827586206896,0.21428571428571427
Ring chromosome 12 syndrome,32385,0,27,20,19,1,33,1,32,0.7037037037037037,0.037037037037037035,0.95,0.7037037037037037,0.030303030303030304,0.037037037037037035
Autosomal recessive hypophosphatemic rickets,27800,2,37,17,13,4,23,5,18,0.35135135135135137,0.13513513513513514,0.7647058823529411,0.35135135135135137,0.21739130434782608,0.13513513513513514
Craniopharyngioma,32939,4,46,39,38,1,32,5,27,0.8260869565217391,0.10869565217391304,0.9743589743589743,0.8260869565217391,0.15625,0.10869565217391304
Pituitary deficiency due to empty sella turcica syndrome,27741,1,21,17,15,2,20,1,19,0.7142857142857143,0.047619047619047616,0.8823529411764706,0.7142857142857143,0.05,0.047619047619047616
Solar urticaria,32231,9,16,21,14,7,31,8,23,0.875,0.5,0.6666666666666666,0.875,0.25806451612903225,0.5
Becker muscular dystrophy,30669,3,16,17,10,7,24,5,19,0.625,0.3125,0.5882352941176471,0.625,0.20833333333333334,0.3125
Pituitary deficiency due to Rathke cleft cysts,32899,0,24,17,19,-2,27,0,27,0.7916666666666666,0.0,1.1176470588235294,0.7916666666666666,0.0,0.0
Nelson syndrome,28832,0,27,19,0,19,32,3,29,0.0,0.1111111111111111,0.0,0.0,0.09375,0.1111111111111111
Dimethylglycine dehydrogenase deficiency,28290,0,5,7,4,3,20,0,20,0.8,0.0,0.5714285714285714,0.8,0.0,0.0
Giant axonal neuropathy,29389,1,26,25,15,10,27,2,25,0.5769230769230769,0.07692307692307693,0.6,0.5769230769230769,0.07407407407407407,0.07692307692307693
Inhalational anthrax,32710,8,12,19,10,9,29,6,23,0.8333333333333334,0.5,0.5263157894736842,0.8333333333333334,0.20689655172413793,0.5
Branchioskeletogenital syndrome,29196,0,55,29,1,28,22,0,22,0.01818181818181818,0.0,0.034482758620689655,0.01818181818181818,0.0,0.0
Hereditary chronic pancreatitis,28384,3,9,16,8,8,21,4,17,0.8888888888888888,0.4444444444444444,0.5,0.8888888888888888,0.19047619047619047,0.4444444444444444
Autism spectrum disorder-epilepsy-arthrogryposis syndrome,29642,2,10,17,7,10,35,0,35,0.7,0.0,0.4117647058823529,0.7,0.0,0.0
Oculocutaneous albinism type 6,84278,8,7,29,5,24,31,4,27,0.7142857142857143,0.5714285714285714,0.1724137931034483,0.7142857142857143,0.12903225806451613,0.5714285714285714
Focal facial dermal dysplasia type II,27910,1,13,26,3,23,29,0,29,0.23076923076923078,0.0,0.11538461538461539,0.23076923076923078,0.0,0.0
Calciphylaxis,84215,11,13,27,2,25,22,2,20,0.15384615384615385,0.15384615384615385,0.07407407407407407,0.15384615384615385,0.09090909090909091,0.15384615384615385
Homozygous familial hypercholesterolemia,33299,8,33,27,23,4,35,8,27,0.696969696969697,0.24242424242424243,0.8518518518518519,0.696969696969697,0.22857142857142856,0.24242424242424243
Familial chylomicronemia syndrome,27755,1,22,16,15,1,29,5,24,0.6818181818181818,0.22727272727272727,0.9375,0.6818181818181818,0.1724137931034483,0.22727272727272727
Obesity due to pro-opiomelanocortin deficiency,30170,4,18,17,13,4,19,7,12,0.7222222222222222,0.3888888888888889,0.7647058823529411,0.7222222222222222,0.3684210526315789,0.3888888888888889
Obesity due to prohormone convertase I deficiency,30410,0,18,17,14,3,50,4,46,0.7777777777777778,0.2222222222222222,0.8235294117647058,0.7777777777777778,0.08,0.2222222222222222
Autoimmune hypoparathyroidism,33262,2,28,18,18,0,21,4,17,0.6428571428571429,0.14285714285714285,1.0,0.6428571428571429,0.19047619047619047,0.14285714285714285
Auricular abnormalities-cleft lip with or without cleft palate-ocular abnormalities syndrome,33184,0,22,16,13,3,30,2,28,0.5909090909090909,0.09090909090909091,0.8125,0.5909090909090909,0.06666666666666667,0.09090909090909091
Autosomal recessive primary microcephaly,27182,5,17,25,8,17,26,2,24,0.47058823529411764,0.11764705882352941,0.32,0.47058823529411764,0.07692307692307693,0.11764705882352941
Autoimmune polyendocrinopathy type 3,27834,2,33,70,28,42,22,1,21,0.8484848484848485,0.030303030303030304,0.4,0.8484848484848485,0.045454545454545456,0.030303030303030304
Autoimmune polyendocrinopathy type 4,38555,18,32,27,1,26,22,2,20,0.03125,0.0625,0.037037037037037035,0.03125,0.09090909090909091,0.0625
Primary hepatic neuroendocrine carcinoma,27774,3,38,22,22,0,26,5,21,0.5789473684210527,0.13157894736842105,1.0,0.5789473684210527,0.19230769230769232,0.13157894736842105
Gallbladder neuroendocrine tumor,33106,3,18,17,17,0,26,3,23,0.9444444444444444,0.16666666666666666,1.0,0.9444444444444444,0.11538461538461539,0.16666666666666666
Bronchial neuroendocrine tumor,32264,4,31,17,17,0,27,9,18,0.5483870967741935,0.2903225806451613,1.0,0.5483870967741935,0.3333333333333333,0.2903225806451613
Neuroendocrine tumor of stomach,33118,3,32,22,22,0,23,5,18,0.6875,0.15625,1.0,0.6875,0.21739130434782608,0.15625
Adrenocortical carcinoma,38037,13,29,24,7,17,24,7,17,0.2413793103448276,0.2413793103448276,0.2916666666666667,0.2413793103448276,0.2916666666666667,0.2413793103448276
Pure autonomic failure,33468,7,10,20,9,11,26,6,20,0.9,0.6,0.45,0.9,0.23076923076923078,0.6
Laryngeal neuroendocrine tumor,33111,3,14,16,14,2,34,3,31,1.0,0.21428571428571427,0.875,1.0,0.08823529411764706,0.21428571428571427
Cutaneous neuroendocrine carcinoma,27810,3,17,17,13,4,19,3,16,0.7647058823529411,0.17647058823529413,0.7647058823529411,0.7647058823529411,0.15789473684210525,0.17647058823529413
Neuroendocrine tumor of the colon,33114,2,22,16,17,-1,19,3,16,0.7727272727272727,0.13636363636363635,1.0625,0.7727272727272727,0.15789473684210525,0.13636363636363635
Neuroendocrine neoplasm of appendix,39113,14,30,29,2,27,21,1,20,0.06666666666666667,0.03333333333333333,0.06896551724137931,0.06666666666666667,0.047619047619047616,0.03333333333333333
Neuroendocrine tumor of anal canal,33110,2,25,19,20,-1,22,5,17,0.8,0.2,1.0526315789473684,0.8,0.22727272727272727,0.2
Neuroendocrine tumor of the rectum,33116,2,25,20,21,-1,24,4,20,0.84,0.16,1.05,0.84,0.16666666666666666,0.16
Ulbright-Hodes syndrome,28730,1,44,45,38,7,38,0,38,0.8636363636363636,0.0,0.8444444444444444,0.8636363636363636,0.0,0.0
Spastic paraplegia-nephritis-deafness syndrome,30994,2,12,18,10,8,34,2,32,0.8333333333333334,0.16666666666666666,0.5555555555555556,0.8333333333333334,0.058823529411764705,0.16666666666666666
Tubular aggregate myopathy,32730,10,9,18,10,8,18,2,16,1.1111111111111112,0.2222222222222222,0.5555555555555556,1.1111111111111112,0.1111111111111111,0.2222222222222222
Carcinoid syndrome,33104,1,27,16,17,-1,29,4,25,0.6296296296296297,0.14814814814814814,1.0625,0.6296296296296297,0.13793103448275862,0.14814814814814814
Otodental syndrome,31500,0,26,71,0,71,19,2,17,0.0,0.07692307692307693,0.0,0.0,0.10526315789473684,0.07692307692307693
Pili torti-onychodysplasia syndrome,32594,5,20,17,13,4,27,3,24,0.65,0.15,0.7647058823529411,0.65,0.1111111111111111,0.15
Pelvis-shoulder dysplasia,31759,0,41,28,23,5,25,0,25,0.5609756097560976,0.0,0.8214285714285714,0.5609756097560976,0.0,0.0
DPM3-CDG,28471,2,15,16,9,7,27,2,25,0.6,0.13333333333333333,0.5625,0.6,0.07407407407407407,0.13333333333333333
COG4-CDG,29748,0,33,42,28,14,11,0,11,0.8484848484848485,0.0,0.6666666666666666,0.8484848484848485,0.0,0.0
COASY protein-associated neurodegeneration,29074,11,13,137,17,120,21,2,19,1.3076923076923077,0.15384615384615385,0.12408759124087591,1.3076923076923077,0.09523809523809523,0.15384615384615385
Severe combined immunodeficiency due to adenosine deaminase deficiency,32100,5,20,28,13,15,31,3,28,0.65,0.15,0.4642857142857143,0.65,0.0967741935483871,0.15
Ichthyosis-hepatosplenomegaly-cerebellar degeneration syndrome,29578,6,8,21,8,13,31,3,28,1.0,0.375,0.38095238095238093,1.0,0.0967741935483871,0.375
Glycogen storage disease with severe cardiomyopathy due to glycogenin deficiency,30954,11,25,22,3,19,29,3,26,0.12,0.12,0.13636363636363635,0.12,0.10344827586206896,0.12
Yunis-Varon syndrome,32112,0,90,98,79,19,40,0,40,0.8777777777777778,0.0,0.8061224489795918,0.8777777777777778,0.0,0.0
Cerebellar ataxia-areflexia-pes cavus-optic atrophy-sensorineural hearing loss syndrome,27541,5,13,19,11,8,7,5,2,0.8461538461538461,0.38461538461538464,0.5789473684210527,0.8461538461538461,0.7142857142857143,0.38461538461538464
Glioblastoma,37487,20,15,28,7,21,24,7,17,0.4666666666666667,0.4666666666666667,0.25,0.4666666666666667,0.2916666666666667,0.4666666666666667
Idiopathic pulmonary fibrosis,30661,4,20,16,11,5,18,4,14,0.55,0.2,0.6875,0.55,0.2222222222222222,0.2
Cenani-Lenz syndrome,32005,0,41,19,16,3,4,0,4,0.3902439024390244,0.0,0.8421052631578947,0.3902439024390244,0.0,0.0
Isolated distal symphalangism,30247,0,4,14,1,13,24,0,24,0.25,0.0,0.07142857142857142,0.25,0.0,0.0
Isotretinoin-like syndrome,27758,0,30,19,18,1,31,0,31,0.6,0.0,0.9473684210526315,0.6,0.0,0.0
Pfeiffer-Palm-Teller syndrome,28193,3,9,20,5,15,31,0,31,0.5555555555555556,0.0,0.25,0.5555555555555556,0.0,0.0
Non-progressive predominantly posterior cavitating leukoencephalopathy with peripheral neuropathy,97948,5,38,20,2,18,20,2,18,0.05263157894736842,0.05263157894736842,0.1,0.05263157894736842,0.1,0.05263157894736842
"Cardiocranial syndrome, Pfeiffer type",31346,0,34,34,30,4,13,0,13,0.8823529411764706,0.0,0.8823529411764706,0.8823529411764706,0.0,0.0
Renpenning syndrome,32065,0,42,20,10,10,16,0,16,0.23809523809523808,0.0,0.5,0.23809523809523808,0.0,0.0
Deafness-vitiligo-achalasia syndrome,28430,11,6,24,4,20,34,1,33,0.6666666666666666,0.16666666666666666,0.16666666666666666,0.6666666666666666,0.029411764705882353,0.16666666666666666
Cardiospondylocarpofacial syndrome,32109,0,11,30,8,22,26,0,26,0.7272727272727273,0.0,0.26666666666666666,0.7272727272727273,0.0,0.0
Multiple synostoses syndrome,28804,4,10,58,11,47,44,2,42,1.1,0.2,0.1896551724137931,1.1,0.045454545454545456,0.2
Deafness-genital anomalies-metacarpal and metatarsal synostosis syndrome,32333,1,28,24,20,4,36,2,34,0.7142857142857143,0.07142857142857142,0.8333333333333334,0.7142857142857143,0.05555555555555555,0.07142857142857142
Deafness-enamel hypoplasia-nail defects syndrome,32330,3,33,18,17,1,39,5,34,0.5151515151515151,0.15151515151515152,0.9444444444444444,0.5151515151515151,0.1282051282051282,0.15151515151515152
Deafness-small bowel diverticulosis-neuropathy syndrome,29269,0,16,18,11,7,21,0,21,0.6875,0.0,0.6111111111111112,0.6875,0.0,0.0
Spastic paraplegia-glaucoma-intellectual disability syndrome,38974,10,4,28,2,26,33,0,33,0.5,0.0,0.07142857142857142,0.5,0.0,0.0
Spastic paraplegia-facial-cutaneous lesions syndrome,32437,3,9,21,5,16,22,1,21,0.5555555555555556,0.1111111111111111,0.23809523809523808,0.5555555555555556,0.045454545454545456,0.1111111111111111
Peripheral motor neuropathy-dysautonomia syndrome,32032,4,7,16,6,10,33,0,33,0.8571428571428571,0.0,0.375,0.8571428571428571,0.0,0.0
X-linked immunoneurologic disorder,30901,0,12,16,7,9,24,0,24,0.5833333333333334,0.0,0.4375,0.5833333333333334,0.0,0.0
Undifferentiated pleomorphic sarcoma,96287,13,9,36,4,32,21,4,17,0.4444444444444444,0.4444444444444444,0.1111111111111111,0.4444444444444444,0.19047619047619047,0.4444444444444444
Long chain 3-hydroxyacyl-CoA dehydrogenase deficiency,27860,3,25,18,16,2,26,6,20,0.64,0.24,0.8888888888888888,0.64,0.23076923076923078,0.24
Nephrosis-deafness-urinary tract-digital malformations syndrome,29757,4,9,18,7,11,36,1,35,0.7777777777777778,0.1111111111111111,0.3888888888888889,0.7777777777777778,0.027777777777777776,0.1111111111111111
Trigonocephaly-short stature-developmental delay syndrome,28461,1,23,22,16,6,36,2,34,0.6956521739130435,0.08695652173913043,0.7272727272727273,0.6956521739130435,0.05555555555555555,0.08695652173913043
Nasopalpebral lipoma-coloboma syndrome,27754,3,30,32,25,7,27,3,24,0.8333333333333334,0.1,0.78125,0.8333333333333334,0.1111111111111111,0.1
Thyrocerebrorenal syndrome,27696,3,11,20,9,11,31,1,30,0.8181818181818182,0.09090909090909091,0.45,0.8181818181818182,0.03225806451612903,0.09090909090909091
Idiopathic/heritable pulmonary arterial hypertension,39076,15,13,19,4,15,18,5,13,0.3076923076923077,0.38461538461538464,0.21052631578947367,0.3076923076923077,0.2777777777777778,0.38461538461538464
Autoimmune pulmonary alveolar proteinosis,31774,7,20,17,13,4,16,9,7,0.65,0.45,0.7647058823529411,0.65,0.5625,0.45
Ichthyosis-intellectual disability-dwarfism-renal impairment syndrome,31725,2,9,20,2,18,39,2,37,0.2222222222222222,0.2222222222222222,0.1,0.2222222222222222,0.05128205128205128,0.2222222222222222
PHAVER syndrome,32597,0,26,25,23,2,25,0,25,0.8846153846153846,0.0,0.92,0.8846153846153846,0.0,0.0
Autosomal recessive Kenny-Caffey syndrome,27547,0,22,17,9,8,34,0,34,0.4090909090909091,0.0,0.5294117647058824,0.4090909090909091,0.0,0.0
Autosomal dominant Kenny-Caffey syndrome,27547,1,30,17,11,6,36,1,35,0.36666666666666664,0.03333333333333333,0.6470588235294118,0.36666666666666664,0.027777777777777776,0.03333333333333333
Postpoliomyelitis syndrome,33269,3,17,16,16,0,28,4,24,0.9411764705882353,0.23529411764705882,1.0,0.9411764705882353,0.14285714285714285,0.23529411764705882
Familial cerebral saccular aneurysm,33557,1,15,20,12,8,28,1,27,0.8,0.06666666666666667,0.6,0.8,0.03571428571428571,0.06666666666666667
Neuromyelitis optica spectrum disorder,33400,1,15,16,12,4,28,4,24,0.8,0.26666666666666666,0.75,0.8,0.14285714285714285,0.26666666666666666
Posterior cortical atrophy,32407,5,21,17,17,0,25,6,19,0.8095238095238095,0.2857142857142857,1.0,0.8095238095238095,0.24,0.2857142857142857
Acyl-CoA dehydrogenase 9 deficiency,28731,6,29,18,14,4,28,3,25,0.4827586206896552,0.10344827586206896,0.7777777777777778,0.4827586206896552,0.10714285714285714,0.10344827586206896
Rigid spine syndrome,32221,1,20,18,18,0,24,2,22,0.9,0.1,1.0,0.9,0.08333333333333333,0.1
Glycogen storage disease due to lactate dehydrogenase deficiency,33023,10,11,20,6,14,25,1,24,0.5454545454545454,0.09090909090909091,0.3,0.5454545454545454,0.04,0.09090909090909091
Metachondromatosis,31364,7,7,20,6,14,23,1,22,0.8571428571428571,0.14285714285714285,0.3,0.8571428571428571,0.043478260869565216,0.14285714285714285
Mesomelia-synostoses syndrome,28345,2,41,33,24,9,42,2,40,0.5853658536585366,0.04878048780487805,0.7272727272727273,0.5853658536585366,0.047619047619047616,0.04878048780487805
Mutilating hereditary sensory neuropathy with spastic paraplegia,39084,7,18,25,4,21,36,3,33,0.2222222222222222,0.16666666666666666,0.16,0.2222222222222222,0.08333333333333333,0.16666666666666666
Pericardial and diaphragmatic defect,32412,2,20,16,16,0,24,3,21,0.8,0.15,1.0,0.8,0.125,0.15
Acrootoocular syndrome,27815,1,42,17,12,5,38,0,38,0.2857142857142857,0.0,0.7058823529411765,0.2857142857142857,0.0,0.0
Autosomal recessive omodysplasia,31857,0,24,17,11,6,18,0,18,0.4583333333333333,0.0,0.6470588235294118,0.4583333333333333,0.0,0.0
Arachnodactyly-abnormal ossification-intellectual disability syndrome,33227,2,15,19,15,4,42,2,40,1.0,0.13333333333333333,0.7894736842105263,1.0,0.047619047619047616,0.13333333333333333
Erythrokeratoderma ''en cocardes'',38275,4,5,25,4,21,24,2,22,0.8,0.4,0.16,0.8,0.08333333333333333,0.4
Systemic capillary leak syndrome,32762,0,23,17,18,-1,21,2,19,0.782608695652174,0.08695652173913043,1.0588235294117647,0.782608695652174,0.09523809523809523,0.08695652173913043
Autosomal dominant hypohidrotic ectodermal dysplasia,32453,3,15,28,5,23,35,1,34,0.3333333333333333,0.06666666666666667,0.17857142857142858,0.3333333333333333,0.02857142857142857,0.06666666666666667
Toxic epidermal necrolysis,32299,3,39,31,6,25,23,6,17,0.15384615384615385,0.15384615384615385,0.1935483870967742,0.15384615384615385,0.2608695652173913,0.15384615384615385
CHIME syndrome,31712,2,48,41,21,20,24,4,20,0.4375,0.08333333333333333,0.5121951219512195,0.4375,0.16666666666666666,0.08333333333333333
GCGR-related hyperglucagonemia,27646,9,10,20,7,13,19,1,18,0.7,0.1,0.35,0.7,0.05263157894736842,0.1
Inverted duplicated chromosome 15 syndrome,27697,0,41,17,16,1,21,3,18,0.3902439024390244,0.07317073170731707,0.9411764705882353,0.3902439024390244,0.14285714285714285,0.07317073170731707
Sporadic pheochromocytoma/secreting paraganglioma,33207,8,36,20,16,4,18,4,14,0.4444444444444444,0.1111111111111111,0.8,0.4444444444444444,0.2222222222222222,0.1111111111111111
Non-functioning paraganglioma,28429,1,31,16,8,8,17,5,12,0.25806451612903225,0.16129032258064516,0.5,0.25806451612903225,0.29411764705882354,0.16129032258064516
Hereditary pheochromocytoma-paraganglioma,33431,4,41,23,22,1,18,4,14,0.5365853658536586,0.0975609756097561,0.9565217391304348,0.5365853658536586,0.2222222222222222,0.0975609756097561
Kleefstra syndrome,32549,4,67,19,8,11,28,5,23,0.11940298507462686,0.07462686567164178,0.42105263157894735,0.11940298507462686,0.17857142857142858,0.07462686567164178
Tietz syndrome,29062,0,6,20,6,14,1,0,1,1.0,0.0,0.3,1.0,0.0,0.0
Tyrosinemia type 2,37602,19,17,26,0,26,28,0,28,0.0,0.0,0.0,0.0,0.0,0.0
Malignant atrophic papulosis,31893,0,34,17,14,3,23,1,22,0.4117647058823529,0.029411764705882353,0.8235294117647058,0.4117647058823529,0.043478260869565216,0.029411764705882353
Congenital ichthyosis-microcephalus-tetraplegia syndrome,33497,9,8,23,6,17,28,5,23,0.75,0.625,0.2608695652173913,0.75,0.17857142857142858,0.625
Male hypergonadotropic hypogonadism-intellectual disability-skeletal anomalies syndrome,28452,3,19,17,11,6,26,5,21,0.5789473684210527,0.2631578947368421,0.6470588235294118,0.5789473684210527,0.19230769230769232,0.2631578947368421
Hydrocephaly-tall stature-joint laxity syndrome,28637,4,15,16,16,0,30,4,26,1.0666666666666667,0.26666666666666666,1.0,1.0666666666666667,0.13333333333333333,0.26666666666666666
Hydrocephalus-costovertebral dysplasia-Sprengel anomaly syndrome,29540,2,29,25,21,4,23,2,21,0.7241379310344828,0.06896551724137931,0.84,0.7241379310344828,0.08695652173913043,0.06896551724137931
Johnson neuroectodermal syndrome,31953,0,27,18,13,5,27,0,27,0.48148148148148145,0.0,0.7222222222222222,0.48148148148148145,0.0,0.0
IVIC syndrome,28220,0,18,17,11,6,37,0,37,0.6111111111111112,0.0,0.6470588235294118,0.6111111111111112,0.0,0.0
Microvillus inclusion disease,28835,4,11,16,11,5,27,4,23,1.0,0.36363636363636365,0.6875,1.0,0.14814814814814814,0.36363636363636365
Superficial epidermolytic ichthyosis,38946,7,7,19,0,19,17,0,17,0.0,0.0,0.0,0.0,0.0,0.0
Umbilical cord ulceration-intestinal atresia syndrome,33382,4,9,10,3,7,24,1,23,0.3333333333333333,0.1111111111111111,0.3,0.3333333333333333,0.041666666666666664,0.1111111111111111
NPHP3-related Meckel-like syndrome,29600,0,10,18,7,11,23,0,23,0.7,0.0,0.3888888888888889,0.7,0.0,0.0
Nail-patella-like renal disease,27551,10,6,23,6,17,17,4,13,1.0,0.6666666666666666,0.2608695652173913,1.0,0.23529411764705882,0.6666666666666666
Hirschsprung disease-deafness-polydactyly syndrome,29484,11,7,24,5,19,20,1,19,0.7142857142857143,0.14285714285714285,0.20833333333333334,0.7142857142857143,0.05,0.14285714285714285
Hirschsprung disease-type D brachydactyly syndrome,29999,2,6,18,6,12,16,0,16,1.0,0.0,0.3333333333333333,1.0,0.0,0.0
Hennekam syndrome,31425,2,51,23,5,18,26,3,23,0.09803921568627451,0.058823529411764705,0.21739130434782608,0.09803921568627451,0.11538461538461539,0.058823529411764705
X-linked intellectual disability-epilepsy-progressive joint contractures-dysmorphism syndrome,32558,8,8,21,8,13,29,3,26,1.0,0.375,0.38095238095238093,1.0,0.10344827586206896,0.375
Isolated arrhinia,33224,1,12,20,12,8,12,1,11,1.0,0.08333333333333333,0.6,1.0,0.08333333333333333,0.08333333333333333
Shprintzen-Goldberg syndrome,28538,3,53,22,16,6,70,6,64,0.3018867924528302,0.11320754716981132,0.7272727272727273,0.3018867924528302,0.08571428571428572,0.11320754716981132
MOMO syndrome,27713,0,44,18,15,3,31,0,31,0.3409090909090909,0.0,0.8333333333333334,0.3409090909090909,0.0,0.0
Lethal Kniest-like dysplasia,28026,0,27,61,7,54,21,1,20,0.25925925925925924,0.037037037037037035,0.11475409836065574,0.25925925925925924,0.047619047619047616,0.037037037037037035
Melnick-Needles syndrome,31600,0,35,26,16,10,30,0,30,0.45714285714285713,0.0,0.6153846153846154,0.45714285714285713,0.0,0.0
Melorheostosis,29790,3,17,19,17,2,25,4,21,1.0,0.23529411764705882,0.8947368421052632,1.0,0.16,0.23529411764705882
Marshall-Smith syndrome,29367,0,29,19,8,11,15,1,14,0.27586206896551724,0.034482758620689655,0.42105263157894735,0.27586206896551724,0.06666666666666667,0.034482758620689655
Matthew-Wood syndrome,30311,0,20,18,10,8,16,1,15,0.5,0.05,0.5555555555555556,0.5,0.0625,0.05
Bifid uvula,31121,3,4,19,2,17,31,0,31,0.5,0.0,0.10526315789473684,0.5,0.0,0.0
Juberg-Hayward syndrome,28696,2,26,28,17,11,27,2,25,0.6538461538461539,0.07692307692307693,0.6071428571428571,0.6538461538461539,0.07407407407407407,0.07692307692307693
Kapur-Toriello syndrome,31290,1,22,19,9,10,31,1,30,0.4090909090909091,0.045454545454545456,0.47368421052631576,0.4090909090909091,0.03225806451612903,0.045454545454545456
Mitochondrial neurogastrointestinal encephalomyopathy,32417,0,48,24,24,0,27,6,21,0.5,0.125,1.0,0.5,0.2222222222222222,0.125
Chronic graft versus host disease,32520,1,53,21,16,5,19,6,13,0.3018867924528302,0.11320754716981132,0.7619047619047619,0.3018867924528302,0.3157894736842105,0.11320754716981132
Pleural mesothelioma,30725,3,17,20,18,2,28,8,20,1.0588235294117647,0.47058823529411764,0.9,1.0588235294117647,0.2857142857142857,0.47058823529411764
Müllerian derivatives-lymphangiectasia-polydactyly syndrome,29432,1,41,41,33,8,19,0,19,0.8048780487804879,0.0,0.8048780487804879,0.8048780487804879,0.0,0.0
Arnold-Chiari malformation type I,31379,5,44,62,44,18,27,7,20,1.0,0.1590909090909091,0.7096774193548387,1.0,0.25925925925925924,0.1590909090909091
Restrictive dermopathy,29066,1,58,26,20,6,13,1,12,0.3448275862068966,0.017241379310344827,0.7692307692307693,0.3448275862068966,0.07692307692307693,0.017241379310344827
Wrinkly skin syndrome,27675,0,61,21,13,8,20,0,20,0.21311475409836064,0.0,0.6190476190476191,0.21311475409836064,0.0,0.0
Distal deletion 15q syndrome,33436,2,60,17,4,13,21,1,20,0.06666666666666667,0.016666666666666666,0.23529411764705882,0.06666666666666667,0.047619047619047616,0.016666666666666666
Turner syndrome due to structural X chromosome anomalies,32829,5,113,25,25,0,28,8,20,0.22123893805309736,0.07079646017699115,1.0,0.22123893805309736,0.2857142857142857,0.07079646017699115
Mosaic monosomy X syndrome,32637,2,113,24,25,-1,40,12,28,0.22123893805309736,0.10619469026548672,1.0416666666666667,0.22123893805309736,0.3,0.10619469026548672
X-linked spasticity-intellectual disability-epilepsy syndrome,28704,14,7,23,4,19,21,4,17,0.5714285714285714,0.5714285714285714,0.17391304347826086,0.5714285714285714,0.19047619047619047,0.5714285714285714
Denys-Drash syndrome,31013,6,7,18,7,11,24,2,22,1.0,0.2857142857142857,0.3888888888888889,1.0,0.08333333333333333,0.2857142857142857
Danon disease,36778,14,6,30,1,29,23,0,23,0.16666666666666666,0.0,0.03333333333333333,0.16666666666666666,0.0,0.0
De Barsy syndrome,27798,0,66,54,53,1,38,0,38,0.803030303030303,0.0,0.9814814814814815,0.803030303030303,0.0,0.0
Hemangioblastoma,32188,3,16,15,16,-1,31,4,27,1.0,0.25,1.0666666666666667,1.0,0.12903225806451613,0.25
Thymic neuroendocrine tumor,95096,20,24,28,3,25,23,3,20,0.125,0.125,0.10714285714285714,0.125,0.13043478260869565,0.125
Wiedemann-Rautenstrauch syndrome,30429,2,128,141,117,24,23,1,22,0.9140625,0.0078125,0.8297872340425532,0.9140625,0.043478260869565216,0.0078125
"Heart-hand syndrome, Slovenian type",31419,1,7,13,5,8,28,1,27,0.7142857142857143,0.14285714285714285,0.38461538461538464,0.7142857142857143,0.03571428571428571,0.14285714285714285
Congenital enterocyte heparan sulfate deficiency,33360,4,10,16,7,9,28,2,26,0.7,0.2,0.4375,0.7,0.07142857142857142,0.2
Patent ductus arteriosus-bicuspid aortic valve-hand anomalies syndrome,27701,4,8,18,8,10,37,2,35,1.0,0.25,0.4444444444444444,1.0,0.05405405405405406,0.25
Hyperinsulinism due to short chain 3-hydroxylacyl-CoA dehydrogenase deficiency,33397,2,36,19,14,5,28,1,27,0.3888888888888889,0.027777777777777776,0.7368421052631579,0.3888888888888889,0.03571428571428571,0.027777777777777776
Gray platelet syndrome,31205,2,8,17,9,8,31,4,27,1.125,0.5,0.5294117647058824,1.125,0.12903225806451613,0.5
Atrial septal defect-atrioventricular conduction defects syndrome,28295,1,3,18,5,13,23,1,22,1.6666666666666667,0.3333333333333333,0.2777777777777778,1.6666666666666667,0.043478260869565216,0.3333333333333333
Meacham syndrome,31400,0,25,18,0,18,18,0,18,0.0,0.0,0.0,0.0,0.0,0.0
Microcephaly-albinism-digital anomalies syndrome,29753,9,8,26,6,20,28,2,26,0.75,0.25,0.23076923076923078,0.75,0.07142857142857142,0.25
Microbrachycephaly-ptosis-cleft lip syndrome,29673,4,36,20,14,6,28,6,22,0.3888888888888889,0.16666666666666666,0.7,0.3888888888888889,0.21428571428571427,0.16666666666666666
Microcephaly-cardiomyopathy syndrome,31468,5,15,18,12,6,24,3,21,0.8,0.2,0.6666666666666666,0.8,0.125,0.2
Blindness-scoliosis-arachnodactyly syndrome,32292,4,11,19,7,12,30,3,27,0.6363636363636364,0.2727272727272727,0.3684210526315789,0.6363636363636364,0.1,0.2727272727272727
Glycogen storage disease due to hepatic glycogen synthase deficiency,28161,1,14,17,12,5,23,0,23,0.8571428571428571,0.0,0.7058823529411765,0.8571428571428571,0.0,0.0
Leri pleonosteosis,27912,0,23,19,9,10,21,0,21,0.391304347826087,0.0,0.47368421052631576,0.391304347826087,0.0,0.0
Polydactyly-myopia syndrome,29088,2,5,18,1,17,33,1,32,0.2,0.2,0.05555555555555555,0.2,0.030303030303030304,0.2
Orofaciodigital syndrome type 4,27672,0,69,27,16,11,17,1,16,0.2318840579710145,0.014492753623188406,0.5925925925925926,0.2318840579710145,0.058823529411764705,0.014492753623188406
Pitt-Hopkins syndrome,38983,9,69,27,5,22,23,4,19,0.07246376811594203,0.057971014492753624,0.18518518518518517,0.07246376811594203,0.17391304347826086,0.057971014492753624
Marden-Walker syndrome,30945,0,61,33,30,3,26,2,24,0.4918032786885246,0.03278688524590164,0.9090909090909091,0.4918032786885246,0.07692307692307693,0.03278688524590164
Osteosclerotic bone dysplasia,38177,15,20,27,0,27,16,0,16,0.0,0.0,0.0,0.0,0.0,0.0
Marinesco-Sjögren syndrome,99505,12,45,37,2,35,17,1,16,0.044444444444444446,0.022222222222222223,0.05405405405405406,0.044444444444444446,0.058823529411764705,0.022222222222222223
Palmoplantar keratoderma-spastic paralysis syndrome,33538,2,12,16,11,5,29,2,27,0.9166666666666666,0.16666666666666666,0.6875,0.9166666666666666,0.06896551724137931,0.16666666666666666
Palmoplantar keratoderma-deafness syndrome,29543,12,3,26,2,24,39,0,39,0.6666666666666666,0.0,0.07692307692307693,0.6666666666666666,0.0,0.0
Autosomal dominant epidermolytic ichthyosis,38946,16,11,24,3,21,24,4,20,0.2727272727272727,0.36363636363636365,0.125,0.2727272727272727,0.16666666666666666,0.36363636363636365
Palmoplantar keratoderma-esophageal carcinoma syndrome,30179,5,15,20,16,4,27,7,20,1.0666666666666667,0.4666666666666667,0.8,1.0666666666666667,0.25925925925925924,0.4666666666666667
Epidermolysis bullosa simplex with muscular dystrophy,27434,2,19,25,7,18,25,1,24,0.3684210526315789,0.05263157894736842,0.28,0.3684210526315789,0.04,0.05263157894736842
Hydrolethalus,29931,0,28,24,12,12,35,2,33,0.42857142857142855,0.07142857142857142,0.5,0.42857142857142855,0.05714285714285714,0.07142857142857142
Arthrochalasia Ehlers-Danlos syndrome,28563,1,26,19,10,9,21,1,20,0.38461538461538464,0.038461538461538464,0.5263157894736842,0.38461538461538464,0.047619047619047616,0.038461538461538464
Dermatosparaxis Ehlers-Danlos syndrome,27624,5,35,26,14,12,33,3,30,0.4,0.08571428571428572,0.5384615384615384,0.4,0.09090909090909091,0.08571428571428572
Thumb deformity-alopecia-pigmentation anomaly syndrome,29692,3,24,22,18,4,24,2,22,0.75,0.08333333333333333,0.8181818181818182,0.75,0.08333333333333333,0.08333333333333333
Hyposmia-nasal and ocular hypoplasia-hypogonadotropic hypogonadism syndrome,33507,0,32,17,16,1,23,5,18,0.5,0.15625,0.9411764705882353,0.5,0.21739130434782608,0.15625
Ulna hypoplasia-intellectual disability syndrome,30575,2,20,26,23,3,37,2,35,1.15,0.1,0.8846153846153846,1.15,0.05405405405405406,0.1
Hypertrichosis cubiti,29153,0,27,25,20,5,6,0,6,0.7407407407407407,0.0,0.8,0.7407407407407407,0.0,0.0
Cervical hypertrichosis-peripheral neuropathy syndrome,30000,9,6,18,3,15,38,0,38,0.5,0.0,0.16666666666666666,0.5,0.0,0.0
Hypertelorism-microtia-facial clefting syndrome,29319,2,15,28,11,17,40,4,36,0.7333333333333333,0.26666666666666666,0.39285714285714285,0.7333333333333333,0.1,0.26666666666666666
Hypertelorism-hypospadias-polysyndactyly syndrome,31233,2,35,34,28,6,32,3,29,0.8,0.08571428571428572,0.8235294117647058,0.8,0.09375,0.08571428571428572
Ankylosing vertebral hyperostosis with tylosis,33335,1,5,20,2,18,23,2,21,0.4,0.4,0.1,0.4,0.08695652173913043,0.4
Congenital patella dislocation,33356,8,8,14,8,6,22,4,18,1.0,0.5,0.5714285714285714,1.0,0.18181818181818182,0.5
Adenosine monophosphate deaminase deficiency,27667,0,7,18,7,11,13,0,13,1.0,0.0,0.3888888888888889,1.0,0.0,0.0
Acitretin/etretinate embryopathy,32239,0,27,22,22,0,39,0,39,0.8148148148148148,0.0,1.0,0.8148148148148148,0.0,0.0
Carnitine-acylcarnitine translocase deficiency,31976,5,30,18,13,5,30,6,24,0.43333333333333335,0.2,0.7222222222222222,0.43333333333333335,0.2,0.2
Pudendal nerve entrapment syndrome,27690,5,18,25,5,20,23,3,20,0.2777777777777778,0.16666666666666666,0.2,0.2777777777777778,0.13043478260869565,0.16666666666666666
Double uterus-hemivagina-renal agenesis syndrome,28216,0,12,12,11,1,24,2,22,0.9166666666666666,0.16666666666666666,0.9166666666666666,0.9166666666666666,0.08333333333333333,0.16666666666666666
W syndrome,38849,9,25,42,0,42,32,0,32,0.0,0.0,0.0,0.0,0.0,0.0
DDOST-CDG,30268,0,23,18,14,4,22,1,21,0.6086956521739131,0.043478260869565216,0.7777777777777778,0.6086956521739131,0.045454545454545456,0.043478260869565216
XK aprosencephaly syndrome,30599,3,12,21,9,12,41,2,39,0.75,0.16666666666666666,0.42857142857142855,0.75,0.04878048780487805,0.16666666666666666
Lateral meningocele syndrome,30158,0,41,19,13,6,3,0,3,0.3170731707317073,0.0,0.6842105263157895,0.3170731707317073,0.0,0.0
X-linked sideroblastic anemia and spinocerebellar ataxia,30154,4,33,18,11,7,22,4,18,0.3333333333333333,0.12121212121212122,0.6111111111111112,0.3333333333333333,0.18181818181818182,0.12121212121212122
Björnstad syndrome,31383,2,5,17,4,13,29,0,29,0.8,0.0,0.23529411764705882,0.8,0.0,0.0
Acquired hypertrichosis lanuginosa,33530,2,18,17,14,3,12,1,11,0.7777777777777778,0.05555555555555555,0.8235294117647058,0.7777777777777778,0.08333333333333333,0.05555555555555555
Kallmann syndrome-heart disease syndrome,33051,3,29,20,21,-1,25,5,20,0.7241379310344828,0.1724137931034483,1.05,0.7241379310344828,0.2,0.1724137931034483
Familial pancreatic carcinoma,29050,5,24,16,14,2,21,6,15,0.5833333333333334,0.25,0.875,0.5833333333333334,0.2857142857142857,0.25
Congenital aortic valve stenosis,32802,6,17,19,12,7,21,2,19,0.7058823529411765,0.11764705882352941,0.631578947368421,0.7058823529411765,0.09523809523809523,0.11764705882352941
Ring chromosome 22 syndrome,32376,0,33,31,32,-1,30,1,29,0.9696969696969697,0.030303030303030304,1.032258064516129,0.9696969696969697,0.03333333333333333,0.030303030303030304
Early-onset autosomal dominant Alzheimer disease,28780,5,26,23,11,12,28,3,25,0.4230769230769231,0.11538461538461539,0.4782608695652174,0.4230769230769231,0.10714285714285714,0.11538461538461539
DNAJB6-related limb-girdle muscular dystrophy D1,30310,2,12,19,10,9,22,0,22,0.8333333333333334,0.0,0.5263157894736842,0.8333333333333334,0.0,0.0
Myoclonus-dystonia syndrome,33386,10,11,28,10,18,32,2,30,0.9090909090909091,0.18181818181818182,0.35714285714285715,0.9090909090909091,0.0625,0.18181818181818182
Lambert-Eaton myasthenic syndrome,33451,6,16,26,11,15,20,0,20,0.6875,0.0,0.4230769230769231,0.6875,0.0,0.0
Inclusion body myopathy with Paget disease of bone and frontotemporal dementia,28751,0,43,24,15,9,21,4,17,0.3488372093023256,0.09302325581395349,0.625,0.3488372093023256,0.19047619047619047,0.09302325581395349
Partial deletion of the short arm of chromosome 8 syndrome,39324,20,0,59,0,59,30,0,30,0.0,0.0,0.0,0.0,0.0,0.0
Trisomy 8p syndrome,32953,1,65,17,17,0,37,4,33,0.26153846153846155,0.06153846153846154,1.0,0.26153846153846155,0.10810810810810811,0.06153846153846154
Dopa-responsive dystonia due to sepiapterin reductase deficiency,27441,4,26,20,13,7,31,6,25,0.5,0.23076923076923078,0.65,0.5,0.1935483870967742,0.23076923076923078
Distal duplication 5q syndrome,38415,10,30,31,2,29,26,3,23,0.06666666666666667,0.1,0.06451612903225806,0.06666666666666667,0.11538461538461539,0.1
Spinal muscular atrophy-Dandy-Walker malformation-cataracts syndrome,32247,10,7,25,8,17,30,1,29,1.1428571428571428,0.14285714285714285,0.32,1.1428571428571428,0.03333333333333333,0.14285714285714285
Combined immunodeficiency-enteropathy spectrum,38553,13,30,30,2,28,24,1,23,0.06666666666666667,0.03333333333333333,0.06666666666666667,0.06666666666666667,0.041666666666666664,0.03333333333333333
X-linked intellectual disability-plagiocephaly syndrome,28823,2,14,14,12,2,38,3,35,0.8571428571428571,0.21428571428571427,0.8571428571428571,0.8571428571428571,0.07894736842105263,0.21428571428571427
SCARF syndrome,28136,0,32,36,25,11,29,0,29,0.78125,0.0,0.6944444444444444,0.78125,0.0,0.0
Ulnar-mammary syndrome,30503,0,36,19,9,10,21,0,21,0.25,0.0,0.47368421052631576,0.25,0.0,0.0
Hereditary hyperekplexia,27484,3,21,24,17,7,23,7,16,0.8095238095238095,0.3333333333333333,0.7083333333333334,0.8095238095238095,0.30434782608695654,0.3333333333333333
Stimmler syndrome,30523,0,9,17,7,10,19,0,19,0.7777777777777778,0.0,0.4117647058823529,0.7777777777777778,0.0,0.0
"Deaf blind hypopigmentation syndrome, Yemenite type",27918,0,22,13,0,13,38,8,30,0.0,0.36363636363636365,0.0,0.0,0.21052631578947367,0.36363636363636365
Tetramelic monodactyly,29581,6,2,25,1,24,22,0,22,0.5,0.0,0.04,0.5,0.0,0.0
Microcephaly-cleft palate-abnormal retinal pigmentation syndrome,32767,3,12,25,11,14,29,2,27,0.9166666666666666,0.16666666666666666,0.44,0.9166666666666666,0.06896551724137931,0.16666666666666666
Infantile epileptic spasms syndrome,39077,5,6,54,1,53,30,2,28,0.16666666666666666,0.3333333333333333,0.018518518518518517,0.16666666666666666,0.06666666666666667,0.3333333333333333
"Oculocerebrofacial syndrome, Kaufman type",30909,0,44,17,11,6,9,2,7,0.25,0.045454545454545456,0.6470588235294118,0.25,0.2222222222222222,0.045454545454545456
"Autosomal recessive cutis laxa type 2, classic type",27841,7,57,30,16,14,29,1,28,0.2807017543859649,0.017543859649122806,0.5333333333333333,0.2807017543859649,0.034482758620689655,0.017543859649122806
Neuhauser-Eichner-Opitz syndrome,98826,0,14,6,0,6,32,1,31,0.0,0.07142857142857142,0.0,0.0,0.03125,0.07142857142857142
Port-wine nevi-mega cisterna magna-hydrocephalus syndrome,98778,15,10,30,1,29,30,1,29,0.1,0.1,0.03333333333333333,0.1,0.03333333333333333,0.1
"Blepharophimosis-intellectual disability syndrome, Ohdo type",35826,0,26,26,6,20,17,3,14,0.23076923076923078,0.11538461538461539,0.23076923076923078,0.23076923076923078,0.17647058823529413,0.11538461538461539
Imperforate oropharynx-costovertebral anomalies syndrome,32391,3,27,26,27,-1,21,3,18,1.0,0.1111111111111111,1.0384615384615385,1.0,0.14285714285714285,0.1111111111111111
Postaxial tetramelic oligodactyly,29948,3,4,17,3,14,18,0,18,0.75,0.0,0.17647058823529413,0.75,0.0,0.0
Digital extensor muscle aplasia-polyneuropathy,27875,0,9,18,9,9,25,0,25,1.0,0.0,0.5,1.0,0.0,0.0
Ptosis-vocal cord paralysis syndrome,29904,8,6,28,6,22,27,0,27,1.0,0.0,0.21428571428571427,1.0,0.0,0.0
"Familial osteodysplasia, Anderson type",32383,0,31,17,16,1,16,0,16,0.5161290322580645,0.0,0.9411764705882353,0.5161290322580645,0.0,0.0
Renal caliceal diverticuli-deafness syndrome,32430,9,6,23,7,16,28,0,28,1.1666666666666667,0.0,0.30434782608695654,1.1666666666666667,0.0,0.0
Wilson-Turner syndrome,27809,1,28,18,11,7,30,0,30,0.39285714285714285,0.0,0.6111111111111112,0.39285714285714285,0.0,0.0
Absent radius-anogenital anomalies syndrome,30195,2,9,16,8,8,36,1,35,0.8888888888888888,0.1111111111111111,0.5,0.8888888888888888,0.027777777777777776,0.1111111111111111
Radio-renal syndrome,30731,1,24,25,19,6,17,1,16,0.7916666666666666,0.041666666666666664,0.76,0.7916666666666666,0.058823529411764705,0.041666666666666664
Microgastria-limb reduction defect syndrome,28114,1,48,52,36,16,32,1,31,0.75,0.020833333333333332,0.6923076923076923,0.75,0.03125,0.020833333333333332
VACTERL with hydrocephalus,28762,3,33,18,14,4,22,5,17,0.42424242424242425,0.15151515151515152,0.7777777777777778,0.42424242424242425,0.22727272727272727,0.15151515151515152
Tremor-nystagmus-duodenal ulcer syndrome,29154,8,4,27,5,22,25,1,24,1.25,0.25,0.18518518518518517,1.25,0.04,0.25
Extensor tendons of finger anomalies,29251,1,6,13,5,8,12,0,12,0.8333333333333334,0.0,0.38461538461538464,0.8333333333333334,0.0,0.0
Classic Hodgkin lymphoma,33077,4,32,17,13,4,20,7,13,0.40625,0.21875,0.7647058823529411,0.40625,0.35,0.21875
Inherited Creutzfeldt-Jakob disease,32477,5,50,28,11,17,22,6,16,0.22,0.12,0.39285714285714285,0.22,0.2727272727272727,0.12
SHORT syndrome,27483,1,37,17,12,5,34,2,32,0.32432432432432434,0.05405405405405406,0.7058823529411765,0.32432432432432434,0.058823529411764705,0.05405405405405406
Neuroectodermal melanolysosomal disease,95816,18,29,39,1,38,33,1,32,0.034482758620689655,0.034482758620689655,0.02564102564102564,0.034482758620689655,0.030303030303030304,0.034482758620689655
Anophthalmia-megalocornea-cardiopathy-skeletal anomalies syndrome,33240,3,28,19,17,2,30,4,26,0.6071428571428571,0.14285714285714285,0.8947368421052632,0.6071428571428571,0.13333333333333333,0.14285714285714285
Ogden syndrome,30624,0,41,57,34,23,34,0,34,0.8292682926829268,0.0,0.5964912280701754,0.8292682926829268,0.0,0.0
Proximal myopathy with extrapyramidal signs,27666,3,25,19,14,5,27,5,22,0.56,0.2,0.7368421052631579,0.56,0.18518518518518517,0.2
Hereditary myopathy with early respiratory failure,30168,2,24,22,11,11,22,4,18,0.4583333333333333,0.16666666666666666,0.5,0.4583333333333333,0.18181818181818182,0.16666666666666666
Congenital muscular dystrophy-respiratory failure-skin abnormalities-joint hyperlaxity syndrome,29690,2,30,31,27,4,23,3,20,0.9,0.1,0.8709677419354839,0.9,0.13043478260869565,0.1
Autosomal dominant Emery-Dreifuss muscular dystrophy,27738,4,44,39,20,19,26,2,24,0.45454545454545453,0.045454545454545456,0.5128205128205128,0.45454545454545453,0.07692307692307693,0.045454545454545456
Autosomal recessive Emery-Dreifuss muscular dystrophy,27738,4,40,19,9,10,24,3,21,0.225,0.075,0.47368421052631576,0.225,0.125,0.075
X-linked Emery-Dreifuss muscular dystrophy,27674,3,44,23,14,9,29,3,26,0.3181818181818182,0.06818181818181818,0.6086956521739131,0.3181818181818182,0.10344827586206896,0.06818181818181818
Pontocerebellar hypoplasia type 10,27716,2,27,38,10,28,14,0,14,0.37037037037037035,0.0,0.2631578947368421,0.37037037037037035,0.0,0.0
Autosomal recessive centronuclear myopathy,29888,4,36,47,31,16,23,3,20,0.8611111111111112,0.08333333333333333,0.6595744680851063,0.8611111111111112,0.13043478260869565,0.08333333333333333
Autosomal dominant Charcot-Marie-Tooth disease type 2K,29098,2,10,27,12,15,21,1,20,1.2,0.1,0.4444444444444444,1.2,0.047619047619047616,0.1
FKRP-related limb-girdle muscular dystrophy R9,30310,4,17,19,6,13,29,3,26,0.35294117647058826,0.17647058823529413,0.3157894736842105,0.35294117647058826,0.10344827586206896,0.17647058823529413
Cap myopathy,33498,0,30,17,16,1,18,0,18,0.5333333333333333,0.0,0.9411764705882353,0.5333333333333333,0.0,0.0
KAT6-related intellectual disability-craniofacial anomalies-cardiac defects syndrome,98748,18,39,27,6,21,45,5,40,0.15384615384615385,0.1282051282051282,0.2222222222222222,0.15384615384615385,0.1111111111111111,0.1282051282051282
Wiedemann-Steiner syndrome,30199,2,58,53,43,10,21,2,19,0.7413793103448276,0.034482758620689655,0.8113207547169812,0.7413793103448276,0.09523809523809523,0.034482758620689655
GMPPB-related limb-girdle muscular dystrophy R19,27315,10,25,29,12,17,29,7,22,0.48,0.28,0.41379310344827586,0.48,0.2413793103448276,0.28
Moderate multiminicore disease with hand involvement,32818,2,14,16,13,3,16,0,16,0.9285714285714286,0.0,0.8125,0.9285714285714286,0.0,0.0
Antenatal multiminicore disease with arthrogryposis multiplex congenita,32819,0,21,18,18,0,19,2,17,0.8571428571428571,0.09523809523809523,1.0,0.8571428571428571,0.10526315789473684,0.09523809523809523
CLN12 disease,29506,6,18,26,5,21,30,6,24,0.2777777777777778,0.3333333333333333,0.19230769230769232,0.2777777777777778,0.2,0.3333333333333333
Severe congenital nemaline myopathy,27294,3,30,126,26,100,12,0,12,0.8666666666666667,0.0,0.20634920634920634,0.8666666666666667,0.0,0.0
Typical nemaline myopathy,27294,5,39,124,42,82,17,0,17,1.0769230769230769,0.0,0.3387096774193548,1.0769230769230769,0.0,0.0
Classic multiminicore myopathy,28689,0,29,13,0,13,21,0,21,0.0,0.0,0.0,0.0,0.0,0.0
Caribbean parkinsonism,27682,5,27,20,21,-1,33,5,28,0.7777777777777778,0.18518518518518517,1.05,0.7777777777777778,0.15151515151515152,0.18518518518518517
Cranio-cervical dystonia with laryngeal and upper-limb involvement,38345,8,9,30,3,27,29,2,27,0.3333333333333333,0.2222222222222222,0.1,0.3333333333333333,0.06896551724137931,0.2222222222222222
Cirrhosis-dystonia-polycythemia-hypermanganesemia syndrome,30577,1,40,28,24,4,37,4,33,0.6,0.1,0.8571428571428571,0.6,0.10810810810810811,0.1
Oromandibular dystonia,32613,4,21,17,17,0,31,6,25,0.8095238095238095,0.2857142857142857,1.0,0.8095238095238095,0.1935483870967742,0.2857142857142857
Hereditary late-onset Parkinson disease,27576,6,34,43,12,31,24,8,16,0.35294117647058826,0.23529411764705882,0.27906976744186046,0.35294117647058826,0.3333333333333333,0.23529411764705882
X-linked parkinsonism-spasticity syndrome,31408,3,14,16,14,2,25,3,22,1.0,0.21428571428571427,0.875,1.0,0.12,0.21428571428571427
Parkinsonian-pyramidal syndrome,30093,7,25,19,12,7,28,6,22,0.48,0.24,0.631578947368421,0.48,0.21428571428571427,0.24
Infantile dystonia-parkinsonism,29875,6,20,40,16,24,30,3,27,0.8,0.15,0.4,0.8,0.1,0.15
Calpain-3-related limb-girdle muscular dystrophy R1,84272,17,21,20,2,18,21,2,19,0.09523809523809523,0.09523809523809523,0.1,0.09523809523809523,0.09523809523809523,0.09523809523809523
Beta-sarcoglycan-related limb-girdle muscular dystrophy R4,39236,16,13,20,1,19,22,1,21,0.07692307692307693,0.07692307692307693,0.05,0.07692307692307693,0.045454545454545456,0.07692307692307693
Paroxysmal dystonic choreathetosis with episodic ataxia and spasticity,31507,3,13,99,4,95,23,3,20,0.3076923076923077,0.23076923076923078,0.04040404040404041,0.3076923076923077,0.13043478260869565,0.23076923076923078
Congenital muscular dystrophy without intellectual disability,29208,1,27,84,5,79,21,2,19,0.18518518518518517,0.07407407407407407,0.05952380952380952,0.18518518518518517,0.09523809523809523,0.07407407407407407
Autosomal dominant centronuclear myopathy,29888,3,30,48,17,31,31,2,29,0.5666666666666667,0.06666666666666667,0.3541666666666667,0.5666666666666667,0.06451612903225806,0.06666666666666667
Juvenile myoclonic epilepsy,99971,19,11,28,1,27,23,1,22,0.09090909090909091,0.09090909090909091,0.03571428571428571,0.09090909090909091,0.043478260869565216,0.09090909090909091
POMT1-related limb-girdle muscular dystrophy R11,29368,9,32,18,6,12,26,3,23,0.1875,0.09375,0.3333333333333333,0.1875,0.11538461538461539,0.09375
Microform holoprosencephaly,32418,0,35,20,19,1,21,1,20,0.5428571428571428,0.02857142857142857,0.95,0.5428571428571428,0.047619047619047616,0.02857142857142857
Charcot-Marie-Tooth disease type 1B,27530,5,14,32,3,29,20,1,19,0.21428571428571427,0.07142857142857142,0.09375,0.21428571428571427,0.05,0.07142857142857142
Charcot-Marie-Tooth disease type 1A,27530,5,20,20,3,17,22,1,21,0.15,0.05,0.15,0.15,0.045454545454545456,0.05
X-linked intellectual disability-hypotonia-movement disorder syndrome,33463,4,23,19,18,1,23,6,17,0.782608695652174,0.2608695652173913,0.9473684210526315,0.782608695652174,0.2608695652173913,0.2608695652173913
Alpha-sarcoglycan-related limb-girdle muscular dystrophy R3,39236,18,14,27,1,26,25,0,25,0.07142857142857142,0.0,0.037037037037037035,0.07142857142857142,0.0,0.0
Amish nemaline myopathy,27294,4,12,125,12,113,16,1,15,1.0,0.08333333333333333,0.096,1.0,0.0625,0.08333333333333333
Congenital myasthenic syndrome,33062,2,68,35,10,25,23,4,19,0.14705882352941177,0.058823529411764705,0.2857142857142857,0.14705882352941177,0.17391304347826086,0.058823529411764705
Tibial muscular dystrophy,27375,2,19,17,17,0,26,2,24,0.8947368421052632,0.10526315789473684,1.0,0.8947368421052632,0.07692307692307693,0.10526315789473684
Malignant hyperthermia of anesthesia,33459,6,23,17,15,2,32,5,27,0.6521739130434783,0.21739130434782608,0.8823529411764706,0.6521739130434783,0.15625,0.21739130434782608
NARP syndrome,27782,2,28,17,16,1,29,2,27,0.5714285714285714,0.07142857142857142,0.9411764705882353,0.5714285714285714,0.06896551724137931,0.07142857142857142
Paramyotonia congenita of Von Eulenburg,27349,2,19,18,14,4,16,2,14,0.7368421052631579,0.10526315789473684,0.7777777777777778,0.7368421052631579,0.125,0.10526315789473684
Intermediate nemaline myopathy,27294,3,29,124,31,93,17,0,17,1.0689655172413792,0.0,0.25,1.0689655172413792,0.0,0.0
Congenital myopathy with myasthenic-like onset,27781,1,25,17,18,-1,17,1,16,0.72,0.04,1.0588235294117647,0.72,0.058823529411764705,0.04
Neuronal intestinal pseudoobstruction,30090,1,7,16,6,10,20,0,20,0.8571428571428571,0.0,0.375,0.8571428571428571,0.0,0.0
Hereditary sensory and autonomic neuropathy type 5,27625,3,11,24,1,23,41,0,41,0.09090909090909091,0.0,0.041666666666666664,0.09090909090909091,0.0,0.0
Delta-sarcoglycan-related limb-girdle muscular dystrophy R6,39236,16,6,27,0,27,21,0,21,0.0,0.0,0.0,0.0,0.0,0.0
Benign Samaritan congenital myopathy,32794,0,19,16,16,0,28,1,27,0.8421052631578947,0.05263157894736842,1.0,0.8421052631578947,0.03571428571428571,0.05263157894736842
Amyotrophic lateral sclerosis type 4,29371,1,8,19,0,19,19,1,18,0.0,0.125,0.0,0.0,0.05263157894736842,0.125
Spinocerebellar ataxia type 42,27402,6,32,8,2,6,9,3,6,0.0625,0.09375,0.25,0.0625,0.3333333333333333,0.09375
Hemidystonia-hemiatrophy syndrome,32878,1,15,19,15,4,25,1,24,1.0,0.06666666666666667,0.7894736842105263,1.0,0.04,0.06666666666666667
Spinocerebellar ataxia type 10,27402,7,30,9,3,6,11,4,7,0.1,0.13333333333333333,0.3333333333333333,0.1,0.36363636363636365,0.13333333333333333
Autosomal recessive spastic paraplegia type 15,39424,15,39,36,6,30,32,7,25,0.15384615384615385,0.1794871794871795,0.16666666666666666,0.15384615384615385,0.21875,0.1794871794871795
Autosomal dominant spastic paraplegia type 17,38455,6,16,24,0,24,22,0,22,0.0,0.0,0.0,0.0,0.0,0.0
Recessive mitochondrial ataxia syndrome,32303,4,22,18,19,-1,30,9,21,0.8636363636363636,0.4090909090909091,1.0555555555555556,0.8636363636363636,0.3,0.4090909090909091
Ataxia-telangiectasia-like disorder,30466,2,34,17,10,7,20,3,17,0.29411764705882354,0.08823529411764706,0.5882352941176471,0.29411764705882354,0.15,0.08823529411764706
Autosomal recessive spastic paraplegia type 20,39424,9,52,19,1,18,32,4,28,0.019230769230769232,0.07692307692307693,0.05263157894736842,0.019230769230769232,0.125,0.07692307692307693
Autosomal recessive spastic paraplegia type 21,39424,7,19,18,5,13,26,3,23,0.2631578947368421,0.15789473684210525,0.2777777777777778,0.2631578947368421,0.11538461538461539,0.15789473684210525
Autosomal recessive spastic paraplegia type 23,39424,20,14,24,0,24,25,0,25,0.0,0.0,0.0,0.0,0.0,0.0
Autosomal recessive spastic paraplegia type 24,39424,11,7,12,0,12,26,0,26,0.0,0.0,0.0,0.0,0.0,0.0
Autosomal recessive spastic paraplegia type 26,39424,14,22,31,5,26,28,1,27,0.22727272727272727,0.045454545454545456,0.16129032258064516,0.22727272727272727,0.03571428571428571,0.045454545454545456
Autosomal recessive spastic paraplegia type 27,39424,18,9,33,1,32,30,2,28,0.1111111111111111,0.2222222222222222,0.030303030303030304,0.1111111111111111,0.06666666666666667,0.2222222222222222
Spinocerebellar ataxia type 4,29145,4,12,18,3,15,17,5,12,0.25,0.4166666666666667,0.16666666666666666,0.25,0.29411764705882354,0.4166666666666667
Spinocerebellar ataxia type 15/16,27402,3,8,32,4,28,5,1,4,0.5,0.125,0.125,0.5,0.2,0.125
Spinocerebellar ataxia type 13,27402,6,32,23,5,18,14,5,9,0.15625,0.15625,0.21739130434782608,0.15625,0.35714285714285715,0.15625
Autosomal dominant cerebellar ataxia-deafness-narcolepsy syndrome,29925,2,28,29,25,4,6,3,3,0.8928571428571429,0.10714285714285714,0.8620689655172413,0.8928571428571429,0.5,0.10714285714285714
Spinocerebellar ataxia type 18,27402,6,18,6,2,4,12,3,9,0.1111111111111111,0.16666666666666666,0.3333333333333333,0.1111111111111111,0.25,0.16666666666666666
Childhood-onset spasticity with hyperglycinemia,27211,2,25,31,23,8,34,3,31,0.92,0.12,0.7419354838709677,0.92,0.08823529411764706,0.12
Spinocerebellar ataxia type 40,27402,7,14,19,2,17,14,2,12,0.14285714285714285,0.14285714285714285,0.10526315789473684,0.14285714285714285,0.14285714285714285,0.14285714285714285
Tremor-ataxia-central hypomyelination syndrome,33516,2,41,35,37,-2,5,3,2,0.9024390243902439,0.07317073170731707,1.0571428571428572,0.9024390243902439,0.6,0.07317073170731707
Primary progressive freezing gait,33138,3,21,18,17,1,33,4,29,0.8095238095238095,0.19047619047619047,0.9444444444444444,0.8095238095238095,0.12121212121212122,0.19047619047619047
X-linked non progressive cerebellar ataxia,27395,3,16,17,14,3,12,1,11,0.875,0.0625,0.8235294117647058,0.875,0.08333333333333333,0.0625
X-linked progressive cerebellar ataxia,27395,2,26,17,7,10,17,3,14,0.2692307692307692,0.11538461538461539,0.4117647058823529,0.2692307692307692,0.17647058823529413,0.11538461538461539
Huntington disease-like 1,38307,16,44,24,6,18,18,6,12,0.13636363636363635,0.13636363636363635,0.25,0.13636363636363635,0.3333333333333333,0.13636363636363635
Huntington disease-like 2,38307,16,18,18,4,14,17,5,12,0.2222222222222222,0.2777777777777778,0.2222222222222222,0.2222222222222222,0.29411764705882354,0.2777777777777778
Autosomal recessive spastic paraplegia type 75,27668,1,16,15,4,11,23,1,22,0.25,0.0625,0.26666666666666666,0.25,0.043478260869565216,0.0625
Hemiparkinsonism-hemiatrophy syndrome,32759,2,17,15,14,1,27,4,23,0.8235294117647058,0.23529411764705882,0.9333333333333333,0.8235294117647058,0.14814814814814814,0.23529411764705882
Presynaptic congenital myasthenic syndromes,27760,4,68,62,60,2,28,7,21,0.8823529411764706,0.10294117647058823,0.967741935483871,0.8823529411764706,0.25,0.10294117647058823
Postsynaptic congenital myasthenic syndromes,33062,4,37,35,37,-2,33,9,24,1.0,0.24324324324324326,1.0571428571428572,1.0,0.2727272727272727,0.24324324324324326
"Cerebellar ataxia, Cayman type",27352,2,11,17,9,8,12,2,10,0.8181818181818182,0.18181818181818182,0.5294117647058824,0.8181818181818182,0.16666666666666666,0.18181818181818182
Autosomal recessive ataxia due to PEX10 deficiency,27817,8,19,17,1,16,28,1,27,0.05263157894736842,0.05263157894736842,0.058823529411764705,0.05263157894736842,0.03571428571428571,0.05263157894736842
Gamma-sarcoglycan-related limb-girdle muscular dystrophy R5,39236,15,27,22,0,22,21,1,20,0.0,0.037037037037037035,0.0,0.0,0.047619047619047616,0.037037037037037035
Synaptic congenital myasthenic syndromes,33061,2,54,51,55,-4,21,5,16,1.0185185185185186,0.09259259259259259,1.0784313725490196,1.0185185185185186,0.23809523809523808,0.09259259259259259
Anoctamin-5-related limb-girdle muscular dystrophy R12,30310,2,35,21,6,15,23,3,20,0.17142857142857143,0.08571428571428572,0.2857142857142857,0.17142857142857143,0.13043478260869565,0.08571428571428572
Congenital multicore myopathy with external ophthalmoplegia,27213,2,44,21,19,2,30,4,26,0.4318181818181818,0.09090909090909091,0.9047619047619048,0.4318181818181818,0.13333333333333333,0.09090909090909091
Congenital myasthenic syndromes with glycosylation defect,33198,8,36,29,19,10,25,1,24,0.5277777777777778,0.027777777777777776,0.6551724137931034,0.5277777777777778,0.04,0.027777777777777776
Autosomal dominant progressive external ophthalmoplegia,33290,5,81,27,24,3,25,7,18,0.2962962962962963,0.08641975308641975,0.8888888888888888,0.2962962962962963,0.28,0.08641975308641975
Autosomal recessive progressive external ophthalmoplegia,33290,4,42,30,21,9,28,2,26,0.5,0.047619047619047616,0.7,0.5,0.07142857142857142,0.047619047619047616
Autosomal recessive spastic paraplegia type 54,38455,15,16,31,3,28,30,4,26,0.1875,0.25,0.0967741935483871,0.1875,0.13333333333333333,0.25
Autosomal recessive spastic paraplegia type 55,38455,17,27,34,3,31,28,4,24,0.1111111111111111,0.14814814814814814,0.08823529411764706,0.1111111111111111,0.14285714285714285,0.14814814814814814
Autosomal recessive spastic paraplegia type 43,38455,20,17,32,4,28,36,2,34,0.23529411764705882,0.11764705882352941,0.125,0.23529411764705882,0.05555555555555555,0.11764705882352941
Episodic ataxia type 7,27813,9,11,45,10,35,26,6,20,0.9090909090909091,0.5454545454545454,0.2222222222222222,0.9090909090909091,0.23076923076923078,0.5454545454545454
Autosomal recessive cerebellar ataxia-psychomotor delay syndrome,27739,1,13,19,6,13,20,8,12,0.46153846153846156,0.6153846153846154,0.3157894736842105,0.46153846153846156,0.4,0.6153846153846154
Autosomal recessive cerebellar ataxia-movement disorder syndrome,27739,0,20,20,12,8,13,1,12,0.6,0.05,0.6,0.6,0.07692307692307693,0.05
Posterior column ataxia-retinitis pigmentosa syndrome,31638,3,31,46,33,13,15,4,11,1.064516129032258,0.12903225806451613,0.717391304347826,1.064516129032258,0.26666666666666666,0.12903225806451613
Autosomal recessive spastic paraplegia type 28,39424,20,13,36,2,34,33,2,31,0.15384615384615385,0.15384615384615385,0.05555555555555555,0.15384615384615385,0.06060606060606061,0.15384615384615385
Autosomal spastic paraplegia type 72,30156,3,9,20,1,19,20,0,20,0.1111111111111111,0.0,0.05,0.1111111111111111,0.0,0.0
Episodic ataxia with slurred speech,38156,8,10,9,3,6,16,3,13,0.3,0.3,0.3333333333333333,0.3,0.1875,0.3
Episodic ataxia type 5,27813,5,6,23,5,18,25,4,21,0.8333333333333334,0.6666666666666666,0.21739130434782608,0.8333333333333334,0.16,0.6666666666666666
Autosomal recessive spastic paraplegia type 76,27668,2,17,17,8,9,33,5,28,0.47058823529411764,0.29411764705882354,0.47058823529411764,0.47058823529411764,0.15151515151515152,0.29411764705882354
Autosomal recessive spastic paraplegia type 9B,39424,9,29,12,0,12,26,1,25,0.0,0.034482758620689655,0.0,0.0,0.038461538461538464,0.034482758620689655
X-linked spastic paraplegia type 34,38801,18,8,28,1,27,33,1,32,0.125,0.125,0.03571428571428571,0.125,0.030303030303030304,0.125
Autosomal recessive spastic paraplegia type 62,27668,1,13,18,6,12,27,2,25,0.46153846153846156,0.15384615384615385,0.3333333333333333,0.46153846153846156,0.07407407407407407,0.15384615384615385
Beta-propeller protein-associated neurodegeneration,29074,3,22,16,4,12,43,1,42,0.18181818181818182,0.045454545454545456,0.25,0.18181818181818182,0.023255813953488372,0.045454545454545456
Spinocerebellar ataxia type 20,27402,6,19,22,4,18,14,4,10,0.21052631578947367,0.21052631578947367,0.18181818181818182,0.21052631578947367,0.2857142857142857,0.21052631578947367
Classic pantothenate kinase-associated neurodegeneration,28116,8,28,105,30,75,29,5,24,1.0714285714285714,0.17857142857142858,0.2857142857142857,1.0714285714285714,0.1724137931034483,0.17857142857142858
Spastic paraplegia-neuropathy-poikiloderma syndrome,28013,0,8,19,8,11,29,0,29,1.0,0.0,0.42105263157894735,1.0,0.0,0.0
"Primary dystonia, DYT21 type",27743,6,9,65,6,59,22,0,22,0.6666666666666666,0.0,0.09230769230769231,0.6666666666666666,0.0,0.0
Childhood-onset benign chorea with striatal involvement,27708,7,7,19,5,14,30,0,30,0.7142857142857143,0.0,0.2631578947368421,0.7142857142857143,0.0,0.0
Atypical pantothenate kinase-associated neurodegeneration,28116,7,30,105,32,73,32,2,30,1.0666666666666667,0.06666666666666667,0.3047619047619048,1.0666666666666667,0.0625,0.06666666666666667
Postencephalitic parkinsonism,32468,5,41,24,25,-1,19,5,14,0.6097560975609756,0.12195121951219512,1.0416666666666667,0.6097560975609756,0.2631578947368421,0.12195121951219512
X-linked spinocerebellar ataxia type 4,29145,3,7,18,2,16,8,0,8,0.2857142857142857,0.0,0.1111111111111111,0.2857142857142857,0.0,0.0
Autosomal recessive spastic ataxia of Charlevoix-Saguenay,31049,6,38,20,15,5,28,9,19,0.39473684210526316,0.23684210526315788,0.75,0.39473684210526316,0.32142857142857145,0.23684210526315788
Delayed encephalopathy due to carbon monoxide poisoning,97084,22,9,25,0,25,26,0,26,0.0,0.0,0.0,0.0,0.0,0.0
Manganese poisoning,32704,1,30,18,18,0,22,1,21,0.6,0.03333333333333333,1.0,0.6,0.045454545454545456,0.03333333333333333
"Primary dystonia, DYT6 type",27743,9,9,72,6,66,35,1,34,0.6666666666666666,0.1111111111111111,0.08333333333333333,0.6666666666666666,0.02857142857142857,0.1111111111111111
"Primary dystonia, DYT4 type",27743,5,17,15,4,11,31,2,29,0.23529411764705882,0.11764705882352941,0.26666666666666666,0.23529411764705882,0.06451612903225806,0.11764705882352941
Severe motor and intellectual disabilities-sensorineural deafness-dystonia syndrome,30801,1,20,19,15,4,21,1,20,0.75,0.05,0.7894736842105263,0.75,0.047619047619047616,0.05
Semantic dementia,29468,0,11,17,3,14,6,0,6,0.2727272727272727,0.0,0.17647058823529413,0.2727272727272727,0.0,0.0
Cyanide-induced parkinsonism-dystonia,32700,5,20,17,17,0,17,5,12,0.85,0.25,1.0,0.85,0.29411764705882354,0.25
Spinocerebellar ataxia type 23,27402,7,10,22,5,17,18,3,15,0.5,0.3,0.22727272727272727,0.5,0.16666666666666666,0.3
Spinocerebellar ataxia type 21,27402,2,15,23,4,19,4,2,2,0.26666666666666666,0.13333333333333333,0.17391304347826086,0.26666666666666666,0.5,0.13333333333333333
RIDDLE syndrome,30932,0,43,16,16,0,32,0,32,0.37209302325581395,0.0,1.0,0.37209302325581395,0.0,0.0
Joubert syndrome with Jeune asphyxiating thoracic dystrophy,33081,0,73,67,69,-2,1,1,0,0.9452054794520548,0.0136986301369863,1.0298507462686568,0.9452054794520548,1.0,0.0136986301369863
Juvenile-onset diabetes mellitus-central and peripheral neurodegeneration syndrome,30777,2,15,17,13,4,15,3,12,0.8666666666666667,0.2,0.7647058823529411,0.8666666666666667,0.2,0.2
Encephalitis lethargica,32753,3,30,18,17,1,33,3,30,0.5666666666666667,0.1,0.9444444444444444,0.5666666666666667,0.09090909090909091,0.1
Rolandic epilepsy-paroxysmal exercise-induced dystonia-writer's cramp syndrome,31210,3,8,18,9,9,21,1,20,1.125,0.125,0.5,1.125,0.047619047619047616,0.125
Spinocerebellar ataxia type 12,27402,9,21,20,4,16,19,5,14,0.19047619047619047,0.23809523809523808,0.2,0.19047619047619047,0.2631578947368421,0.23809523809523808
Autosomal dominant spastic ataxia type 1,27721,7,26,91,24,67,17,3,14,0.9230769230769231,0.11538461538461539,0.26373626373626374,0.9230769230769231,0.17647058823529413,0.11538461538461539
Autosomal dominant spastic paraplegia type 73,27668,1,19,15,4,11,34,1,33,0.21052631578947367,0.05263157894736842,0.26666666666666666,0.21052631578947367,0.029411764705882353,0.05263157894736842
Autosomal dominant spastic paraplegia type 38,30156,3,25,22,5,17,23,2,21,0.2,0.08,0.22727272727272727,0.2,0.08695652173913043,0.08
Autosomal dominant spastic paraplegia type 41,38901,15,14,26,0,26,29,1,28,0.0,0.07142857142857142,0.0,0.0,0.034482758620689655,0.07142857142857142
Autosomal dominant spastic paraplegia type 42,38455,15,17,19,1,18,29,2,27,0.058823529411764705,0.11764705882352941,0.05263157894736842,0.058823529411764705,0.06896551724137931,0.11764705882352941
Autosomal dominant spastic paraplegia type 37,30156,2,20,23,6,17,28,5,23,0.3,0.25,0.2608695652173913,0.3,0.17857142857142858,0.25
Autosomal dominant spastic paraplegia type 19,30156,3,24,23,6,17,30,4,26,0.25,0.16666666666666666,0.2608695652173913,0.25,0.13333333333333333,0.16666666666666666
Autosomal dominant spastic paraplegia type 12,30156,2,26,22,6,16,31,3,28,0.23076923076923078,0.11538461538461539,0.2727272727272727,0.23076923076923078,0.0967741935483871,0.11538461538461539
Autosomal dominant spastic paraplegia type 8,38901,6,22,19,2,17,25,4,21,0.09090909090909091,0.18181818181818182,0.10526315789473684,0.09090909090909091,0.16,0.18181818181818182
Autosomal recessive cerebellar ataxia-epilepsy-intellectual disability syndrome due to TUD deficiency,29856,7,6,23,6,17,26,3,23,1.0,0.5,0.2608695652173913,1.0,0.11538461538461539,0.5
Autosomal recessive cerebellar ataxia-epilepsy-intellectual disability syndrome due to WWOX deficiency,27803,7,8,24,1,23,28,3,25,0.125,0.375,0.041666666666666664,0.125,0.10714285714285714,0.375
Benign paroxysmal torticollis of infancy,32585,3,10,15,9,6,8,1,7,0.9,0.1,0.6,0.9,0.125,0.1
Episodic ataxia type 1,38156,16,27,19,3,16,27,4,23,0.1111111111111111,0.14814814814814814,0.15789473684210525,0.1111111111111111,0.14814814814814814,0.14814814814814814
Episodic ataxia type 6,27813,5,14,32,11,21,34,6,28,0.7857142857142857,0.42857142857142855,0.34375,0.7857142857142857,0.17647058823529413,0.42857142857142855
Autosomal recessive spastic paraplegia type 44,38455,16,16,23,3,20,36,5,31,0.1875,0.3125,0.13043478260869565,0.1875,0.1388888888888889,0.3125
Dystonia-aphonia syndrome,33366,5,24,17,18,-1,32,6,26,0.75,0.25,1.0588235294117647,0.75,0.1875,0.25
Autosomal recessive spastic paraplegia type 53,39424,12,16,20,1,19,23,2,21,0.0625,0.125,0.05,0.0625,0.08695652173913043,0.125
Autosomal recessive spastic paraplegia type 46,38455,10,33,17,1,16,13,1,12,0.030303030303030304,0.030303030303030304,0.058823529411764705,0.030303030303030304,0.07692307692307693,0.030303030303030304
Autosomal recessive spastic paraplegia type 25,39424,22,13,34,0,34,35,0,35,0.0,0.0,0.0,0.0,0.0,0.0
Autosomal recessive spastic paraplegia type 39,39424,13,9,31,2,29,22,1,21,0.2222222222222222,0.1111111111111111,0.06451612903225806,0.2222222222222222,0.045454545454545456,0.1111111111111111
Generalized epilepsy-paroxysmal dyskinesia syndrome,28945,1,11,19,10,9,31,1,30,0.9090909090909091,0.09090909090909091,0.5263157894736842,0.9090909090909091,0.03225806451612903,0.09090909090909091
Autosomal dominant spastic paraplegia type 29,30156,3,14,23,4,19,31,2,29,0.2857142857142857,0.14285714285714285,0.17391304347826086,0.2857142857142857,0.06451612903225806,0.14285714285714285
Sydenham chorea,32884,7,17,24,11,13,21,3,18,0.6470588235294118,0.17647058823529413,0.4583333333333333,0.6470588235294118,0.14285714285714285,0.17647058823529413
Adult-onset dystonia-parkinsonism,27743,9,32,22,8,14,22,8,14,0.25,0.25,0.36363636363636365,0.25,0.36363636363636365,0.25
Autosomal dominant spastic paraplegia type 36,30156,3,20,23,4,19,36,1,35,0.2,0.05,0.17391304347826086,0.2,0.027777777777777776,0.05
PANDAS,31184,0,24,34,0,34,1,0,1,0.0,0.0,0.0,0.0,0.0,0.0
Spinocerebellar ataxia type 36,27402,7,27,21,6,15,11,5,6,0.2222222222222222,0.18518518518518517,0.2857142857142857,0.2222222222222222,0.45454545454545453,0.18518518518518517
Spinocerebellar ataxia type 43,27402,5,22,23,2,21,17,2,15,0.09090909090909091,0.09090909090909091,0.08695652173913043,0.09090909090909091,0.11764705882352941,0.09090909090909091
Autosomal dominant spastic paraplegia type 13,38455,10,16,21,1,20,26,3,23,0.0625,0.1875,0.047619047619047616,0.0625,0.11538461538461539,0.1875
Spastic paraplegia type 7,30156,1,30,24,5,19,32,3,29,0.16666666666666666,0.1,0.20833333333333334,0.16666666666666666,0.09375,0.1
Paroxysmal hemicrania,27770,3,21,17,15,2,27,5,22,0.7142857142857143,0.23809523809523808,0.8823529411764706,0.7142857142857143,0.18518518518518517,0.23809523809523808
Autosomal dominant spastic paraplegia type 31,38455,14,18,26,6,20,32,8,24,0.3333333333333333,0.4444444444444444,0.23076923076923078,0.3333333333333333,0.25,0.4444444444444444
Autosomal spastic paraplegia type 58,30156,3,33,17,3,14,30,3,27,0.09090909090909091,0.09090909090909091,0.17647058823529413,0.09090909090909091,0.1,0.09090909090909091
Autosomal dominant spastic paraplegia type 6,30156,2,13,23,9,14,28,3,25,0.6923076923076923,0.23076923076923078,0.391304347826087,0.6923076923076923,0.10714285714285714,0.23076923076923078
Autosomal dominant dopa-responsive dystonia,32450,4,34,51,10,41,27,1,26,0.29411764705882354,0.029411764705882353,0.19607843137254902,0.29411764705882354,0.037037037037037035,0.029411764705882353
Autosomal recessive spastic paraplegia type 35,38455,13,37,36,3,33,26,4,22,0.08108108108108109,0.10810810810810811,0.08333333333333333,0.08108108108108109,0.15384615384615385,0.10810810810810811
X-linked spastic paraplegia type 16,38818,13,9,29,1,28,27,0,27,0.1111111111111111,0.0,0.034482758620689655,0.1111111111111111,0.0,0.0
Autosomal recessive spastic paraplegia type 61,27668,2,8,14,2,12,34,1,33,0.25,0.125,0.14285714285714285,0.25,0.029411764705882353,0.125
Autosomal recessive spastic paraplegia type 45,38455,9,14,23,0,23,32,0,32,0.0,0.0,0.0,0.0,0.0,0.0
Autosomal recessive spastic paraplegia type 56,27668,1,14,18,3,15,34,1,33,0.21428571428571427,0.07142857142857142,0.16666666666666666,0.21428571428571427,0.029411764705882353,0.07142857142857142
Autosomal spastic paraplegia type 30,30156,3,15,21,1,20,21,3,18,0.06666666666666667,0.2,0.047619047619047616,0.06666666666666667,0.14285714285714285,0.2
Autosomal recessive spastic paraplegia type 48,38455,23,19,28,3,25,37,3,34,0.15789473684210525,0.15789473684210525,0.10714285714285714,0.15789473684210525,0.08108108108108109,0.15789473684210525
Autosomal recessive spastic paraplegia type 5A,39424,12,24,15,2,13,30,3,27,0.08333333333333333,0.125,0.13333333333333333,0.08333333333333333,0.1,0.125
Autosomal recessive spastic paraplegia type 14,39424,15,7,41,0,41,28,1,27,0.0,0.14285714285714285,0.0,0.0,0.03571428571428571,0.14285714285714285
Multifocal motor neuropathy,33185,6,12,17,10,7,18,3,15,0.8333333333333334,0.25,0.5882352941176471,0.8333333333333334,0.16666666666666666,0.25
Autosomal dominant limb-girdle muscular dystrophy type 1A,27315,9,24,19,4,15,19,3,16,0.16666666666666666,0.125,0.21052631578947367,0.16666666666666666,0.15789473684210525,0.125
Episodic ataxia type 4,27813,7,10,30,8,22,28,3,25,0.8,0.3,0.26666666666666666,0.8,0.10714285714285714,0.3
Leukoencephalopathy-spondyloepimetaphyseal dysplasia syndrome,38339,14,23,33,5,28,26,3,23,0.21739130434782608,0.13043478260869565,0.15151515151515152,0.21739130434782608,0.11538461538461539,0.13043478260869565
ATTRV30M amyloidosis,33159,2,14,20,0,20,23,4,19,0.0,0.2857142857142857,0.0,0.0,0.17391304347826086,0.2857142857142857
Autosomal recessive spastic paraplegia type 64,38455,23,9,38,3,35,32,4,28,0.3333333333333333,0.4444444444444444,0.07894736842105263,0.3333333333333333,0.125,0.4444444444444444
Autosomal recessive spastic paraplegia type 63,27668,1,9,13,3,10,18,0,18,0.3333333333333333,0.0,0.23076923076923078,0.3333333333333333,0.0,0.0
Autosomal recessive ataxia due to ubiquinone deficiency,31085,2,24,16,13,3,24,1,23,0.5416666666666666,0.041666666666666664,0.8125,0.5416666666666666,0.041666666666666664,0.041666666666666664
Non-progressive cerebellar ataxia with intellectual disability,39885,4,39,4,2,2,4,2,2,0.05128205128205128,0.05128205128205128,0.5,0.05128205128205128,0.5,0.05128205128205128
Spinocerebellar ataxia type 35,27402,6,18,9,2,7,16,6,10,0.1111111111111111,0.3333333333333333,0.2222222222222222,0.1111111111111111,0.375,0.3333333333333333
Spinocerebellar ataxia type 26,27402,6,15,25,1,24,17,4,13,0.06666666666666667,0.26666666666666666,0.04,0.06666666666666667,0.23529411764705882,0.26666666666666666
Adult-onset autosomal recessive cerebellar ataxia,27739,1,28,18,4,14,11,3,8,0.14285714285714285,0.10714285714285714,0.2222222222222222,0.14285714285714285,0.2727272727272727,0.10714285714285714
Childhood-onset autosomal recessive slowly progressive spinocerebellar ataxia,27662,5,21,26,6,20,29,3,26,0.2857142857142857,0.14285714285714285,0.23076923076923078,0.2857142857142857,0.10344827586206896,0.14285714285714285
Infantile-onset autosomal recessive nonprogressive cerebellar ataxia,27739,1,18,18,4,14,14,2,12,0.2222222222222222,0.1111111111111111,0.2222222222222222,0.2222222222222222,0.14285714285714285,0.1111111111111111
Spectrin-associated autosomal recessive cerebellar ataxia,27739,1,20,17,4,13,12,4,8,0.2,0.2,0.23529411764705882,0.2,0.3333333333333333,0.2
Spinocerebellar degeneration-corneal dystrophy syndrome,31441,1,9,22,11,11,16,2,14,1.2222222222222223,0.2222222222222222,0.5,1.2222222222222223,0.125,0.2222222222222222
Myoclonus-cerebellar ataxia-deafness syndrome,28663,3,10,16,10,6,6,2,4,1.0,0.2,0.625,1.0,0.3333333333333333,0.2
Progressive encephalopathy with leukodystrophy due to DECR deficiency,32025,1,28,31,23,8,22,1,21,0.8214285714285714,0.03571428571428571,0.7419354838709677,0.8214285714285714,0.045454545454545456,0.03571428571428571
Familial congenital mirror movements,33373,2,14,18,12,6,25,2,23,0.8571428571428571,0.14285714285714285,0.6666666666666666,0.8571428571428571,0.08,0.14285714285714285
"Metachromatic leukodystrophy, adult form",29433,18,48,22,4,18,41,7,34,0.08333333333333333,0.14583333333333334,0.18181818181818182,0.08333333333333333,0.17073170731707318,0.14583333333333334
"Metachromatic leukodystrophy, juvenile form",29393,3,37,17,8,9,29,4,25,0.21621621621621623,0.10810810810810811,0.47058823529411764,0.21621621621621623,0.13793103448275862,0.10810810810810811
"Metachromatic leukodystrophy, late infantile form",29393,3,36,17,9,8,25,4,21,0.25,0.1111111111111111,0.5294117647058824,0.25,0.16,0.1111111111111111
Mitochondrial membrane protein-associated neurodegeneration,38859,11,26,28,3,25,23,4,19,0.11538461538461539,0.15384615384615385,0.10714285714285714,0.11538461538461539,0.17391304347826086,0.15384615384615385
Paroxysmal non-kinesigenic dyskinesia,29166,3,15,18,11,7,23,2,21,0.7333333333333333,0.13333333333333333,0.6111111111111112,0.7333333333333333,0.08695652173913043,0.13333333333333333
Paroxysmal kinesigenic dyskinesia,29166,2,9,18,7,11,24,3,21,0.7777777777777778,0.3333333333333333,0.3888888888888889,0.7777777777777778,0.125,0.3333333333333333
Juvenile Huntington disease,33341,3,24,17,16,1,19,3,16,0.6666666666666666,0.125,0.9411764705882353,0.6666666666666666,0.15789473684210525,0.125
Sporadic adult-onset ataxia of unknown etiology,32721,3,28,19,18,1,12,4,8,0.6428571428571429,0.14285714285714285,0.9473684210526315,0.6428571428571429,0.3333333333333333,0.14285714285714285
Spinocerebellar ataxia with axonal neuropathy type 2,27662,1,22,30,9,21,20,4,16,0.4090909090909091,0.18181818181818182,0.3,0.4090909090909091,0.2,0.18181818181818182
Autosomal dominant spastic paraplegia type 4,38455,13,19,23,5,18,32,7,25,0.2631578947368421,0.3684210526315789,0.21739130434782608,0.2631578947368421,0.21875,0.3684210526315789
Autosomal dominant spastic paraplegia type 3,30156,1,20,23,8,15,23,2,21,0.4,0.1,0.34782608695652173,0.4,0.08695652173913043,0.1
Familial paroxysmal ataxia,30987,8,14,21,4,17,15,6,9,0.2857142857142857,0.42857142857142855,0.19047619047619047,0.2857142857142857,0.4,0.42857142857142855
Early-onset cerebellar ataxia with retained tendon reflexes,27787,2,24,17,16,1,15,4,11,0.6666666666666666,0.16666666666666666,0.9411764705882353,0.6666666666666666,0.26666666666666666,0.16666666666666666
Spinocerebellar ataxia type 6,27402,6,19,25,2,23,17,5,12,0.10526315789473684,0.2631578947368421,0.08,0.10526315789473684,0.29411764705882354,0.2631578947368421
Spinocerebellar ataxia type 7,27402,9,32,24,7,17,17,9,8,0.21875,0.28125,0.2916666666666667,0.21875,0.5294117647058824,0.28125
"Multiple system atrophy, parkinsonian type",33015,4,30,16,15,1,23,5,18,0.5,0.16666666666666666,0.9375,0.5,0.21739130434782608,0.16666666666666666
"Multiple system atrophy, cerebellar type",32854,4,35,34,34,0,21,5,16,0.9714285714285714,0.14285714285714285,1.0,0.9714285714285714,0.23809523809523808,0.14285714285714285
X-linked dystonia-parkinsonism,28439,4,19,17,14,3,23,3,20,0.7368421052631579,0.15789473684210525,0.8235294117647058,0.7368421052631579,0.13043478260869565,0.15789473684210525
Severe intellectual disability-corpus callosum agenesis-facial dysmorphism-cerebellar ataxia syndrome,31952,1,23,25,16,9,29,2,27,0.6956521739130435,0.08695652173913043,0.64,0.6956521739130435,0.06896551724137931,0.08695652173913043
Acute infantile liver failure-cerebellar ataxia-peripheral sensory motor neuropathy syndrome,27793,3,25,25,16,9,18,2,16,0.64,0.08,0.64,0.64,0.1111111111111111,0.08
Autosomal recessive dopa-responsive dystonia,32450,6,33,51,14,37,17,2,15,0.42424242424242425,0.06060606060606061,0.27450980392156865,0.42424242424242425,0.11764705882352941,0.06060606060606061
RARS-related autosomal recessive hypomyelinating leukodystrophy,27796,3,27,143,28,115,11,1,10,1.037037037037037,0.037037037037037035,0.1958041958041958,1.037037037037037,0.09090909090909091,0.037037037037037035
Spinocerebellar ataxia type 1,27662,2,40,26,12,14,11,6,5,0.3,0.15,0.46153846153846156,0.3,0.5454545454545454,0.15
Spinocerebellar ataxia type 2,27402,8,27,17,1,16,21,2,19,0.037037037037037035,0.07407407407407407,0.058823529411764705,0.037037037037037035,0.09523809523809523,0.07407407407407407
VPS11-related autosomal recessive hypomyelinating leukodystrophy,27796,2,26,18,5,13,11,1,10,0.19230769230769232,0.038461538461538464,0.2777777777777778,0.19230769230769232,0.09090909090909091,0.038461538461538464
Dentatorubral pallidoluysian atrophy,30598,4,26,21,21,0,30,6,24,0.8076923076923077,0.23076923076923078,1.0,0.8076923076923077,0.2,0.23076923076923078
17q24.2 microdeletion syndrome,32429,6,47,102,11,91,27,1,26,0.23404255319148937,0.02127659574468085,0.10784313725490197,0.23404255319148937,0.037037037037037035,0.02127659574468085
PLAA-associated neurodevelopmental disorder,38984,15,51,24,1,23,21,2,19,0.0196078431372549,0.0392156862745098,0.041666666666666664,0.0196078431372549,0.09523809523809523,0.0392156862745098
Cleft palate-short stature-vertebral anomalies syndrome,32539,7,11,25,11,14,26,3,23,1.0,0.2727272727272727,0.44,1.0,0.11538461538461539,0.2727272727272727
Microcephaly-seizures-intellectual disability-heart disease syndrome,32770,1,24,17,16,1,24,3,21,0.6666666666666666,0.125,0.9411764705882353,0.6666666666666666,0.125,0.125
Zimmermann-Laband syndrome,28250,0,43,17,7,10,9,0,9,0.16279069767441862,0.0,0.4117647058823529,0.16279069767441862,0.0,0.0
Microcephaly-brachydactyly-kyphoscoliosis syndrome,33370,5,19,21,17,4,30,3,27,0.8947368421052632,0.15789473684210525,0.8095238095238095,0.8947368421052632,0.1,0.15789473684210525
Fallot complex-intellectual disability-growth delay syndrome,29650,2,33,17,14,3,26,2,24,0.42424242424242425,0.06060606060606061,0.8235294117647058,0.42424242424242425,0.07692307692307693,0.06060606060606061
Microcephaly-facial dysmorphism-ocular anomalies-multiple congenital anomalies syndrome,98519,18,27,21,1,20,27,1,26,0.037037037037037035,0.037037037037037035,0.047619047619047616,0.037037037037037035,0.037037037037037035,0.037037037037037035
CHAND syndrome,27636,0,20,16,16,0,21,0,21,0.8,0.0,1.0,0.8,0.0,0.0
Familial infantile bilateral striatal necrosis,31878,4,36,48,31,17,21,5,16,0.8611111111111112,0.1388888888888889,0.6458333333333334,0.8611111111111112,0.23809523809523808,0.1388888888888889
Sporadic infantile bilateral striatal necrosis,31878,6,38,48,25,23,30,4,26,0.6578947368421053,0.10526315789473684,0.5208333333333334,0.6578947368421053,0.13333333333333333,0.10526315789473684
Early-onset progressive leukoencephalopathy-central nervous system calcification-deafness-visual impairment syndrome,31550,3,23,17,1,16,25,0,25,0.043478260869565216,0.0,0.058823529411764705,0.043478260869565216,0.0,0.0
Cataract-deafness-hypogonadism syndrome,32868,7,6,36,7,29,37,2,35,1.1666666666666667,0.3333333333333333,0.19444444444444445,1.1666666666666667,0.05405405405405406,0.3333333333333333
Aymé-Gripp syndrome,30872,0,66,16,10,6,32,1,31,0.15151515151515152,0.015151515151515152,0.625,0.15151515151515152,0.03125,0.015151515151515152
Atelosteogenesis type III,30049,0,27,16,7,9,26,0,26,0.25925925925925924,0.0,0.4375,0.25925925925925924,0.0,0.0
Global developmental delay-osteopenia-ectodermal defect syndrome,32336,0,39,23,25,-2,25,1,24,0.6410256410256411,0.02564102564102564,1.0869565217391304,0.6410256410256411,0.04,0.02564102564102564
Bilateral polymicrogyria,27528,9,44,20,6,14,21,2,19,0.13636363636363635,0.045454545454545456,0.3,0.13636363636363635,0.09523809523809523,0.045454545454545456
Atelosteogenesis type II,30049,0,53,16,9,7,21,0,21,0.16981132075471697,0.0,0.5625,0.16981132075471697,0.0,0.0
Tricho-dento-osseous syndrome,31662,1,16,17,14,3,36,2,34,0.875,0.125,0.8235294117647058,0.875,0.05555555555555555,0.125
Unilateral polymicrogyria,27528,7,37,18,5,13,30,7,23,0.13513513513513514,0.1891891891891892,0.2777777777777778,0.13513513513513514,0.23333333333333334,0.1891891891891892
Isolated congenital alacrima,28705,0,10,22,5,17,31,0,31,0.5,0.0,0.22727272727272727,0.5,0.0,0.0
NKX6-2-related autosomal recessive hypomyelinating leukodystrophy,99885,16,25,20,2,18,38,5,33,0.08,0.2,0.1,0.08,0.13157894736842105,0.2
"3-phosphoserine phosphatase deficiency, infantile/juvenile form",30055,1,18,17,13,4,26,0,26,0.7222222222222222,0.0,0.7647058823529411,0.7222222222222222,0.0,0.0
Autosomal recessive axonal Charcot-Marie-Tooth disease due to copper metabolism defect,30728,0,21,17,1,16,23,3,20,0.047619047619047616,0.14285714285714285,0.058823529411764705,0.047619047619047616,0.13043478260869565,0.14285714285714285
Familial acute necrotizing encephalopathy,29105,4,24,30,25,5,22,4,18,1.0416666666666667,0.16666666666666666,0.8333333333333334,1.0416666666666667,0.18181818181818182,0.16666666666666666
Chronic bilirubin encephalopathy,95110,20,21,27,0,27,29,0,29,0.0,0.0,0.0,0.0,0.0,0.0
Microphthalmia-brain atrophy syndrome,33238,1,20,19,17,2,20,2,18,0.85,0.1,0.8947368421052632,0.85,0.1,0.1
Ossification anomalies-psychomotor developmental delay syndrome,32328,1,36,21,21,0,23,1,22,0.5833333333333334,0.027777777777777776,1.0,0.5833333333333334,0.043478260869565216,0.027777777777777776
Charcot-Marie-Tooth disease-deafness-intellectual disability syndrome,27720,2,30,16,14,2,27,1,26,0.4666666666666667,0.03333333333333333,0.875,0.4666666666666667,0.037037037037037035,0.03333333333333333
Keratosis follicularis-dwarfism-cerebral atrophy syndrome,30259,10,6,26,5,21,40,2,38,0.8333333333333334,0.3333333333333333,0.19230769230769232,0.8333333333333334,0.05,0.3333333333333333
Sporadic Creutzfeldt-Jakob disease,32477,4,28,17,18,-1,20,8,12,0.6428571428571429,0.2857142857142857,1.0588235294117647,0.6428571428571429,0.4,0.2857142857142857
Agammaglobulinemia-microcephaly-craniosynostosis-severe dermatitis syndrome,32747,0,54,17,16,1,31,1,30,0.2962962962962963,0.018518518518518517,0.9411764705882353,0.2962962962962963,0.03225806451612903,0.018518518518518517
"3-phosphoglycerate dehydrogenase deficiency, infantile/juvenile form",35495,9,46,27,2,25,19,0,19,0.043478260869565216,0.0,0.07407407407407407,0.043478260869565216,0.0,0.0
Periventricular nodular heterotopia,28816,3,16,26,4,22,23,0,23,0.25,0.0,0.15384615384615385,0.25,0.0,0.0
S-adenosylhomocysteine hydrolase deficiency,29286,1,44,23,18,5,27,4,23,0.4090909090909091,0.09090909090909091,0.782608695652174,0.4090909090909091,0.14814814814814814,0.09090909090909091
MYH9-related disease,27475,2,16,18,9,9,37,0,37,0.5625,0.0,0.5,0.5625,0.0,0.0
"X-linked intellectual disability, Snyder type",27603,5,66,114,24,90,33,2,31,0.36363636363636365,0.030303030303030304,0.21052631578947367,0.36363636363636365,0.06060606060606061,0.030303030303030304
Ménétrier disease,30175,0,21,16,0,16,20,6,14,0.0,0.2857142857142857,0.0,0.0,0.3,0.2857142857142857
Laryngeal abductor paralysis-intellectual disability syndrome,28639,6,7,19,5,14,34,0,34,0.7142857142857143,0.0,0.2631578947368421,0.7142857142857143,0.0,0.0
X-linked intellectual disability-seizures-psoriasis syndrome,27727,10,5,30,3,27,34,3,31,0.6,0.6,0.1,0.6,0.08823529411764706,0.6
"Autosomal dominant optic atrophy, classic form",27858,4,44,24,17,7,38,5,33,0.38636363636363635,0.11363636363636363,0.7083333333333334,0.38636363636363635,0.13157894736842105,0.11363636363636363
HELLP syndrome,30274,5,32,16,13,3,22,7,15,0.40625,0.21875,0.8125,0.40625,0.3181818181818182,0.21875
Hyperornithinemia-hyperammonemia-homocitrullinuria syndrome,30805,6,40,20,4,16,22,4,18,0.1,0.1,0.2,0.1,0.18181818181818182,0.1
Small bowel atresia,31974,8,10,17,10,7,15,2,13,1.0,0.2,0.5882352941176471,1.0,0.13333333333333333,0.2
Meige disease,29657,0,21,17,17,0,35,0,35,0.8095238095238095,0.0,1.0,0.8095238095238095,0.0,0.0
Caudal appendage-deafness syndrome,33226,2,7,23,6,17,39,1,38,0.8571428571428571,0.14285714285714285,0.2608695652173913,0.8571428571428571,0.02564102564102564,0.14285714285714285
Chilblain lupus,27368,2,18,17,13,4,20,2,18,0.7222222222222222,0.1111111111111111,0.7647058823529411,0.7222222222222222,0.1,0.1111111111111111
Van den Bosch syndrome,31455,1,12,16,12,4,20,0,20,1.0,0.0,0.75,1.0,0.0,0.0
FG syndrome type 1,28758,1,72,17,9,8,35,0,35,0.125,0.0,0.5294117647058824,0.125,0.0,0.0
Glycogen storage disease due to phosphoglycerate kinase 1 deficiency,29043,2,21,18,14,4,26,4,22,0.6666666666666666,0.19047619047619047,0.7777777777777778,0.6666666666666666,0.15384615384615385,0.19047619047619047
Mitochondrial DNA-associated Leigh syndrome,29857,7,53,106,22,84,25,5,20,0.41509433962264153,0.09433962264150944,0.20754716981132076,0.41509433962264153,0.2,0.09433962264150944
"Severe X-linked intellectual disability, Gustavson type",28944,3,34,20,3,17,28,2,26,0.08823529411764706,0.058823529411764705,0.15,0.08823529411764706,0.07142857142857142,0.058823529411764705
X-linked intellectual disability-psychosis-macroorchidism syndrome,32121,1,27,35,19,16,27,1,26,0.7037037037037037,0.037037037037037035,0.5428571428571428,0.7037037037037037,0.037037037037037035,0.037037037037037035
Ethylmalonic encephalopathy,28057,2,18,18,14,4,13,2,11,0.7777777777777778,0.1111111111111111,0.7777777777777778,0.7777777777777778,0.15384615384615385,0.1111111111111111
Primary lateral sclerosis,28624,6,18,18,7,11,26,3,23,0.3888888888888889,0.16666666666666666,0.3888888888888889,0.3888888888888889,0.11538461538461539,0.16666666666666666
Brain malformations-musculoskeletal abnormalities-facial dysmorphism-intellectual disability syndrome,38365,22,105,34,4,30,29,5,24,0.0380952380952381,0.047619047619047616,0.11764705882352941,0.0380952380952381,0.1724137931034483,0.047619047619047616
Global developmental delay-neuro-ophthalmological abnormalities-seizures-intellectual disability syndrome,29069,11,29,22,7,15,33,5,28,0.2413793103448276,0.1724137931034483,0.3181818181818182,0.2413793103448276,0.15151515151515152,0.1724137931034483
Glanzmann thrombasthenia,27527,5,20,18,13,5,22,6,16,0.65,0.3,0.7222222222222222,0.65,0.2727272727272727,0.3
Bernard-Soulier syndrome,30957,6,21,16,15,1,25,8,17,0.7142857142857143,0.38095238095238093,0.9375,0.7142857142857143,0.32,0.38095238095238093
8q24.3 microdeletion syndrome,32429,4,101,100,16,84,29,2,27,0.15841584158415842,0.019801980198019802,0.16,0.15841584158415842,0.06896551724137931,0.019801980198019802
NUT midline carcinoma,33035,1,9,19,8,11,26,0,26,0.8888888888888888,0.0,0.42105263157894735,0.8888888888888888,0.0,0.0
Distal hereditary motor neuropathy type 5,38458,15,16,24,1,23,34,3,31,0.0625,0.1875,0.041666666666666664,0.0625,0.08823529411764706,0.1875
Autoimmune hepatitis,33348,3,34,28,27,1,22,4,18,0.7941176470588235,0.11764705882352941,0.9642857142857143,0.7941176470588235,0.18181818181818182,0.11764705882352941
Histidinemia,30272,1,7,16,5,11,15,0,15,0.7142857142857143,0.0,0.3125,0.7142857142857143,0.0,0.0
Hepatic veno-occlusive disease-immunodeficiency syndrome,32827,9,39,22,5,17,25,6,19,0.1282051282051282,0.15384615384615385,0.22727272727272727,0.1282051282051282,0.24,0.15384615384615385
Combined oxidative phosphorylation defect type 29,38594,13,22,21,0,21,30,0,30,0.0,0.0,0.0,0.0,0.0,0.0
Dilated cardiomyopathy with ataxia,28077,11,37,24,2,22,24,1,23,0.05405405405405406,0.02702702702702703,0.08333333333333333,0.05405405405405406,0.041666666666666664,0.02702702702702703
Mitochondrial myopathy with reversible cytochrome C oxidase deficiency,31222,1,24,39,25,14,25,1,24,1.0416666666666667,0.041666666666666664,0.6410256410256411,1.0416666666666667,0.04,0.041666666666666664
Hereditary pulmonary alveolar proteinosis,32659,3,15,16,14,2,26,4,22,0.9333333333333333,0.26666666666666666,0.875,0.9333333333333333,0.15384615384615385,0.26666666666666666
Familial reactive perforating collagenosis,27811,0,20,16,13,3,23,0,23,0.65,0.0,0.8125,0.65,0.0,0.0
Aneurysm-osteoarthritis syndrome,27747,1,51,21,15,6,33,1,32,0.29411764705882354,0.0196078431372549,0.7142857142857143,0.29411764705882354,0.030303030303030304,0.0196078431372549
Peripheral primitive neuroectodermal tumor,96073,4,37,10,0,10,44,5,39,0.0,0.13513513513513514,0.0,0.0,0.11363636363636363,0.13513513513513514
Early-onset seizures-distal limb anomalies-facial dysmorphism-global developmental delay syndrome,29279,1,53,36,26,10,46,5,41,0.49056603773584906,0.09433962264150944,0.7222222222222222,0.49056603773584906,0.10869565217391304,0.09433962264150944
Ramos-Arroyo syndrome,31138,0,46,43,37,6,25,0,25,0.8043478260869565,0.0,0.8604651162790697,0.8043478260869565,0.0,0.0
Neuroleptic malignant syndrome,33454,10,54,23,17,6,20,9,11,0.3148148148148148,0.16666666666666666,0.7391304347826086,0.3148148148148148,0.45,0.16666666666666666
Somatomammotropinoma,33412,2,60,45,44,1,51,10,41,0.7333333333333333,0.16666666666666666,0.9777777777777777,0.7333333333333333,0.19607843137254902,0.16666666666666666
"Hypotrichosis-intellectual disability, Lopes type",33503,14,4,31,4,27,29,1,28,1.0,0.25,0.12903225806451613,1.0,0.034482758620689655,0.25
Pediatric-onset Graves disease,33524,1,48,31,26,5,21,4,17,0.5416666666666666,0.08333333333333333,0.8387096774193549,0.5416666666666666,0.19047619047619047,0.08333333333333333
Autosomal dominant Charcot-Marie-Tooth disease type 2W,29098,2,20,29,18,11,19,2,17,0.9,0.1,0.6206896551724138,0.9,0.10526315789473684,0.1
Autosomal dominant Charcot-Marie-Tooth disease type 2A2,29098,3,45,25,7,18,21,5,16,0.15555555555555556,0.1111111111111111,0.28,0.15555555555555556,0.23809523809523808,0.1111111111111111
Autosomal recessive axonal neuropathy with neuromyotonia,39150,13,47,23,2,21,13,2,11,0.0425531914893617,0.0425531914893617,0.08695652173913043,0.0425531914893617,0.15384615384615385,0.0425531914893617
Ichthyosis-alopecia-eclabion-ectropion-intellectual disability syndrome,27833,7,26,18,17,1,41,8,33,0.6538461538461539,0.3076923076923077,0.9444444444444444,0.6538461538461539,0.1951219512195122,0.3076923076923077
Osteopenia-intellectual disability-sparse hair syndrome,29559,2,22,27,21,6,17,2,15,0.9545454545454546,0.09090909090909091,0.7777777777777778,0.9545454545454546,0.11764705882352941,0.09090909090909091
Dysmorphism-short stature-deafness-difference of sex development syndrome,33495,3,30,17,17,0,39,6,33,0.5666666666666667,0.2,1.0,0.5666666666666667,0.15384615384615385,0.2
Subependymoma,33499,0,15,16,15,1,26,1,25,1.0,0.06666666666666667,0.9375,1.0,0.038461538461538464,0.06666666666666667
Ependymoma,38294,20,15,27,2,25,31,4,27,0.13333333333333333,0.26666666666666666,0.07407407407407407,0.13333333333333333,0.12903225806451613,0.26666666666666666
Lowry-MacLean syndrome,30395,0,52,16,14,2,26,2,24,0.2692307692307692,0.038461538461538464,0.875,0.2692307692307692,0.07692307692307693,0.038461538461538464
Myxopapillary ependymoma,33500,2,12,12,12,0,30,2,28,1.0,0.16666666666666666,1.0,1.0,0.06666666666666667,0.16666666666666666
Marfanoid habitus-autosomal recessive intellectual disability syndrome,29507,2,43,17,13,4,24,4,20,0.3023255813953488,0.09302325581395349,0.7647058823529411,0.3023255813953488,0.16666666666666666,0.09302325581395349
Czeizel-Losonci syndrome,31961,1,34,17,13,4,40,2,38,0.38235294117647056,0.058823529411764705,0.7647058823529411,0.38235294117647056,0.05,0.058823529411764705
Lethal omphalocele-cleft palate syndrome,31149,8,8,21,8,13,33,2,31,1.0,0.25,0.38095238095238093,1.0,0.06060606060606061,0.25
Metaphyseal dysostosis-intellectual disability-conductive deafness syndrome,27873,1,26,16,10,6,26,1,25,0.38461538461538464,0.038461538461538464,0.625,0.38461538461538464,0.038461538461538464,0.038461538461538464
Orofaciodigital syndrome type 2,27672,3,49,31,4,27,43,3,40,0.08163265306122448,0.061224489795918366,0.12903225806451613,0.08163265306122448,0.06976744186046512,0.061224489795918366
Osteoporosis-pseudoglioma syndrome,30174,0,34,17,9,8,33,1,32,0.2647058823529412,0.029411764705882353,0.5294117647058824,0.2647058823529412,0.030303030303030304,0.029411764705882353
Short stature-webbed neck-heart disease syndrome,32604,4,7,24,8,16,28,3,25,1.1428571428571428,0.42857142857142855,0.3333333333333333,1.1428571428571428,0.10714285714285714,0.42857142857142855
Orofaciodigital syndrome type 5,27672,0,27,33,4,29,17,1,16,0.14814814814814814,0.037037037037037035,0.12121212121212122,0.14814814814814814,0.058823529411764705,0.037037037037037035
Oliver syndrome,28654,0,25,18,17,1,24,0,24,0.68,0.0,0.9444444444444444,0.68,0.0,0.0
Preaxial polydactyly-colobomata-intellectual disability syndrome,33280,7,9,30,9,21,30,2,28,1.0,0.2222222222222222,0.3,1.0,0.06666666666666667,0.2222222222222222
Qazi-Markouizos syndrome,32142,0,23,18,12,6,17,0,17,0.5217391304347826,0.0,0.6666666666666666,0.5217391304347826,0.0,0.0
Intellectual disability-balding-patella luxation-acromicria syndrome,29979,1,54,63,54,9,32,0,32,1.0,0.0,0.8571428571428571,1.0,0.0,0.0
Intellectual disability-dysmorphism-hypogonadism-diabetes mellitus syndrome,29562,4,22,28,17,11,26,0,26,0.7727272727272727,0.0,0.6071428571428571,0.7727272727272727,0.0,0.0
Richieri Costa-da Silva syndrome,27732,0,36,18,13,5,33,0,33,0.3611111111111111,0.0,0.7222222222222222,0.3611111111111111,0.0,0.0
Say-Barber-Miller syndrome,29878,0,57,29,23,6,14,0,14,0.40350877192982454,0.0,0.7931034482758621,0.40350877192982454,0.0,0.0
Schinzel-Giedion syndrome,30565,2,92,34,27,7,30,5,25,0.29347826086956524,0.05434782608695652,0.7941176470588235,0.29347826086956524,0.16666666666666666,0.05434782608695652
DOORS syndrome,32136,2,89,104,84,20,24,1,23,0.9438202247191011,0.011235955056179775,0.8076923076923077,0.9438202247191011,0.041666666666666664,0.011235955056179775
Intellectual disability-autism-speech apraxia-craniofacial dysmorphism syndrome,31809,3,19,31,3,28,35,3,32,0.15789473684210525,0.15789473684210525,0.0967741935483871,0.15789473684210525,0.08571428571428572,0.15789473684210525
DNA2-related mitochondrial DNA deletion syndrome,38367,17,21,26,2,24,31,2,29,0.09523809523809523,0.09523809523809523,0.07692307692307693,0.09523809523809523,0.06451612903225806,0.09523809523809523
Progressive external ophthalmoplegia-myopathy-emaciation syndrome,31717,3,32,15,1,14,19,2,17,0.03125,0.0625,0.06666666666666667,0.03125,0.10526315789473684,0.0625
Autosomal dominant mitochondrial myopathy with exercise intolerance,29450,0,13,16,13,3,21,0,21,1.0,0.0,0.8125,1.0,0.0,0.0
Vocal cord and pharyngeal distal myopathy,27806,4,30,26,17,9,24,4,20,0.5666666666666667,0.13333333333333333,0.6538461538461539,0.5666666666666667,0.16666666666666666,0.13333333333333333
Congenital cataract-progressive muscular hypotonia-hearing loss-developmental delay syndrome,29667,16,13,26,3,23,27,2,25,0.23076923076923078,0.15384615384615385,0.11538461538461539,0.23076923076923078,0.07407407407407407,0.15384615384615385
Kyphoscoliosis-lateral tongue atrophy-hereditary spastic paraplegia syndrome,27773,2,22,18,18,0,21,2,19,0.8181818181818182,0.09090909090909091,1.0,0.8181818181818182,0.09523809523809523,0.09090909090909091
Familial dyskinesia and facial myokymia,27719,4,15,16,9,7,23,2,21,0.6,0.13333333333333333,0.5625,0.6,0.08695652173913043,0.13333333333333333
Spastic paraplegia-intellectual disability-nystagmus-obesity syndrome,29703,1,14,18,7,11,24,3,21,0.5,0.21428571428571427,0.3888888888888889,0.5,0.125,0.21428571428571427
Spastic paraplegia-optic atrophy-neuropathy syndrome,29282,8,20,30,2,28,27,2,25,0.1,0.1,0.06666666666666667,0.1,0.07407407407407407,0.1
Cerebellar ataxia with neuropathy and bilateral vestibular areflexia syndrome,32643,4,16,17,15,2,22,3,19,0.9375,0.1875,0.8823529411764706,0.9375,0.13636363636363635,0.1875
Spastic paraplegia-precocious puberty syndrome,31892,6,6,19,5,14,29,0,29,0.8333333333333334,0.0,0.2631578947368421,0.8333333333333334,0.0,0.0
Early-onset progressive encephalopathy-spastic ataxia-distal spinal muscular atrophy syndrome,27801,1,24,18,18,0,25,2,23,0.75,0.08333333333333333,1.0,0.75,0.08,0.08333333333333333
Autosomal recessive spinocerebellar ataxia-blindness-deafness syndrome,27662,3,19,28,4,24,5,1,4,0.21052631578947367,0.05263157894736842,0.14285714285714285,0.21052631578947367,0.2,0.05263157894736842
Sandifer syndrome,33361,5,13,19,9,10,26,1,25,0.6923076923076923,0.07692307692307693,0.47368421052631576,0.6923076923076923,0.038461538461538464,0.07692307692307693
Autosomal recessive cerebellar ataxia-pyramidal signs-nystagmus-oculomotor apraxia syndrome,27757,1,32,19,20,-1,6,2,4,0.625,0.0625,1.0526315789473684,0.625,0.3333333333333333,0.0625
APC-related attenuated familial adenomatous polyposis,29041,0,25,18,8,10,20,1,19,0.32,0.04,0.4444444444444444,0.32,0.05,0.04
MUTYH-related attenuated familial adenomatous polyposis,27714,0,7,17,2,15,20,1,19,0.2857142857142857,0.14285714285714285,0.11764705882352941,0.2857142857142857,0.05,0.14285714285714285
Attenuated familial adenomatous polyposis,27714,0,14,24,6,18,23,0,23,0.42857142857142855,0.0,0.25,0.42857142857142855,0.0,0.0
Serrated polyposis syndrome,100017,15,14,21,0,21,18,0,18,0.0,0.0,0.0,0.0,0.0,0.0
Male infertility due to acephalic spermatozoa,29505,5,7,15,1,14,24,1,23,0.14285714285714285,0.14285714285714285,0.06666666666666667,0.14285714285714285,0.041666666666666664,0.14285714285714285
Familial adenomatous polyposis due to 5q22.2 microdeletion,32693,1,35,31,31,0,23,1,22,0.8857142857142857,0.02857142857142857,1.0,0.8857142857142857,0.043478260869565216,0.02857142857142857
Primary erythromelalgia,38272,18,14,24,1,23,27,1,26,0.07142857142857142,0.07142857142857142,0.041666666666666664,0.07142857142857142,0.037037037037037035,0.07142857142857142
Hereditary mixed polyposis syndrome,30215,13,18,27,8,19,24,2,22,0.4444444444444444,0.1111111111111111,0.2962962962962963,0.4444444444444444,0.08333333333333333,0.1111111111111111
Polymerase proofreading-related adenomatous polyposis,33525,2,7,7,0,7,28,1,27,0.0,0.14285714285714285,0.0,0.0,0.03571428571428571,0.14285714285714285
AXIN2-related attenuated familial adenomatous polyposis,29041,0,7,22,1,21,20,1,19,0.14285714285714285,0.14285714285714285,0.045454545454545456,0.14285714285714285,0.05,0.14285714285714285
NTHL1-related attenuated familial adenomatous polyposis,29041,0,15,18,2,16,24,0,24,0.13333333333333333,0.0,0.1111111111111111,0.13333333333333333,0.0,0.0
MSH3-related attenuated familial adenomatous polyposis,27714,1,14,17,6,11,24,2,22,0.42857142857142855,0.14285714285714285,0.35294117647058826,0.42857142857142855,0.08333333333333333,0.14285714285714285
Laing distal myopathy,28689,4,20,17,4,13,25,1,24,0.2,0.05,0.23529411764705882,0.2,0.04,0.05
Distal anoctaminopathy,29778,0,13,9,0,9,33,2,31,0.0,0.15384615384615385,0.0,0.0,0.06060606060606061,0.15384615384615385
Distal myotilinopathy,27323,4,15,25,2,23,22,4,18,0.13333333333333333,0.26666666666666666,0.08,0.13333333333333333,0.18181818181818182,0.26666666666666666
Mitochondrial myopathy-cerebellar ataxia-pigmentary retinopathy syndrome,28118,6,47,18,6,12,27,3,24,0.1276595744680851,0.06382978723404255,0.3333333333333333,0.1276595744680851,0.1111111111111111,0.06382978723404255
Mitochondrial DNA-related progressive external ophthalmoplegia,32694,7,17,34,3,31,28,3,25,0.17647058823529413,0.17647058823529413,0.08823529411764706,0.17647058823529413,0.10714285714285714,0.17647058823529413
Neutral lipid storage disease with myopathy,31602,3,39,32,24,8,23,0,23,0.6153846153846154,0.0,0.75,0.6153846153846154,0.0,0.0
"Mitochondrial DNA depletion syndrome, myopathic form",27802,3,39,17,13,4,28,9,19,0.3333333333333333,0.23076923076923078,0.7647058823529411,0.3333333333333333,0.32142857142857145,0.23076923076923078
Sensory ataxic neuropathy-dysarthria-ophthalmoparesis syndrome,31935,2,31,24,21,3,21,5,16,0.6774193548387096,0.16129032258064516,0.875,0.6774193548387096,0.23809523809523808,0.16129032258064516
Mitochondrial trifunctional protein deficiency,29972,2,46,18,15,3,26,7,19,0.32608695652173914,0.15217391304347827,0.8333333333333334,0.32608695652173914,0.2692307692307692,0.15217391304347827
Distal nebulin myopathy,32689,0,16,16,16,0,23,0,23,1.0,0.0,1.0,1.0,0.0,0.0
Adult-onset distal myopathy due to VCP mutation,27733,3,30,24,23,1,26,7,19,0.7666666666666667,0.23333333333333334,0.9583333333333334,0.7666666666666667,0.2692307692307692,0.23333333333333334
Peripheral neuropathy-myopathy-hoarseness-hearing loss syndrome,27792,1,21,18,13,5,32,1,31,0.6190476190476191,0.047619047619047616,0.7222222222222222,0.6190476190476191,0.03125,0.047619047619047616
KLHL9-related early-onset distal myopathy,32448,7,17,32,17,15,24,0,24,1.0,0.0,0.53125,1.0,0.0,0.0
Finnish upper limb-onset distal myopathy,27678,1,16,18,13,5,23,1,22,0.8125,0.0625,0.7222222222222222,0.8125,0.043478260869565216,0.0625
"Distal myopathy, Tateyama type",27717,1,18,22,17,5,24,1,23,0.9444444444444444,0.05555555555555555,0.7727272727272727,0.9444444444444444,0.041666666666666664,0.05555555555555555
Distal myopathy with anterior tibial onset,27323,1,13,23,4,19,19,1,18,0.3076923076923077,0.07692307692307693,0.17391304347826086,0.3076923076923077,0.05263157894736842,0.07692307692307693
9q21.13 microdeletion syndrome,32429,5,24,99,9,90,25,2,23,0.375,0.08333333333333333,0.09090909090909091,0.375,0.08,0.08333333333333333
Ocular anomalies-axonal neuropathy-developmental delay syndrome,33527,2,36,25,7,18,32,3,29,0.19444444444444445,0.08333333333333333,0.28,0.19444444444444445,0.09375,0.08333333333333333
Cortical dysgenesis with pontocerebellar hypoplasia due to TUBB3 mutation,27716,7,79,25,7,18,30,2,28,0.08860759493670886,0.02531645569620253,0.28,0.08860759493670886,0.06666666666666667,0.02531645569620253
Multiple congenital anomalies-hypotonia-seizures syndrome,30436,1,86,17,5,12,27,0,27,0.05813953488372093,0.0,0.29411764705882354,0.05813953488372093,0.0,0.0
Limb-mammary syndrome,31471,0,32,31,30,1,17,0,17,0.9375,0.0,0.967741935483871,0.9375,0.0,0.0
Non-specific early-onset epileptic encephalopathy,33095,3,48,18,19,-1,29,6,23,0.3958333333333333,0.125,1.0555555555555556,0.3958333333333333,0.20689655172413793,0.125
Autosomal dominant spastic paraplegia type 9B,38455,15,21,23,0,23,24,0,24,0.0,0.0,0.0,0.0,0.0,0.0
Lethal infantile mitochondrial myopathy,31987,3,11,18,11,7,25,0,25,1.0,0.0,0.6111111111111112,1.0,0.0,0.0
Myopathy and diabetes mellitus,31234,4,32,21,12,9,26,2,24,0.375,0.0625,0.5714285714285714,0.375,0.07692307692307693,0.0625
KBG syndrome,27930,0,40,42,34,8,20,0,20,0.85,0.0,0.8095238095238095,0.85,0.0,0.0
Maternal phenylketonuria,31918,0,32,20,7,13,4,0,4,0.21875,0.0,0.35,0.21875,0.0,0.0
Neutral lipid storage disease with ichthyosis,38786,17,32,32,1,31,24,1,23,0.03125,0.03125,0.03125,0.03125,0.041666666666666664,0.03125
Adult-onset multiple mitochondrial DNA deletion syndrome due to DGUOK deficiency,31398,2,21,18,11,7,31,3,28,0.5238095238095238,0.14285714285714285,0.6111111111111112,0.5238095238095238,0.0967741935483871,0.14285714285714285
Pure mitochondrial myopathy,33309,3,33,18,18,0,29,2,27,0.5454545454545454,0.06060606060606061,1.0,0.5454545454545454,0.06896551724137931,0.06060606060606061
Adult-onset chronic progressive external ophthalmoplegia with mitochondrial myopathy,32694,1,32,22,22,0,26,1,25,0.6875,0.03125,1.0,0.6875,0.038461538461538464,0.03125
Self-limited childhood occipital epilepsy,32153,3,6,17,6,11,17,1,16,1.0,0.16666666666666666,0.35294117647058826,1.0,0.058823529411764705,0.16666666666666666
Non-24-hour sleep-wake syndrome,32227,4,5,22,3,19,8,1,7,0.6,0.2,0.13636363636363635,0.6,0.125,0.2
Pyridoxal phosphate-responsive seizures,30591,0,29,31,22,9,26,1,25,0.7586206896551724,0.034482758620689655,0.7096774193548387,0.7586206896551724,0.038461538461538464,0.034482758620689655
Hydroxykynureninuria,27816,0,17,17,12,5,27,0,27,0.7058823529411765,0.0,0.7058823529411765,0.7058823529411765,0.0,0.0
Paraparetic variant of Guillain-Barré syndrome,27775,11,10,22,7,15,25,1,24,0.7,0.1,0.3181818181818182,0.7,0.04,0.1
Trigeminal neuralgia,30449,3,17,21,14,7,22,4,18,0.8235294117647058,0.23529411764705882,0.6666666666666666,0.8235294117647058,0.18181818181818182,0.23529411764705882
Complex regional pain syndrome,32316,4,12,19,10,9,22,2,20,0.8333333333333334,0.16666666666666666,0.5263157894736842,0.8333333333333334,0.09090909090909091,0.16666666666666666
Oculoauriculofrontonasal syndrome,33175,1,22,17,18,-1,34,3,31,0.8181818181818182,0.13636363636363635,1.0588235294117647,0.8181818181818182,0.08823529411764706,0.13636363636363635
Craniofrontonasal dysplasia-Poland anomaly syndrome,32403,5,26,21,19,2,31,3,28,0.7307692307692307,0.11538461538461539,0.9047619047619048,0.7307692307692307,0.0967741935483871,0.11538461538461539
Frontonasal dysplasia-severe microphthalmia-severe facial clefting syndrome,29916,4,29,27,24,3,27,6,21,0.8275862068965517,0.20689655172413793,0.8888888888888888,0.8275862068965517,0.2222222222222222,0.20689655172413793
Chronic hiccup,32174,0,8,24,5,19,14,1,13,0.625,0.125,0.20833333333333334,0.625,0.07142857142857142,0.125
Polyneuropathy associated with IgM monoclonal gammopathy with anti-MAG,32591,2,9,18,3,15,26,0,26,0.3333333333333333,0.0,0.16666666666666666,0.3333333333333333,0.0,0.0
SIX2-related frontonasal dysplasia,27673,0,22,16,16,0,17,0,17,0.7272727272727273,0.0,1.0,0.7272727272727273,0.0,0.0
Intellectual disability-hyperkinetic movement-truncal ataxia syndrome,38229,1,20,18,3,15,3,0,3,0.15,0.0,0.16666666666666666,0.15,0.0,0.0
Primary angiitis of the central nervous system,99173,17,30,32,10,22,27,8,19,0.3333333333333333,0.26666666666666666,0.3125,0.3333333333333333,0.2962962962962963,0.26666666666666666
"Primary dystonia, DYT2 type",27743,8,10,35,6,29,33,4,29,0.6,0.4,0.17142857142857143,0.6,0.12121212121212122,0.4
Rapid-onset dystonia-parkinsonism,31408,1,20,16,4,12,27,4,23,0.2,0.2,0.25,0.2,0.14814814814814814,0.2
Autosomal recessive spastic paraplegia type 78,27668,1,28,16,7,9,29,3,26,0.25,0.10714285714285714,0.4375,0.25,0.10344827586206896,0.10714285714285714
Spinocerebellar ataxia with axonal neuropathy type 1,27662,3,20,30,10,20,15,3,12,0.5,0.15,0.3333333333333333,0.5,0.2,0.15
Frontotemporal dementia with motor neuron disease,32696,0,35,32,31,1,16,1,15,0.8857142857142857,0.02857142857142857,0.96875,0.8857142857142857,0.0625,0.02857142857142857
Childhood disintegrative disorder,32809,4,16,16,15,1,32,5,27,0.9375,0.3125,0.9375,0.9375,0.15625,0.3125
Aminoacylase 1 deficiency,28711,1,13,18,11,7,25,0,25,0.8461538461538461,0.0,0.6111111111111112,0.8461538461538461,0.0,0.0
Acute inflammatory demyelinating polyradiculoneuropathy,36915,16,13,23,0,23,27,0,27,0.0,0.0,0.0,0.0,0.0,0.0
Axonal polyneuropathy associated with IgG/IgM/IgA monoclonal gammopathy,32591,1,12,17,12,5,28,0,28,1.0,0.0,0.7058823529411765,1.0,0.0,0.0
Autosomal dominant spastic paraplegia type 9A,38455,12,34,18,3,15,26,3,23,0.08823529411764706,0.08823529411764706,0.16666666666666666,0.08823529411764706,0.11538461538461539,0.08823529411764706
Adult-onset nemaline myopathy,27294,5,29,24,6,18,21,4,17,0.20689655172413793,0.13793103448275862,0.25,0.20689655172413793,0.19047619047619047,0.13793103448275862
Childhood-onset nemaline myopathy,27294,4,46,104,41,63,18,1,17,0.8913043478260869,0.021739130434782608,0.3942307692307692,0.8913043478260869,0.05555555555555555,0.021739130434782608
"Primary dystonia, DYT27 type",27743,9,8,68,4,64,32,1,31,0.5,0.125,0.058823529411764705,0.5,0.03125,0.125
"Adult-onset cervical dystonia, DYT23 type",27743,5,17,28,7,21,33,3,30,0.4117647058823529,0.17647058823529413,0.25,0.4117647058823529,0.09090909090909091,0.17647058823529413
"Primary dystonia, DYT17 type",27743,5,7,64,5,59,26,0,26,0.7142857142857143,0.0,0.078125,0.7142857142857143,0.0,0.0
Autosomal recessive spastic paraplegia type 59,27668,0,11,15,6,9,32,0,32,0.5454545454545454,0.0,0.4,0.5454545454545454,0.0,0.0
Autosomal recessive spastic paraplegia type 60,38455,11,9,32,2,30,24,1,23,0.2222222222222222,0.1111111111111111,0.0625,0.2222222222222222,0.041666666666666664,0.1111111111111111
Autosomal recessive spastic paraplegia type 66,27668,1,14,20,4,16,39,2,37,0.2857142857142857,0.14285714285714285,0.2,0.2857142857142857,0.05128205128205128,0.14285714285714285
Autosomal recessive spastic paraplegia type 67,27668,1,15,15,4,11,35,3,32,0.26666666666666666,0.2,0.26666666666666666,0.26666666666666666,0.08571428571428572,0.2
Infantile-onset generalized dyskinesia with orofacial involvement,27706,11,13,21,10,11,35,3,32,0.7692307692307693,0.23076923076923078,0.47619047619047616,0.7692307692307693,0.08571428571428572,0.23076923076923078
Postnatal microcephaly-infantile hypotonia-spastic diplegia-dysarthria-intellectual disability syndrome,28602,3,22,36,5,31,28,4,24,0.22727272727272727,0.18181818181818182,0.1388888888888889,0.22727272727272727,0.14285714285714285,0.18181818181818182
Spastic paraplegia-severe developmental delay-epilepsy syndrome,27808,6,40,22,17,5,39,8,31,0.425,0.2,0.7727272727272727,0.425,0.20512820512820512,0.2
Huntington disease-like syndrome due to C9ORF72 expansions,38307,6,14,20,3,17,22,6,16,0.21428571428571427,0.42857142857142855,0.15,0.21428571428571427,0.2727272727272727,0.42857142857142855
MT-ATP6-related mitochondrial spastic paraplegia,27777,3,17,23,15,8,24,0,24,0.8823529411764706,0.0,0.6521739130434783,0.8823529411764706,0.0,0.0
Autosomal recessive spastic paraplegia type 74,27668,1,19,16,2,14,39,3,36,0.10526315789473684,0.15789473684210525,0.125,0.10526315789473684,0.07692307692307693,0.15789473684210525
Machado-Joseph disease type 2,29334,5,34,20,14,6,26,5,21,0.4117647058823529,0.14705882352941177,0.7,0.4117647058823529,0.19230769230769232,0.14705882352941177
Machado-Joseph disease type 1,29334,6,34,28,19,9,23,5,18,0.5588235294117647,0.14705882352941177,0.6785714285714286,0.5588235294117647,0.21739130434782608,0.14705882352941177
Machado-Joseph disease type 3,29334,4,38,17,14,3,21,5,16,0.3684210526315789,0.13157894736842105,0.8235294117647058,0.3684210526315789,0.23809523809523808,0.13157894736842105
Auriculocondylar syndrome,30422,1,34,48,33,15,32,1,31,0.9705882352941176,0.029411764705882353,0.6875,0.9705882352941176,0.03125,0.029411764705882353
Congenital cerebellar ataxia due to RNU12 mutation,27794,3,17,19,14,5,14,4,10,0.8235294117647058,0.23529411764705882,0.7368421052631579,0.8235294117647058,0.2857142857142857,0.23529411764705882
Frontonasal dysplasia-bifid nose-upper limb anomalies syndrome,28884,2,22,38,3,35,33,2,31,0.13636363636363635,0.09090909090909091,0.07894736842105263,0.13636363636363635,0.06060606060606061,0.09090909090909091
Autosomal recessive spastic paraplegia type 69,27668,1,13,16,4,12,32,1,31,0.3076923076923077,0.07692307692307693,0.25,0.3076923076923077,0.03125,0.07692307692307693
Autosomal recessive spastic paraplegia type 71,27668,2,13,18,5,13,19,2,17,0.38461538461538464,0.15384615384615385,0.2777777777777778,0.38461538461538464,0.10526315789473684,0.15384615384615385
Autosomal recessive spastic paraplegia type 70,27668,1,10,16,3,13,34,2,32,0.3,0.2,0.1875,0.3,0.058823529411764705,0.2
Severe intellectual disability and progressive spastic paraplegia,30156,3,37,24,4,20,39,5,34,0.10810810810810811,0.13513513513513514,0.16666666666666666,0.10810810810810811,0.1282051282051282,0.13513513513513514
Autosomal recessive cerebellar ataxia with late-onset spasticity,27739,2,26,25,24,1,11,3,8,0.9230769230769231,0.11538461538461539,0.96,0.9230769230769231,0.2727272727272727,0.11538461538461539
Huntington disease-like 3,38307,17,22,19,2,17,22,3,19,0.09090909090909091,0.13636363636363635,0.10526315789473684,0.09090909090909091,0.13636363636363635,0.13636363636363635
HSD10 disease,27938,0,37,16,7,9,41,0,41,0.1891891891891892,0.0,0.4375,0.1891891891891892,0.0,0.0
X-linked intellectual disability due to GRIA3 mutations,33312,1,57,23,20,3,28,1,27,0.3508771929824561,0.017543859649122806,0.8695652173913043,0.3508771929824561,0.03571428571428571,0.017543859649122806
Macrocephaly-intellectual disability-left ventricular non compaction syndrome,29116,5,77,17,4,13,27,0,27,0.05194805194805195,0.0,0.23529411764705882,0.05194805194805195,0.0,0.0
X-linked female restricted facial dysmorphism-short stature-choanal atresia-intellectual disability,32853,4,90,33,34,-1,27,4,23,0.37777777777777777,0.044444444444444446,1.0303030303030303,0.37777777777777777,0.14814814814814814,0.044444444444444446
X-linked myotubular myopathy-abnormal genitalia syndrome,32835,4,15,21,13,8,24,2,22,0.8666666666666667,0.13333333333333333,0.6190476190476191,0.8666666666666667,0.08333333333333333,0.13333333333333333
X-linked intellectual disability-short stature-overweight syndrome,30178,4,37,18,10,8,28,3,25,0.2702702702702703,0.08108108108108109,0.5555555555555556,0.2702702702702703,0.10714285714285714,0.08108108108108109
Brachydactyly-short stature-retinitis pigmentosa syndrome,31265,3,46,40,30,10,39,6,33,0.6521739130434783,0.13043478260869565,0.75,0.6521739130434783,0.15384615384615385,0.13043478260869565
Hereditary cryohydrocytosis with reduced stomatin,29949,1,32,19,13,6,30,1,29,0.40625,0.03125,0.6842105263157895,0.40625,0.03333333333333333,0.03125
X-linked intellectual disability-global development delay-facial dysmorphism-sacral caudal remnant syndrome,32787,3,45,39,39,0,41,4,37,0.8666666666666667,0.08888888888888889,1.0,0.8666666666666667,0.0975609756097561,0.08888888888888889
CLCN4-related X-linked intellectual disability syndrome,33420,0,45,38,37,1,31,1,30,0.8222222222222222,0.022222222222222223,0.9736842105263158,0.8222222222222222,0.03225806451612903,0.022222222222222223
Guanidinoacetate methyltransferase deficiency,32145,1,22,18,14,4,30,1,29,0.6363636363636364,0.045454545454545456,0.7777777777777778,0.6363636363636364,0.03333333333333333,0.045454545454545456
Leukoencephalopathy with brain stem and spinal cord involvement-high lactate syndrome,28274,9,50,55,50,5,29,10,19,1.0,0.2,0.9090909090909091,1.0,0.3448275862068966,0.2
Microcephaly-polymicrogyria-corpus callosum agenesis syndrome,32467,12,7,21,6,15,27,1,26,0.8571428571428571,0.14285714285714285,0.2857142857142857,0.8571428571428571,0.037037037037037035,0.14285714285714285
Early-onset X-linked optic atrophy,27348,2,17,23,10,13,19,2,17,0.5882352941176471,0.11764705882352941,0.43478260869565216,0.5882352941176471,0.10526315789473684,0.11764705882352941
"X-linked intellectual disability, Stoll type",28944,4,12,22,2,20,23,2,21,0.16666666666666666,0.16666666666666666,0.09090909090909091,0.16666666666666666,0.08695652173913043,0.16666666666666666
"X-linked intellectual disability, Seemanova type",28041,1,16,17,1,16,25,1,24,0.0625,0.0625,0.058823529411764705,0.0625,0.04,0.0625
X-linked intellectual disability-craniofacioskeletal syndrome,29870,5,48,55,42,13,33,5,28,0.875,0.10416666666666667,0.7636363636363637,0.875,0.15151515151515152,0.10416666666666667
X-linked cerebral-cerebellar-coloboma syndrome,31423,3,31,37,29,8,36,4,32,0.9354838709677419,0.12903225806451613,0.7837837837837838,0.9354838709677419,0.1111111111111111,0.12903225806451613
Rolandic epilepsy-speech dyspraxia syndrome,31036,4,18,30,19,11,28,3,25,1.0555555555555556,0.16666666666666666,0.6333333333333333,1.0555555555555556,0.10714285714285714,0.16666666666666666
X-linked intellectual disability-limb spasticity-retinal dystrophy-arginine vasopressin deficiency,33463,5,35,19,2,17,37,1,36,0.05714285714285714,0.02857142857142857,0.10526315789473684,0.05714285714285714,0.02702702702702703,0.02857142857142857
Pontocerebellar hypoplasia type 4,27716,2,14,22,2,20,23,0,23,0.14285714285714285,0.0,0.09090909090909091,0.14285714285714285,0.0,0.0
Native American myopathy,30258,1,34,29,24,5,13,1,12,0.7058823529411765,0.029411764705882353,0.8275862068965517,0.7058823529411765,0.07692307692307693,0.029411764705882353
Combined oxidative phosphorylation defect type 13,38594,12,33,24,1,23,18,3,15,0.030303030303030304,0.09090909090909091,0.041666666666666664,0.030303030303030304,0.16666666666666666,0.09090909090909091
Severe intellectual disability-poor language-strabismus-grimacing face-long fingers syndrome,29425,4,48,50,43,7,34,3,31,0.8958333333333334,0.0625,0.86,0.8958333333333334,0.08823529411764706,0.0625
Intellectual disability-facial dysmorphism syndrome due to SETD5 haploinsufficiency,29365,2,52,19,18,1,37,3,34,0.34615384615384615,0.057692307692307696,0.9473684210526315,0.34615384615384615,0.08108108108108109,0.057692307692307696
SLC35A2-CDG,29977,0,74,17,2,15,21,0,21,0.02702702702702703,0.0,0.11764705882352941,0.02702702702702703,0.0,0.0
Medium chain acyl-CoA dehydrogenase deficiency,38510,15,37,27,5,22,27,4,23,0.13513513513513514,0.10810810810810811,0.18518518518518517,0.13513513513513514,0.14814814814814814,0.10810810810810811
Dysferlin-related limb-girdle muscular dystrophy R2,27315,9,29,31,5,26,25,3,22,0.1724137931034483,0.10344827586206896,0.16129032258064516,0.1724137931034483,0.12,0.10344827586206896
Very long chain acyl-CoA dehydrogenase deficiency,38510,19,40,29,0,29,36,0,36,0.0,0.0,0.0,0.0,0.0,0.0
Tenosynovial giant cell tumor,36638,18,24,28,5,23,27,5,22,0.20833333333333334,0.20833333333333334,0.17857142857142858,0.20833333333333334,0.18518518518518517,0.20833333333333334
Young-onset Parkinson disease,28547,7,34,20,9,11,20,8,12,0.2647058823529412,0.23529411764705882,0.45,0.2647058823529412,0.4,0.23529411764705882
"X-linked intellectual disability, Schimke type",28944,2,26,22,4,18,32,2,30,0.15384615384615385,0.07692307692307693,0.18181818181818182,0.15384615384615385,0.0625,0.07692307692307693
"X-linked intellectual disability, Stocco Dos Santos type",28859,0,17,21,16,5,17,0,17,0.9411764705882353,0.0,0.7619047619047619,0.9411764705882353,0.0,0.0
"X-linked intellectual disability, Wilson type",27603,1,16,26,3,23,23,0,23,0.1875,0.0,0.11538461538461539,0.1875,0.0,0.0
Early-onset progressive diffuse brain atrophy-microcephaly-muscle weakness-optic atrophy syndrome,28546,5,56,62,43,19,24,5,19,0.7678571428571429,0.08928571428571429,0.6935483870967742,0.7678571428571429,0.20833333333333334,0.08928571428571429
Micrognathia-recurrent infections-behavioral abnormalities-mild intellectual disability syndrome,31611,3,55,17,9,8,30,4,26,0.16363636363636364,0.07272727272727272,0.5294117647058824,0.16363636363636364,0.13333333333333333,0.07272727272727272
Alacrimia-choreoathetosis-liver dysfunction syndrome,28661,1,91,45,4,41,36,3,33,0.04395604395604396,0.03296703296703297,0.08888888888888889,0.04395604395604396,0.08333333333333333,0.03296703296703297
ADNP syndrome,29661,4,80,98,71,27,45,4,41,0.8875,0.05,0.7244897959183674,0.8875,0.08888888888888889,0.05
TARP syndrome,30719,1,55,48,41,7,23,1,22,0.7454545454545455,0.01818181818181818,0.8541666666666666,0.7454545454545455,0.043478260869565216,0.01818181818181818
Tatton-Brown-Rahman syndrome,29516,1,40,20,2,18,30,0,30,0.05,0.0,0.1,0.05,0.0,0.0
Juvenile nasopharyngeal angiofibroma,32610,7,8,16,5,11,34,2,32,0.625,0.25,0.3125,0.625,0.058823529411764705,0.25
Malan overgrowth syndrome,31787,1,38,41,32,9,43,1,42,0.8421052631578947,0.02631578947368421,0.7804878048780488,0.8421052631578947,0.023255813953488372,0.02631578947368421
Birk-Barel syndrome,29256,0,33,38,27,11,30,0,30,0.8181818181818182,0.0,0.7105263157894737,0.8181818181818182,0.0,0.0
Pontocerebellar hypoplasia type 7,27907,2,37,17,7,10,16,4,12,0.1891891891891892,0.10810810810810811,0.4117647058823529,0.1891891891891892,0.25,0.10810810810810811
Isolated childhood apraxia of speech,30522,3,23,17,15,2,8,3,5,0.6521739130434783,0.13043478260869565,0.8823529411764706,0.6521739130434783,0.375,0.13043478260869565
Early infantile epileptic encephalopathy,28025,2,63,17,8,9,29,5,24,0.12698412698412698,0.07936507936507936,0.47058823529411764,0.12698412698412698,0.1724137931034483,0.07936507936507936
Genetic epilepsy with febrile seizure plus,33026,4,28,21,2,19,15,0,15,0.07142857142857142,0.0,0.09523809523809523,0.07142857142857142,0.0,0.0
Intermediate uveitis,33511,3,18,18,17,1,32,2,30,0.9444444444444444,0.1111111111111111,0.9444444444444444,0.9444444444444444,0.0625,0.1111111111111111
Citrullinemia type II,31702,5,46,17,7,10,31,1,30,0.15217391304347827,0.021739130434782608,0.4117647058823529,0.15217391304347827,0.03225806451612903,0.021739130434782608
Pancreatic triacylglycerol lipase deficiency,28401,6,21,17,15,2,27,7,20,0.7142857142857143,0.3333333333333333,0.8823529411764706,0.7142857142857143,0.25925925925925924,0.3333333333333333
Apparent mineralocorticoid excess,27657,4,17,17,13,4,22,5,17,0.7647058823529411,0.29411764705882354,0.7647058823529411,0.7647058823529411,0.22727272727272727,0.29411764705882354
Citrullinemia type I,31702,5,28,17,3,14,23,0,23,0.10714285714285714,0.0,0.17647058823529413,0.10714285714285714,0.0,0.0
DYRK1A-related intellectual disability syndrome,33278,2,73,22,14,8,27,5,22,0.1917808219178082,0.0684931506849315,0.6363636363636364,0.1917808219178082,0.18518518518518517,0.0684931506849315
Microcephaly-corpus callosum and cerebellar vermis hypoplasia-facial dysmorphism-intellectual disability syndrom,29190,2,50,17,7,10,28,4,24,0.14,0.08,0.4117647058823529,0.14,0.14285714285714285,0.08
Severe intellectual disability-progressive spastic diplegia syndrome,28602,3,32,37,24,13,33,5,28,0.75,0.15625,0.6486486486486487,0.75,0.15151515151515152,0.15625
Idiopathic panuveitis,33531,4,19,18,20,-2,20,6,14,1.0526315789473684,0.3157894736842105,1.1111111111111112,1.0526315789473684,0.3,0.3157894736842105
Macrocephaly-intellectual disability-neurodevelopmental disorder-small thorax syndrome,29678,3,45,36,24,12,31,4,27,0.5333333333333333,0.08888888888888889,0.6666666666666666,0.5333333333333333,0.12903225806451613,0.08888888888888889
Early-onset familial hypoaldosteronism,33456,1,16,16,6,10,31,1,30,0.375,0.0625,0.375,0.375,0.03225806451612903,0.0625
Late-onset familial hypoaldosteronism,33456,0,14,16,6,10,20,1,19,0.42857142857142855,0.07142857142857142,0.375,0.42857142857142855,0.05,0.07142857142857142
Congenital total pulmonary venous return anomaly,30720,4,40,22,17,5,30,6,24,0.425,0.15,0.7727272727272727,0.425,0.2,0.15
Posterior urethral valve,32917,5,22,17,19,-2,34,7,27,0.8636363636363636,0.3181818181818182,1.1176470588235294,0.8636363636363636,0.20588235294117646,0.3181818181818182
Infantile osteopetrosis with neuroaxonal dysplasia,31119,1,15,16,12,4,30,1,29,0.8,0.06666666666666667,0.75,0.8,0.03333333333333333,0.06666666666666667
Polyembryoma,33007,2,19,17,17,0,30,3,27,0.8947368421052632,0.15789473684210525,1.0,0.8947368421052632,0.1,0.15789473684210525
Asherman syndrome,29997,0,11,36,0,36,20,4,16,0.0,0.36363636363636365,0.0,0.0,0.2,0.36363636363636365
Cleft lip and alveolus,33455,0,12,16,12,4,27,1,26,1.0,0.08333333333333333,0.75,1.0,0.037037037037037035,0.08333333333333333
Airway infantile hemangioma,95135,19,13,26,7,19,27,7,20,0.5384615384615384,0.5384615384615384,0.2692307692307692,0.5384615384615384,0.25925925925925924,0.5384615384615384
Idiopathic intracranial hypertension,38066,15,21,18,3,15,19,3,16,0.14285714285714285,0.14285714285714285,0.16666666666666666,0.14285714285714285,0.15789473684210525,0.14285714285714285
Intermediate osteopetrosis,38358,12,23,24,4,20,24,5,19,0.17391304347826086,0.21739130434782608,0.16666666666666666,0.17391304347826086,0.20833333333333334,0.21739130434782608
Cleft lip/palate,28138,2,21,20,5,15,20,1,19,0.23809523809523808,0.047619047619047616,0.25,0.23809523809523808,0.05,0.047619047619047616
Idiopathic uveal effusion syndrome,27683,6,14,18,12,6,24,3,21,0.8571428571428571,0.21428571428571427,0.6666666666666666,0.8571428571428571,0.125,0.21428571428571427
Isolated cleft lip,32177,0,19,16,14,2,31,1,30,0.7368421052631579,0.05263157894736842,0.875,0.7368421052631579,0.03225806451612903,0.05263157894736842
Neurotrophic keratopathy,32879,7,15,17,11,6,20,5,15,0.7333333333333333,0.3333333333333333,0.6470588235294118,0.7333333333333333,0.25,0.3333333333333333
Cleft velum,30842,3,13,22,10,12,16,0,16,0.7692307692307693,0.0,0.45454545454545453,0.7692307692307693,0.0,0.0
Panner disease,32475,0,11,14,12,2,21,0,21,1.0909090909090908,0.0,0.8571428571428571,1.0909090909090908,0.0,0.0
Pediatric systemic lupus erythematosus,33534,4,53,17,17,0,25,9,16,0.32075471698113206,0.16981132075471697,1.0,0.32075471698113206,0.36,0.16981132075471697
Secondary short bowel syndrome,32322,3,32,17,17,0,22,6,16,0.53125,0.1875,1.0,0.53125,0.2727272727272727,0.1875
Eisenmenger syndrome,32244,1,58,17,17,0,25,10,15,0.29310344827586204,0.1724137931034483,1.0,0.29310344827586204,0.4,0.1724137931034483
Osgood-Schlatter disease,32476,4,8,19,8,11,16,3,13,1.0,0.375,0.42105263157894735,1.0,0.1875,0.375
Sinding-Larsen-Johansson disease,32478,2,5,7,5,2,12,1,11,1.0,0.2,0.7142857142857143,1.0,0.08333333333333333,0.2
Severe acute respiratory syndrome,33390,5,16,18,16,2,20,4,16,1.0,0.25,0.8888888888888888,1.0,0.2,0.25
Congenital tracheal stenosis,32205,4,36,23,24,-1,26,5,21,0.6666666666666666,0.1388888888888889,1.0434782608695652,0.6666666666666666,0.19230769230769232,0.1388888888888889
Dietary iron overload disease,29761,1,25,27,22,5,29,2,27,0.88,0.08,0.8148148148148148,0.88,0.06896551724137931,0.08
Choanal atresia,32224,8,16,20,12,8,34,4,30,0.75,0.25,0.6,0.75,0.11764705882352941,0.25
Esophageal atresia,33615,12,60,22,6,16,35,8,27,0.1,0.13333333333333333,0.2727272727272727,0.1,0.22857142857142856,0.13333333333333333
Solitary fibrous tumor,33355,2,29,28,23,5,27,3,24,0.7931034482758621,0.10344827586206896,0.8214285714285714,0.7931034482758621,0.1111111111111111,0.10344827586206896
Psoriasis-related juvenile idiopathic arthritis,32727,4,29,16,15,1,33,11,22,0.5172413793103449,0.3793103448275862,0.9375,0.5172413793103449,0.3333333333333333,0.3793103448275862
Solitary bone cyst,32308,1,17,17,16,1,30,1,29,0.9411764705882353,0.058823529411764705,0.9411764705882353,0.9411764705882353,0.03333333333333333,0.058823529411764705
Familial avascular necrosis of femoral head,32914,6,9,13,8,5,15,3,12,0.8888888888888888,0.3333333333333333,0.6153846153846154,0.8888888888888888,0.2,0.3333333333333333
AGel amyloidosis,33159,4,45,18,0,18,35,3,32,0.0,0.06666666666666667,0.0,0.0,0.08571428571428572,0.06666666666666667
Biemond syndrome type 2,28617,3,12,23,9,14,30,0,30,0.75,0.0,0.391304347826087,0.75,0.0,0.0
Acquired idiopathic sideroblastic anemia,29390,1,28,17,7,10,33,2,31,0.25,0.07142857142857142,0.4117647058823529,0.25,0.06060606060606061,0.07142857142857142
Chronic visceral acid sphingomyelinase deficiency,98936,7,47,12,1,11,36,4,32,0.02127659574468085,0.0851063829787234,0.08333333333333333,0.02127659574468085,0.1111111111111111,0.0851063829787234
Proximal 16p11.2 microduplication syndrome,33180,3,38,17,4,13,33,5,28,0.10526315789473684,0.13157894736842105,0.23529411764705882,0.10526315789473684,0.15151515151515152,0.13157894736842105
MEND syndrome,30175,0,45,16,13,3,15,0,15,0.28888888888888886,0.0,0.8125,0.28888888888888886,0.0,0.0
Myelodysplastic neoplasm with increased blasts,95113,19,22,32,7,25,28,5,23,0.3181818181818182,0.22727272727272727,0.21875,0.3181818181818182,0.17857142857142858,0.22727272727272727
Acute panmyelosis with myelofibrosis,32843,3,15,17,16,1,17,2,15,1.0666666666666667,0.13333333333333333,0.9411764705882353,1.0666666666666667,0.11764705882352941,0.13333333333333333
Myelodysplastic syndrome associated with isolated del(5q) chromosome abnormality,28311,1,18,19,19,0,24,3,21,1.0555555555555556,0.16666666666666666,1.0,1.0555555555555556,0.125,0.16666666666666666
Unclassified myelodysplastic syndrome,28813,10,10,18,1,17,23,3,20,0.1,0.3,0.05555555555555555,0.1,0.13043478260869565,0.3
Myelodysplastic neoplasm with low blasts,39579,23,14,30,4,26,28,4,24,0.2857142857142857,0.2857142857142857,0.13333333333333333,0.2857142857142857,0.14285714285714285,0.2857142857142857
Juvenile glaucoma,30583,2,15,16,15,1,14,3,11,1.0,0.2,0.9375,1.0,0.21428571428571427,0.2
Macular corneal dystrophy,30135,5,11,16,11,5,22,3,19,1.0,0.2727272727272727,0.6875,1.0,0.13636363636363635,0.2727272727272727
Gestational choriocarcinoma,32511,8,6,27,4,23,20,0,20,0.6666666666666666,0.0,0.14814814814814814,0.6666666666666666,0.0,0.0
Microtia,31577,6,9,16,3,13,21,1,20,0.3333333333333333,0.1111111111111111,0.1875,0.3333333333333333,0.047619047619047616,0.1111111111111111
Hydranencephaly,27804,0,28,17,16,1,24,0,24,0.5714285714285714,0.0,0.9411764705882353,0.5714285714285714,0.0,0.0
Central areolar choroidal dystrophy,96983,16,17,37,6,31,25,5,20,0.35294117647058826,0.29411764705882354,0.16216216216216217,0.35294117647058826,0.2,0.29411764705882354
Chronic thromboembolic pulmonary hypertension,33068,5,37,17,16,1,18,6,12,0.43243243243243246,0.16216216216216217,0.9411764705882353,0.43243243243243246,0.3333333333333333,0.16216216216216217
Adult acute respiratory distress syndrome,33063,3,17,16,15,1,26,5,21,0.8823529411764706,0.29411764705882354,0.9375,0.8823529411764706,0.19230769230769232,0.29411764705882354
Childhood absence epilepsy,33115,2,21,19,11,8,28,2,26,0.5238095238095238,0.09523809523809523,0.5789473684210527,0.5238095238095238,0.07142857142857142,0.09523809523809523
Dopamine beta-hydroxylase deficiency,30860,3,28,17,14,3,26,9,17,0.5,0.32142857142857145,0.8235294117647058,0.5,0.34615384615384615,0.32142857142857145
Peripartum cardiomyopathy,33304,3,45,17,18,-1,23,7,16,0.4,0.15555555555555556,1.0588235294117647,0.4,0.30434782608695654,0.15555555555555556
Xq25 microduplication syndrome,31102,2,20,17,13,4,29,1,28,0.65,0.05,0.7647058823529411,0.65,0.034482758620689655,0.05
ANE syndrome,31157,0,28,17,9,8,15,0,15,0.32142857142857145,0.0,0.5294117647058824,0.32142857142857145,0.0,0.0
Retinitis punctata albescens,32548,3,19,20,18,2,23,4,19,0.9473684210526315,0.21052631578947367,0.9,0.9473684210526315,0.17391304347826086,0.21052631578947367
Immune dysregulation-polyendocrinopathy-enteropathy-X-linked syndrome,31513,3,60,58,41,17,10,0,10,0.6833333333333333,0.0,0.7068965517241379,0.6833333333333333,0.0,0.0
IgG4-related retroperitoneal fibrosis,32797,3,43,22,24,-2,21,6,15,0.5581395348837209,0.13953488372093023,1.0909090909090908,0.5581395348837209,0.2857142857142857,0.13953488372093023
Idiopathic bronchiectasis,32537,3,19,16,16,0,16,5,11,0.8421052631578947,0.2631578947368421,1.0,0.8421052631578947,0.3125,0.2631578947368421
Recurrent respiratory papillomatosis,31921,9,23,18,6,12,25,8,17,0.2608695652173913,0.34782608695652173,0.3333333333333333,0.2608695652173913,0.32,0.34782608695652173
Primary membranoproliferative glomerulonephritis,94687,17,16,23,4,19,30,4,26,0.25,0.25,0.17391304347826086,0.25,0.13333333333333333,0.25
Medial condensing osteitis of the clavicle,32297,6,5,16,3,13,17,3,14,0.6,0.6,0.1875,0.6,0.17647058823529413,0.6
Graft versus host disease,97057,20,41,26,9,17,22,8,14,0.21951219512195122,0.1951219512195122,0.34615384615384615,0.21951219512195122,0.36363636363636365,0.1951219512195122
Acquired purpura fulminans,39484,15,25,30,6,24,26,3,23,0.24,0.12,0.2,0.24,0.11538461538461539,0.12
T-B+ severe combined immunodeficiency due to JAK3 deficiency,31572,1,25,23,16,7,32,2,30,0.64,0.08,0.6956521739130435,0.64,0.0625,0.08
FRAXE intellectual disability,31304,2,21,16,13,3,32,2,30,0.6190476190476191,0.09523809523809523,0.8125,0.6190476190476191,0.0625,0.09523809523809523
Hyperinsulinism-hyperammonemia syndrome,28314,14,12,30,1,29,24,0,24,0.08333333333333333,0.0,0.03333333333333333,0.08333333333333333,0.0,0.0
CK syndrome,27705,0,35,19,10,9,25,0,25,0.2857142857142857,0.0,0.5263157894736842,0.2857142857142857,0.0,0.0
Acute monoblastic/monocytic leukemia,29863,3,20,17,18,-1,28,6,22,0.9,0.3,1.0588235294117647,0.9,0.21428571428571427,0.3
Congenital factor X deficiency,30586,3,19,17,12,5,23,5,18,0.631578947368421,0.2631578947368421,0.7058823529411765,0.631578947368421,0.21739130434782608,0.2631578947368421
Optic pathway glioma,33318,3,23,18,19,-1,35,5,30,0.8260869565217391,0.21739130434782608,1.0555555555555556,0.8260869565217391,0.14285714285714285,0.21739130434782608
Adult idiopathic neutropenia,27740,3,15,15,14,1,35,4,31,0.9333333333333333,0.26666666666666666,0.9333333333333333,0.9333333333333333,0.11428571428571428,0.26666666666666666
Hereditary elliptocytosis,32434,3,23,19,24,-5,23,6,17,1.0434782608695652,0.2608695652173913,1.263157894736842,1.0434782608695652,0.2608695652173913,0.2608695652173913
Idiopathic aplastic anemia,27664,10,12,22,12,10,17,2,15,1.0,0.16666666666666666,0.5454545454545454,1.0,0.11764705882352941,0.16666666666666666
Fetal and neonatal alloimmune thrombocytopenia,37629,17,17,24,5,19,24,5,19,0.29411764705882354,0.29411764705882354,0.20833333333333334,0.29411764705882354,0.20833333333333334,0.29411764705882354
Lysinuric protein intolerance,29923,2,77,25,26,-1,21,6,15,0.33766233766233766,0.07792207792207792,1.04,0.33766233766233766,0.2857142857142857,0.07792207792207792
Hereditary spherocytosis,27542,4,27,17,15,2,26,5,21,0.5555555555555556,0.18518518518518517,0.8823529411764706,0.5555555555555556,0.19230769230769232,0.18518518518518517
Sarcosinemia,30971,0,22,18,15,3,33,1,32,0.6818181818181818,0.045454545454545456,0.8333333333333334,0.6818181818181818,0.030303030303030304,0.045454545454545456
Cystathioninuria,29708,1,8,9,7,2,10,1,9,0.875,0.125,0.7777777777777778,0.875,0.1,0.125
Congenital factor II deficiency,27656,5,21,24,19,5,17,5,12,0.9047619047619048,0.23809523809523808,0.7916666666666666,0.9047619047619048,0.29411764705882354,0.23809523809523808
Non-involuting congenital hemangioma,32222,0,12,23,12,11,8,2,6,1.0,0.16666666666666666,0.5217391304347826,1.0,0.25,0.16666666666666666
Kasabach-Merritt phenomenon,28851,5,23,18,17,1,28,7,21,0.7391304347826086,0.30434782608695654,0.9444444444444444,0.7391304347826086,0.25,0.30434782608695654
Polyarteritis nodosa,32986,3,28,21,20,1,24,4,20,0.7142857142857143,0.14285714285714285,0.9523809523809523,0.7142857142857143,0.16666666666666666,0.14285714285714285
Rapidly involuting congenital hemangioma,32222,1,14,18,14,4,12,3,9,1.0,0.21428571428571427,0.7777777777777778,1.0,0.25,0.21428571428571427
Acute myelomonocytic leukemia,84319,19,9,25,5,20,22,3,19,0.5555555555555556,0.3333333333333333,0.2,0.5555555555555556,0.13636363636363635,0.3333333333333333
Acute erythroid leukemia,32256,2,9,21,8,13,23,2,21,0.8888888888888888,0.2222222222222222,0.38095238095238093,0.8888888888888888,0.08695652173913043,0.2222222222222222
Brugada syndrome,28198,5,12,18,12,6,29,6,23,1.0,0.5,0.6666666666666666,1.0,0.20689655172413793,0.5
Hypocalcemic vitamin D-dependent rickets,31053,2,46,23,16,7,26,4,22,0.34782608695652173,0.08695652173913043,0.6956521739130435,0.34782608695652173,0.15384615384615385,0.08695652173913043
Acquired methemoglobinemia,30126,15,21,21,9,12,22,11,11,0.42857142857142855,0.5238095238095238,0.42857142857142855,0.42857142857142855,0.5,0.5238095238095238
Familial glucocorticoid deficiency,27648,1,36,28,29,-1,22,2,20,0.8055555555555556,0.05555555555555555,1.0357142857142858,0.8055555555555556,0.09090909090909091,0.05555555555555555
Beta-ketothiolase deficiency,30683,2,42,17,17,0,26,5,21,0.40476190476190477,0.11904761904761904,1.0,0.40476190476190477,0.19230769230769232,0.11904761904761904
Autoimmune lymphoproliferative syndrome,28015,4,70,119,60,59,30,2,28,0.8571428571428571,0.02857142857142857,0.5042016806722689,0.8571428571428571,0.06666666666666667,0.02857142857142857
Secondary hypoparathyroidism due to impaired parathormon secretion,31288,6,25,19,7,12,20,6,14,0.28,0.24,0.3684210526315789,0.28,0.3,0.24
Tufted angioma,30820,3,16,17,13,4,27,3,24,0.8125,0.1875,0.7647058823529411,0.8125,0.1111111111111111,0.1875
Hereditary thrombophilia due to congenital antithrombin deficiency,30094,5,15,17,13,4,26,7,19,0.8666666666666667,0.4666666666666667,0.7647058823529411,0.8666666666666667,0.2692307692307692,0.4666666666666667
Castleman disease,98712,15,29,23,7,16,20,5,15,0.2413793103448276,0.1724137931034483,0.30434782608695654,0.2413793103448276,0.25,0.1724137931034483
MODY,31184,3,27,33,3,30,17,1,16,0.1111111111111111,0.037037037037037035,0.09090909090909091,0.1111111111111111,0.058823529411764705,0.037037037037037035
Primary myelofibrosis,27610,5,36,20,22,-2,32,10,22,0.6111111111111112,0.2777777777777778,1.1,0.6111111111111112,0.3125,0.2777777777777778
Acute promyelocytic leukemia,29361,7,36,18,18,0,34,14,20,0.5,0.3888888888888889,1.0,0.5,0.4117647058823529,0.3888888888888889
Dystonia-parkinsonism-hypermanganesemia syndrome,28480,4,26,23,18,5,29,7,22,0.6923076923076923,0.2692307692307692,0.782608695652174,0.6923076923076923,0.2413793103448276,0.2692307692307692
Familial dilated cardiomyopathy with conduction defect due to LMNA mutation,32609,11,17,21,3,18,21,2,19,0.17647058823529413,0.11764705882352941,0.14285714285714285,0.17647058823529413,0.09523809523809523,0.11764705882352941
Verrucous hemangioma,33276,3,7,13,6,7,20,1,19,0.8571428571428571,0.14285714285714285,0.46153846153846156,0.8571428571428571,0.05,0.14285714285714285
Double outlet right ventricle,33375,4,28,25,23,2,30,5,25,0.8214285714285714,0.17857142857142858,0.92,0.8214285714285714,0.16666666666666666,0.17857142857142858
Tricuspid atresia,32760,6,10,16,8,8,19,1,18,0.8,0.1,0.5,0.8,0.05263157894736842,0.1
Primary hyperoxaluria,29946,5,33,19,11,8,21,2,19,0.3333333333333333,0.06060606060606061,0.5789473684210527,0.3333333333333333,0.09523809523809523,0.06060606060606061
Congenital muscular dystrophy with intellectual disability,29208,1,43,87,37,50,24,3,21,0.8604651162790697,0.06976744186046512,0.42528735632183906,0.8604651162790697,0.125,0.06976744186046512
Idiopathic hypereosinophilic syndrome,28414,7,78,76,70,6,26,10,16,0.8974358974358975,0.1282051282051282,0.9210526315789473,0.8974358974358975,0.38461538461538464,0.1282051282051282
Hyperammonemia due to N-acetylglutamate synthase deficiency,29034,3,42,17,15,2,28,8,20,0.35714285714285715,0.19047619047619047,0.8823529411764706,0.35714285714285715,0.2857142857142857,0.19047619047619047
9p13 microdeletion syndrome,32409,1,32,19,18,1,19,1,18,0.5625,0.03125,0.9473684210526315,0.5625,0.05263157894736842,0.03125
3q27.3 microdeletion syndrome,33028,2,24,19,15,4,29,2,27,0.625,0.08333333333333333,0.7894736842105263,0.625,0.06896551724137931,0.08333333333333333
Congenital factor XIII deficiency,27869,5,26,19,8,11,15,7,8,0.3076923076923077,0.2692307692307692,0.42105263157894735,0.3076923076923077,0.4666666666666667,0.2692307692307692
3-methylglutaconic aciduria type 9,28809,5,25,112,26,86,27,2,25,1.04,0.08,0.23214285714285715,1.04,0.07407407407407407,0.08
3-methylglutaconic aciduria-neonatal cataract-neurologic involvement-congenital neutropenia syndrome,29807,4,38,40,36,4,32,6,26,0.9473684210526315,0.15789473684210525,0.9,0.9473684210526315,0.1875,0.15789473684210525
Subcutaneous panniculitis-like T-cell lymphoma,29698,4,11,16,11,5,18,4,14,1.0,0.36363636363636365,0.6875,1.0,0.2222222222222222,0.36363636363636365
3-hydroxy-3-methylglutaric aciduria,28809,10,54,51,11,40,35,6,29,0.2037037037037037,0.1111111111111111,0.21568627450980393,0.2037037037037037,0.17142857142857143,0.1111111111111111
Incessant infant ventricular tachycardia,27703,4,12,21,9,12,23,1,22,0.75,0.08333333333333333,0.42857142857142855,0.75,0.043478260869565216,0.08333333333333333
Combined immunodeficiency due to ZAP70 deficiency,27177,0,30,23,17,6,19,0,19,0.5666666666666667,0.0,0.7391304347826086,0.5666666666666667,0.0,0.0
Heparin-induced thrombocytopenia,32563,3,15,15,14,1,23,5,18,0.9333333333333333,0.3333333333333333,0.9333333333333333,0.9333333333333333,0.21739130434782608,0.3333333333333333
Hereditary fructose intolerance,27426,6,24,16,10,6,18,8,10,0.4166666666666667,0.3333333333333333,0.625,0.4166666666666667,0.4444444444444444,0.3333333333333333
"Fructose-1,6-bisphosphatase deficiency",30542,1,34,17,15,2,18,3,15,0.4411764705882353,0.08823529411764706,0.8823529411764706,0.4411764705882353,0.16666666666666666,0.08823529411764706
Immunodeficiency by defective expression of MHC class II,31044,0,38,21,16,5,19,3,16,0.42105263157894735,0.07894736842105263,0.7619047619047619,0.42105263157894735,0.15789473684210525,0.07894736842105263
T-B+ severe combined immunodeficiency due to gamma chain deficiency,30284,5,33,32,18,14,28,4,24,0.5454545454545454,0.12121212121212122,0.5625,0.5454545454545454,0.14285714285714285,0.12121212121212122
Gitelman syndrome,31556,6,68,17,13,4,28,11,17,0.19117647058823528,0.16176470588235295,0.7647058823529411,0.19117647058823528,0.39285714285714285,0.16176470588235295
Neurodevelopmental delay-seizures-ophthalmic anomalies-osteopenia-cerebellar atrophy syndrome,28046,3,31,16,6,10,31,7,24,0.1935483870967742,0.22580645161290322,0.375,0.1935483870967742,0.22580645161290322,0.22580645161290322
Autosomal dominant severe congenital neutropenia,33449,2,31,17,17,0,27,2,25,0.5483870967741935,0.06451612903225806,1.0,0.5483870967741935,0.07407407407407407,0.06451612903225806
Severe combined immunodeficiency due to DCLRE1C deficiency,29553,0,19,17,12,5,23,3,20,0.631578947368421,0.15789473684210525,0.7058823529411765,0.631578947368421,0.13043478260869565,0.15789473684210525
Mohr-Tranebjaerg syndrome,31824,1,41,21,0,21,31,1,30,0.0,0.024390243902439025,0.0,0.0,0.03225806451612903,0.024390243902439025
Congenital muscular dystrophy with cerebellar involvement,30361,4,47,18,4,14,30,0,30,0.0851063829787234,0.0,0.2222222222222222,0.0851063829787234,0.0,0.0
Female restricted epilepsy with intellectual disability,29601,2,29,16,3,13,25,2,23,0.10344827586206896,0.06896551724137931,0.1875,0.10344827586206896,0.08,0.06896551724137931
Hyperekplexia-epilepsy syndrome,98352,12,9,21,1,20,40,2,38,0.1111111111111111,0.2222222222222222,0.047619047619047616,0.1111111111111111,0.05,0.2222222222222222
Mosaic trisomy 1 syndrome,33389,0,60,36,37,-1,25,0,25,0.6166666666666667,0.0,1.0277777777777777,0.6166666666666667,0.0,0.0
PMM2-CDG,28471,3,86,17,4,13,26,3,23,0.046511627906976744,0.03488372093023256,0.23529411764705882,0.046511627906976744,0.11538461538461539,0.03488372093023256
Adenylosuccinate synthetase-like 1-related distal myopathy,27734,0,37,19,19,0,20,1,19,0.5135135135135135,0.02702702702702703,1.0,0.5135135135135135,0.05,0.02702702702702703
Miyoshi myopathy,27704,0,25,14,15,-1,19,2,17,0.6,0.08,1.0714285714285714,0.6,0.10526315789473684,0.08
Distal deletion 12q syndrome,32653,0,76,18,20,-2,11,0,11,0.2631578947368421,0.0,1.1111111111111112,0.2631578947368421,0.0,0.0
Distal myopathy with posterior leg and anterior hand involvement,28689,0,22,17,1,16,14,2,12,0.045454545454545456,0.09090909090909091,0.058823529411764705,0.045454545454545456,0.14285714285714285,0.09090909090909091
Oculopharyngodistal myopathy,31614,5,36,18,2,16,29,4,25,0.05555555555555555,0.1111111111111111,0.1111111111111111,0.05555555555555555,0.13793103448275862,0.1111111111111111
"Late-onset distal myopathy, Markesbery-Griggs type",28689,4,21,18,2,16,27,3,24,0.09523809523809523,0.14285714285714285,0.1111111111111111,0.09523809523809523,0.1111111111111111,0.14285714285714285
Desminopathy,38446,15,18,18,0,18,28,0,28,0.0,0.0,0.0,0.0,0.0,0.0
Juvenile polyposis syndrome,31795,2,52,14,10,4,20,6,14,0.19230769230769232,0.11538461538461539,0.7142857142857143,0.19230769230769232,0.3,0.11538461538461539
Turcot syndrome with polyposis,32298,2,42,17,18,-1,26,6,20,0.42857142857142855,0.14285714285714285,1.0588235294117647,0.42857142857142855,0.23076923076923078,0.14285714285714285
Generalized juvenile polyposis/juvenile polyposis coli,31795,2,11,17,9,8,18,1,17,0.8181818181818182,0.09090909090909091,0.5294117647058824,0.8181818181818182,0.05555555555555555,0.09090909090909091
Juvenile polyposis of infancy,31795,3,43,17,6,11,28,8,20,0.13953488372093023,0.18604651162790697,0.35294117647058826,0.13953488372093023,0.2857142857142857,0.18604651162790697
Corticobasal syndrome,33381,5,22,16,17,-1,19,9,10,0.7727272727272727,0.4090909090909091,1.0625,0.7727272727272727,0.47368421052631576,0.4090909090909091
Progressive supranuclear palsy-pure akinesia with gait freezing syndrome,27637,2,21,18,17,1,20,4,16,0.8095238095238095,0.19047619047619047,0.9444444444444444,0.8095238095238095,0.2,0.19047619047619047
Progressive supranuclear palsy-corticobasal syndrome,27828,4,30,26,28,-2,27,7,20,0.9333333333333333,0.23333333333333334,1.0769230769230769,0.9333333333333333,0.25925925925925924,0.23333333333333334
Progressive supranuclear palsy-progressive non-fluent aphasia syndrome,33466,4,21,17,17,0,18,5,13,0.8095238095238095,0.23809523809523808,1.0,0.8095238095238095,0.2777777777777778,0.23809523809523808
Fatty acid hydroxylase-associated neurodegeneration,32709,3,31,28,27,1,29,3,26,0.8709677419354839,0.0967741935483871,0.9642857142857143,0.8709677419354839,0.10344827586206896,0.0967741935483871
Atypical progressive supranuclear palsy syndrome,27828,2,29,26,12,14,21,5,16,0.41379310344827586,0.1724137931034483,0.46153846153846156,0.41379310344827586,0.23809523809523808,0.1724137931034483
Progressive supranuclear palsy-predominant parkinsonism syndrome,27642,3,20,24,17,7,25,5,20,0.85,0.25,0.7083333333333334,0.85,0.2,0.25
Classic progressive supranuclear palsy syndrome,27828,5,28,27,16,11,31,4,27,0.5714285714285714,0.14285714285714285,0.5925925925925926,0.5714285714285714,0.12903225806451613,0.14285714285714285
Familial colorectal cancer Type X,27819,1,53,17,16,1,28,5,23,0.3018867924528302,0.09433962264150944,0.9411764705882353,0.3018867924528302,0.17857142857142858,0.09433962264150944
Autosomal recessive complex spastic paraplegia due to Kennedy pathway dysfunction,33076,1,22,19,19,0,22,2,20,0.8636363636363636,0.09090909090909091,1.0,0.8636363636363636,0.09090909090909091,0.09090909090909091
Autosomal dominant spastic paraplegia type 10,30156,2,28,26,8,18,28,4,24,0.2857142857142857,0.14285714285714285,0.3076923076923077,0.2857142857142857,0.14285714285714285,0.14285714285714285
Autosomal recessive spastic paraplegia type 77,27668,0,37,15,4,11,16,0,16,0.10810810810810811,0.0,0.26666666666666666,0.10810810810810811,0.0,0.0
"X-linked intellectual disability, Hedera type",27603,2,31,28,3,25,33,2,31,0.0967741935483871,0.06451612903225806,0.10714285714285714,0.0967741935483871,0.06060606060606061,0.06451612903225806
Ataxia-oculomotor apraxia type 4,27817,2,21,19,10,9,3,2,1,0.47619047619047616,0.09523809523809523,0.5263157894736842,0.47619047619047616,0.6666666666666666,0.09523809523809523
Episodic ataxia type 3,27813,4,7,19,3,16,27,3,24,0.42857142857142855,0.42857142857142855,0.15789473684210525,0.42857142857142855,0.1111111111111111,0.42857142857142855
Autosomal recessive spastic paraplegia type 32,39424,15,13,30,2,28,29,3,26,0.15384615384615385,0.23076923076923078,0.06666666666666667,0.15384615384615385,0.10344827586206896,0.23076923076923078
Autosomal dominant polycystic kidney disease,28262,2,26,17,6,11,27,3,24,0.23076923076923078,0.11538461538461539,0.35294117647058826,0.23076923076923078,0.1111111111111111,0.11538461538461539
Idiopathic achalasia,27364,2,10,16,2,14,16,4,12,0.2,0.4,0.125,0.2,0.25,0.4
Iminoglycinuria,27825,2,6,27,3,24,31,0,31,0.5,0.0,0.1111111111111111,0.5,0.0,0.0
Meningococcal meningitis,84189,15,35,20,4,16,29,10,19,0.11428571428571428,0.2857142857142857,0.2,0.11428571428571428,0.3448275862068966,0.2857142857142857
Mucolipidosis type II,27333,0,63,18,5,13,26,1,25,0.07936507936507936,0.015873015873015872,0.2777777777777778,0.07936507936507936,0.038461538461538464,0.015873015873015872
Adenine phosphoribosyltransferase deficiency,29957,0,18,17,0,17,37,2,35,0.0,0.1111111111111111,0.0,0.0,0.05405405405405406,0.1111111111111111
SUNCT syndrome,32399,3,23,17,17,0,45,4,41,0.7391304347826086,0.17391304347826086,1.0,0.7391304347826086,0.08888888888888889,0.17391304347826086
Dentinogenesis imperfecta,38671,5,21,18,4,14,7,3,4,0.19047619047619047,0.14285714285714285,0.2222222222222222,0.19047619047619047,0.42857142857142855,0.14285714285714285
Meconium aspiration syndrome,33075,2,22,16,17,-1,18,2,16,0.7727272727272727,0.09090909090909091,1.0625,0.7727272727272727,0.1111111111111111,0.09090909090909091
Enlarged parietal foramina,27853,2,20,21,15,6,23,2,21,0.75,0.1,0.7142857142857143,0.75,0.08695652173913043,0.1
Acute interstitial pneumonia,33385,4,33,17,15,2,23,5,18,0.45454545454545453,0.15151515151515152,0.8823529411764706,0.45454545454545453,0.21739130434782608,0.15151515151515152
Familial isolated restrictive cardiomyopathy,32672,2,20,16,17,-1,28,3,25,0.85,0.15,1.0625,0.85,0.10714285714285714,0.15
Leprechaunism,94931,13,47,24,2,22,24,2,22,0.0425531914893617,0.0425531914893617,0.08333333333333333,0.0425531914893617,0.08333333333333333,0.0425531914893617
Achondroplasia,28484,1,39,20,18,2,27,2,25,0.46153846153846156,0.05128205128205128,0.9,0.46153846153846156,0.07407407407407407,0.05128205128205128
Amelogenesis imperfecta,28782,6,16,20,8,12,7,6,1,0.5,0.375,0.4,0.5,0.8571428571428571,0.375
Sepsis in premature infants,30892,7,51,17,8,9,23,13,10,0.1568627450980392,0.2549019607843137,0.47058823529411764,0.1568627450980392,0.5652173913043478,0.2549019607843137
Posterior polymorphous corneal dystrophy,28828,4,20,17,12,5,21,6,15,0.6,0.3,0.7058823529411765,0.6,0.2857142857142857,0.3
Infantile Krabbe disease,33182,6,70,61,65,-4,23,7,16,0.9285714285714286,0.1,1.0655737704918034,0.9285714285714286,0.30434782608695654,0.1
Late-infantile/juvenile Krabbe disease,33145,3,47,18,17,1,26,5,21,0.3617021276595745,0.10638297872340426,0.9444444444444444,0.3617021276595745,0.19230769230769232,0.10638297872340426
Adult Krabbe disease,33153,1,44,40,41,-1,11,1,10,0.9318181818181818,0.022727272727272728,1.025,0.9318181818181818,0.09090909090909091,0.022727272727272728
Limbal stem cell deficiency,32509,6,15,15,16,-1,19,8,11,1.0666666666666667,0.5333333333333333,1.0666666666666667,1.0666666666666667,0.42105263157894735,0.5333333333333333
Primary Sjögren syndrome,28764,5,82,71,66,5,22,5,17,0.8048780487804879,0.06097560975609756,0.9295774647887324,0.8048780487804879,0.22727272727272727,0.06097560975609756
Oculocutaneous albinism type 1,84278,17,21,33,3,30,33,3,30,0.14285714285714285,0.14285714285714285,0.09090909090909091,0.14285714285714285,0.09090909090909091,0.14285714285714285
Moderate hemophilia A,27361,7,26,26,20,6,34,11,23,0.7692307692307693,0.4230769230769231,0.7692307692307693,0.7692307692307693,0.3235294117647059,0.4230769230769231
Bleeding disorder in hemophilia A carriers,27498,10,12,22,5,17,30,7,23,0.4166666666666667,0.5833333333333334,0.22727272727272727,0.4166666666666667,0.23333333333333334,0.5833333333333334
Localized junctional epidermolysis bullosa,27638,4,19,27,3,24,19,3,16,0.15789473684210525,0.15789473684210525,0.1111111111111111,0.15789473684210525,0.15789473684210525,0.15789473684210525
Progressive multifocal leukoencephalopathy,28636,6,35,19,2,17,32,10,22,0.05714285714285714,0.2857142857142857,0.10526315789473684,0.05714285714285714,0.3125,0.2857142857142857
Generalized pseudohypoaldosteronism type 1,28487,2,22,17,9,8,34,1,33,0.4090909090909091,0.045454545454545456,0.5294117647058824,0.4090909090909091,0.029411764705882353,0.045454545454545456
C3 glomerulopathy,30821,10,23,15,5,10,17,4,13,0.21739130434782608,0.17391304347826086,0.3333333333333333,0.21739130434782608,0.23529411764705882,0.17391304347826086
Snakebite envenomation,32792,1,34,16,17,-1,23,6,17,0.5,0.17647058823529413,1.0625,0.5,0.2608695652173913,0.17647058823529413
Tall stature-intellectual disability-renal anomalies syndrome,28796,2,47,18,15,3,30,4,26,0.3191489361702128,0.0851063829787234,0.8333333333333334,0.3191489361702128,0.13333333333333333,0.0851063829787234
Combined oxidative phosphorylation defect type 7,38594,19,42,26,3,23,27,3,24,0.07142857142857142,0.07142857142857142,0.11538461538461539,0.07142857142857142,0.1111111111111111,0.07142857142857142
Congenital labioscrotal agenesis-cerebellar malformation-corneal dystrophy-facial dysmorphism syndrome,32682,2,52,17,18,-1,24,4,20,0.34615384615384615,0.07692307692307693,1.0588235294117647,0.34615384615384615,0.16666666666666666,0.07692307692307693
Severe neurodevelopmental disorder with feeding difficulties-stereotypic hand movement-bilateral cataract,29669,3,23,18,0,18,36,2,34,0.0,0.08695652173913043,0.0,0.0,0.05555555555555555,0.08695652173913043
Polyhydramnios-megalencephaly-symptomatic epilepsy syndrome,29767,1,34,21,15,6,1,1,0,0.4411764705882353,0.029411764705882353,0.7142857142857143,0.4411764705882353,1.0,0.029411764705882353
Childhood-onset motor and cognitive regression syndrome with extrapyramidal movement disorder,30027,4,33,22,15,7,28,7,21,0.45454545454545453,0.21212121212121213,0.6818181818181818,0.45454545454545453,0.25,0.21212121212121213
Early-onset progressive encephalopathy-hearing loss-pons hypoplasia-brain atrophy syndrome,30113,5,30,19,13,6,26,3,23,0.43333333333333335,0.1,0.6842105263157895,0.43333333333333335,0.11538461538461539,0.1
Gabriele-de Vries syndrome,30722,1,73,24,19,5,31,3,28,0.2602739726027397,0.0410958904109589,0.7916666666666666,0.2602739726027397,0.0967741935483871,0.0410958904109589
CDKL5-deficiency disorder,38814,18,53,32,6,26,25,5,20,0.11320754716981132,0.09433962264150944,0.1875,0.11320754716981132,0.2,0.09433962264150944
Mucopolysaccharidosis-like syndrome with congenital heart defects and hematopoietic disorders,31580,5,71,17,14,3,33,8,25,0.19718309859154928,0.11267605633802817,0.8235294117647058,0.19718309859154928,0.24242424242424243,0.11267605633802817
Intellectual disability-seizures-abnormal gait-facial dysmorphism syndrome,38365,14,62,20,2,18,38,3,35,0.03225806451612903,0.04838709677419355,0.1,0.03225806451612903,0.07894736842105263,0.04838709677419355
Congenital progressive bone marrow failure-B-cell immunodeficiency-skeletal dysplasia syndrome,32406,3,38,18,19,-1,31,5,26,0.5,0.13157894736842105,1.0555555555555556,0.5,0.16129032258064516,0.13157894736842105
Prader-Willi syndrome,32961,5,90,54,42,12,34,10,24,0.4666666666666667,0.1111111111111111,0.7777777777777778,0.4666666666666667,0.29411764705882354,0.1111111111111111
Tuberous sclerosis complex,31194,7,62,24,11,13,22,9,13,0.1774193548387097,0.14516129032258066,0.4583333333333333,0.1774193548387097,0.4090909090909091,0.14516129032258066
Infantile hypotonia-oculomotor anomalies-hyperkinetic movements-developmental delay syndrome,29711,1,60,18,14,4,29,3,26,0.23333333333333334,0.05,0.7777777777777778,0.23333333333333334,0.10344827586206896,0.05
Mucopolysaccharidosis type 2,27436,10,78,19,7,12,22,7,15,0.08974358974358974,0.08974358974358974,0.3684210526315789,0.08974358974358974,0.3181818181818182,0.08974358974358974
Dravet syndrome,84256,20,46,36,2,34,40,4,36,0.043478260869565216,0.08695652173913043,0.05555555555555555,0.043478260869565216,0.1,0.08695652173913043
Beta-thalassemia intermedia,33434,4,36,21,24,-3,29,6,23,0.6666666666666666,0.16666666666666666,1.1428571428571428,0.6666666666666666,0.20689655172413793,0.16666666666666666
Methylcobalamin deficiency type cblE,27539,1,50,17,15,2,21,2,19,0.3,0.04,0.8823529411764706,0.3,0.09523809523809523,0.04
Rabson-Mendenhall syndrome,28382,0,56,18,17,1,21,1,20,0.30357142857142855,0.017857142857142856,0.9444444444444444,0.30357142857142855,0.047619047619047616,0.017857142857142856
"Alpha-mannosidosis, infantile form",99138,11,88,26,7,19,37,7,30,0.07954545454545454,0.07954545454545454,0.2692307692307692,0.07954545454545454,0.1891891891891892,0.07954545454545454
Severe Canavan disease,30772,2,34,16,4,12,25,2,23,0.11764705882352941,0.058823529411764705,0.25,0.11764705882352941,0.08,0.058823529411764705
Glycogen storage disease due to muscle glycogen phosphorylase deficiency,27292,4,24,28,4,24,24,3,21,0.16666666666666666,0.125,0.14285714285714285,0.16666666666666666,0.125,0.125
Glycogen storage disease due to liver glycogen phosphorylase deficiency,32796,3,28,17,9,8,19,8,11,0.32142857142857145,0.2857142857142857,0.5294117647058824,0.32142857142857145,0.42105263157894735,0.2857142857142857
"Alpha-mannosidosis, adult form",99138,16,30,29,0,29,40,1,39,0.0,0.03333333333333333,0.0,0.0,0.025,0.03333333333333333
Glycogen storage disease due to glycogen branching enzyme deficiency,98357,15,30,27,3,24,30,2,28,0.1,0.06666666666666667,0.1111111111111111,0.1,0.06666666666666667,0.06666666666666667
Microcephaly-intellectual disability-sensorineural hearing loss-epilepsy-abnormal muscle tone syndrome,31287,3,50,19,15,4,26,3,23,0.3,0.06,0.7894736842105263,0.3,0.11538461538461539,0.06
Progressive spondyloepimetaphyseal dysplasia-short stature-short fourth metatarsals-intellectual disability syndrome,31488,3,73,28,25,3,25,7,18,0.3424657534246575,0.0958904109589041,0.8928571428571429,0.3424657534246575,0.28,0.0958904109589041
Intellectual disability-muscle weakness-short stature-facial dysmorphism syndrome,32255,3,24,18,18,0,28,3,25,0.75,0.125,1.0,0.75,0.10714285714285714,0.125
Acatalasemia,32009,0,17,17,13,4,29,0,29,0.7647058823529411,0.0,0.7647058823529411,0.7647058823529411,0.0,0.0
Microcephaly-corpus callosum hypoplasia-intellectual disability-facial dysmorphism syndrome,29511,1,38,39,32,7,21,2,19,0.8421052631578947,0.05263157894736842,0.8205128205128205,0.8421052631578947,0.09523809523809523,0.05263157894736842
Intellectual disability-macrocephaly-hypotonia-behavioral abnormalities syndrome,31131,2,61,20,5,15,25,1,24,0.08196721311475409,0.01639344262295082,0.25,0.08196721311475409,0.04,0.01639344262295082
Seizures-scoliosis-macrocephaly syndrome,31388,2,31,17,9,8,26,4,22,0.2903225806451613,0.12903225806451613,0.5294117647058824,0.2903225806451613,0.15384615384615385,0.12903225806451613
Intellectual disability-epilepsy-extrapyramidal syndrome,29601,2,30,21,16,5,30,2,28,0.5333333333333333,0.06666666666666667,0.7619047619047619,0.5333333333333333,0.06666666666666667,0.06666666666666667
WAC-related facial dysmorphism-developmental delay-behavioral abnormalities syndrome,30416,2,70,17,9,8,31,5,26,0.12857142857142856,0.07142857142857142,0.5294117647058824,0.12857142857142856,0.16129032258064516,0.07142857142857142
X-linked intellectual disability-cerebellar hypoplasia-spondylo-epiphyseal dysplasia syndrome,33433,4,63,55,54,1,27,5,22,0.8571428571428571,0.07936507936507936,0.9818181818181818,0.8571428571428571,0.18518518518518517,0.07936507936507936
Craniofacial dysplasia-short stature-ectodermal anomalies-intellectual disability syndrome,29947,5,40,42,36,6,28,4,24,0.9,0.1,0.8571428571428571,0.9,0.14285714285714285,0.1
Corpus callosum agenesis-macrocephaly-hypertelorism syndrome,33432,10,10,26,9,17,37,4,33,0.9,0.4,0.34615384615384615,0.9,0.10810810810810811,0.4
PYCR2-related microcephaly-progressive leukoencephalopathy,32474,0,62,21,22,-1,28,5,23,0.3548387096774194,0.08064516129032258,1.0476190476190477,0.3548387096774194,0.17857142857142858,0.08064516129032258
16p12.1p12.3 triplication syndrome,32260,0,44,18,18,0,27,1,26,0.4090909090909091,0.022727272727272728,1.0,0.4090909090909091,0.037037037037037035,0.022727272727272728
Pierpont syndrome,30736,0,48,18,10,8,34,0,34,0.20833333333333334,0.0,0.5555555555555556,0.20833333333333334,0.0,0.0
PMP22-RAI1 contiguous gene duplication syndrome,30406,1,46,26,13,13,19,1,18,0.2826086956521739,0.021739130434782608,0.5,0.2826086956521739,0.05263157894736842,0.021739130434782608
Palatal anomalies-widely spaced teeth-facial dysmorphism-developmental delay syndrome,31752,2,42,50,38,12,21,3,18,0.9047619047619048,0.07142857142857142,0.76,0.9047619047619048,0.14285714285714285,0.07142857142857142
Recurrent metabolic encephalomyopathic crises-rhabdomyolysis-cardiac arrhythmia-intellectual disability syndrome,29006,2,51,18,8,10,17,4,13,0.1568627450980392,0.0784313725490196,0.4444444444444444,0.1568627450980392,0.23529411764705882,0.0784313725490196
Global developmental delay-visual anomalies-progressive cerebellar atrophy-truncal hypotonia syndrome,32864,1,31,19,17,2,29,0,29,0.5483870967741935,0.0,0.8947368421052632,0.5483870967741935,0.0,0.0
TELO2-related intellectual disability-neurodevelopmental disorder,27209,2,52,28,21,7,24,2,22,0.40384615384615385,0.038461538461538464,0.75,0.40384615384615385,0.08333333333333333,0.038461538461538464
9q33.3q34.11 microdeletion syndrome,32429,4,53,99,8,91,27,1,26,0.1509433962264151,0.018867924528301886,0.08080808080808081,0.1509433962264151,0.037037037037037035,0.018867924528301886
"Camptodactyly syndrome, Guadalajara type 3",27865,0,27,65,14,51,12,0,12,0.5185185185185185,0.0,0.2153846153846154,0.5185185185185185,0.0,0.0
Transketolase deficiency,30944,0,27,20,17,3,28,0,28,0.6296296296296297,0.0,0.85,0.6296296296296297,0.0,0.0
Severe growth deficiency-strabismus-extensive dermal melanocytosis-intellectual disability syndrome,29388,4,41,39,35,4,38,2,36,0.8536585365853658,0.04878048780487805,0.8974358974358975,0.8536585365853658,0.05263157894736842,0.04878048780487805
13q12.3 microdeletion syndrome,32429,2,30,16,1,15,21,1,20,0.03333333333333333,0.03333333333333333,0.0625,0.03333333333333333,0.047619047619047616,0.03333333333333333
Intellectual disability-coarse face-macrocephaly-cerebellar hypotrophy syndrome,38540,17,54,19,4,15,29,4,25,0.07407407407407407,0.07407407407407407,0.21052631578947367,0.07407407407407407,0.13793103448275862,0.07407407407407407
Severe hemophilia A,27361,5,27,26,18,8,33,7,26,0.6666666666666666,0.25925925925925924,0.6923076923076923,0.6666666666666666,0.21212121212121213,0.25925925925925924
Macrocephaly-developmental delay syndrome,29174,4,26,17,14,3,38,4,34,0.5384615384615384,0.15384615384615385,0.8235294117647058,0.5384615384615384,0.10526315789473684,0.15384615384615385
Primary microcephaly-mild intellectual disability-young-onset diabetes syndrome,32976,3,67,27,27,0,28,3,25,0.40298507462686567,0.04477611940298507,1.0,0.40298507462686567,0.10714285714285714,0.04477611940298507
FOXP1 Syndrome,39034,9,60,28,1,27,32,4,28,0.016666666666666666,0.06666666666666667,0.03571428571428571,0.016666666666666666,0.125,0.06666666666666667
Severe intellectual disability-short stature-behavioral abnormalities-facial dysmorphism syndrome,31212,4,29,18,15,3,31,3,28,0.5172413793103449,0.10344827586206896,0.8333333333333334,0.5172413793103449,0.0967741935483871,0.10344827586206896
Hypotonia-speech impairment-severe cognitive delay syndrome,33544,2,55,50,51,-1,27,3,24,0.9272727272727272,0.05454545454545454,1.02,0.9272727272727272,0.1111111111111111,0.05454545454545454
14q24.1q24.3 microdeletion syndrome,32429,5,24,99,5,94,29,1,28,0.20833333333333334,0.041666666666666664,0.050505050505050504,0.20833333333333334,0.034482758620689655,0.041666666666666664
9q31.1q31.3 microdeletion syndrome,32429,5,22,101,3,98,34,1,33,0.13636363636363635,0.045454545454545456,0.0297029702970297,0.13636363636363635,0.029411764705882353,0.045454545454545456
Optic atrophy-intellectual disability syndrome,31888,3,39,19,17,2,29,5,24,0.4358974358974359,0.1282051282051282,0.8947368421052632,0.4358974358974359,0.1724137931034483,0.1282051282051282
Intellectual disability-obesity-prognathism-eye and skin anomalies syndrome,29848,4,27,20,15,5,48,4,44,0.5555555555555556,0.14814814814814814,0.75,0.5555555555555556,0.08333333333333333,0.14814814814814814
Microcephaly-thin corpus callosum-intellectual disability syndrome,29190,3,18,24,20,4,25,1,24,1.1111111111111112,0.05555555555555555,0.8333333333333334,1.1111111111111112,0.04,0.05555555555555555
Temple-Baraitser syndrome,28286,1,48,25,22,3,34,2,32,0.4583333333333333,0.041666666666666664,0.88,0.4583333333333333,0.058823529411764705,0.041666666666666664
AHDC1-related intellectual disability-obstructive sleep apnea-mild dysmorphism syndrome,28954,1,45,19,17,2,17,4,13,0.37777777777777777,0.08888888888888889,0.8947368421052632,0.37777777777777777,0.23529411764705882,0.08888888888888889
PDE4D haploinsufficiency syndrome,31595,4,60,19,14,5,38,3,35,0.23333333333333334,0.05,0.7368421052631579,0.23333333333333334,0.07894736842105263,0.05
Combined oxidative phosphorylation defect type 23,38594,10,27,25,4,21,16,2,14,0.14814814814814814,0.07407407407407407,0.16,0.14814814814814814,0.125,0.07407407407407407
PCNA-related progressive neurodegenerative photosensitivity syndrome,30743,2,16,17,8,9,44,1,43,0.5,0.0625,0.47058823529411764,0.5,0.022727272727272728,0.0625
Retinitis pigmentosa-juvenile cataract-short stature-intellectual disability syndrome,29989,3,27,28,22,6,27,2,25,0.8148148148148148,0.07407407407407407,0.7857142857142857,0.8148148148148148,0.07407407407407407,0.07407407407407407
FBLN1-related developmental delay-central nervous system anomaly-syndactyly syndrome,32938,1,18,15,15,0,21,3,18,0.8333333333333334,0.16666666666666666,1.0,0.8333333333333334,0.14285714285714285,0.16666666666666666
Early-onset epileptic encephalopathy-cortical blindness-intellectual disability-facial dysmorphism syndrome,28987,2,36,34,7,27,27,3,24,0.19444444444444445,0.08333333333333333,0.20588235294117646,0.19444444444444445,0.1111111111111111,0.08333333333333333
Polyendocrine-polyneuropathy syndrome,27386,1,23,16,12,4,23,1,22,0.5217391304347826,0.043478260869565216,0.75,0.5217391304347826,0.043478260869565216,0.043478260869565216
Infantile-onset axonal motor and sensory neuropathy-optic atrophy-neurodegenerative syndrome,33527,0,26,19,18,1,26,0,26,0.6923076923076923,0.0,0.9473684210526315,0.6923076923076923,0.0,0.0
Neurodevelopmental disorder-craniofacial dysmorphism-cardiac defect-skeletal anomalies syndrome,29350,0,71,18,2,16,35,9,26,0.028169014084507043,0.1267605633802817,0.1111111111111111,0.028169014084507043,0.2571428571428571,0.1267605633802817
Congenital insensitivity to pain with severe intellectual disability,33107,0,29,17,18,-1,27,0,27,0.6206896551724138,0.0,1.0588235294117647,0.6206896551724138,0.0,0.0
19p13.3 microduplication syndrome,32305,1,51,18,18,0,30,4,26,0.35294117647058826,0.0784313725490196,1.0,0.35294117647058826,0.13333333333333333,0.0784313725490196
Spastic tetraplegia-thin corpus callosum-progressive postnatal microcephaly syndrome,28523,1,34,24,20,4,18,3,15,0.5882352941176471,0.08823529411764706,0.8333333333333334,0.5882352941176471,0.16666666666666666,0.08823529411764706
Cerebellar-facial-dental syndrome,38540,12,52,35,0,35,32,2,30,0.0,0.038461538461538464,0.0,0.0,0.0625,0.038461538461538464
Cognitive impairment-coarse facies-heart defects-obesity-pulmonary involvement-short stature-skeletal dysplasia syndrome,31335,3,79,23,21,2,26,5,21,0.26582278481012656,0.06329113924050633,0.9130434782608695,0.26582278481012656,0.19230769230769232,0.06329113924050633
Hypohidrosis-enamel hypoplasia-palmoplantar keratoderma-intellectual disability syndrome,27790,3,16,18,14,4,23,4,19,0.875,0.25,0.7777777777777778,0.875,0.17391304347826086,0.25
Intellectual disability-strabismus syndrome,31873,4,72,68,62,6,34,5,29,0.8611111111111112,0.06944444444444445,0.9117647058823529,0.8611111111111112,0.14705882352941177,0.06944444444444445
CTCF-related neurodevelopmental disorder,32357,0,71,18,2,16,36,2,34,0.028169014084507043,0.028169014084507043,0.1111111111111111,0.028169014084507043,0.05555555555555555,0.028169014084507043
20q11.2 microduplication syndrome,32995,2,53,17,3,14,25,2,23,0.05660377358490566,0.03773584905660377,0.17647058823529413,0.05660377358490566,0.08,0.03773584905660377
Classical-like Ehlers-Danlos syndrome type 2,32436,1,63,56,10,46,23,2,21,0.15873015873015872,0.031746031746031744,0.17857142857142858,0.15873015873015872,0.08695652173913043,0.031746031746031744
Kyphoscoliotic Ehlers-Danlos syndrome,33340,7,65,20,20,0,38,10,28,0.3076923076923077,0.15384615384615385,1.0,0.3076923076923077,0.2631578947368421,0.15384615384615385
Spondylodysplastic Ehlers-Danlos syndrome,38339,18,105,35,6,29,28,2,26,0.05714285714285714,0.01904761904761905,0.17142857142857143,0.05714285714285714,0.07142857142857142,0.01904761904761905
Myopathic Ehlers-Danlos syndrome,94824,15,49,30,2,28,18,1,17,0.04081632653061224,0.02040816326530612,0.06666666666666667,0.04081632653061224,0.05555555555555555,0.02040816326530612
Congenital factor V deficiency,31456,4,19,21,17,4,12,5,7,0.8947368421052632,0.2631578947368421,0.8095238095238095,0.8947368421052632,0.4166666666666667,0.2631578947368421
Purine nucleoside phosphorylase deficiency,31390,0,29,20,12,8,21,0,21,0.41379310344827586,0.0,0.6,0.41379310344827586,0.0,0.0
Leukocyte adhesion deficiency,28125,0,52,19,9,10,25,11,14,0.17307692307692307,0.21153846153846154,0.47368421052631576,0.17307692307692307,0.44,0.21153846153846154
Anterior cutaneous nerve entrapment syndrome,32304,1,17,16,15,1,24,1,23,0.8823529411764706,0.058823529411764705,0.9375,0.8823529411764706,0.041666666666666664,0.058823529411764705
Cryptogenic organizing pneumonia,32926,8,27,16,17,-1,26,14,12,0.6296296296296297,0.5185185185185185,1.0625,0.6296296296296297,0.5384615384615384,0.5185185185185185
Dehydrated hereditary stomatocytosis,29701,0,27,17,6,11,28,1,27,0.2222222222222222,0.037037037037037035,0.35294117647058826,0.2222222222222222,0.03571428571428571,0.037037037037037035
Primary non-essential cutis verticis gyrata,32456,0,16,19,12,7,13,0,13,0.75,0.0,0.631578947368421,0.75,0.0,0.0
THOC6-related developmental delay-microcephaly-facial dysmorphism syndrome,28947,3,44,41,35,6,32,1,31,0.7954545454545454,0.022727272727272728,0.8536585365853658,0.7954545454545454,0.03125,0.022727272727272728
Intellectual disability-facial dysmorphism-hand anomalies syndrome,33549,1,34,23,21,2,33,2,31,0.6176470588235294,0.058823529411764705,0.9130434782608695,0.6176470588235294,0.06060606060606061,0.058823529411764705
Intellectual disability-seizures-hypophosphatasia-ophthalmic-skeletal anomalies syndrome,38365,24,71,32,6,26,32,6,26,0.08450704225352113,0.08450704225352113,0.1875,0.08450704225352113,0.1875,0.08450704225352113
Musculocontractural Ehlers-Danlos syndrome,28883,2,63,27,14,13,29,3,26,0.2222222222222222,0.047619047619047616,0.5185185185185185,0.2222222222222222,0.10344827586206896,0.047619047619047616
Ataxia-intellectual disability-oculomotor apraxia-cerebellar cysts syndrome,27757,2,22,17,5,12,5,2,3,0.22727272727272727,0.09090909090909091,0.29411764705882354,0.22727272727272727,0.4,0.09090909090909091
Histiocytoid cardiomyopathy,32712,2,44,25,26,-1,29,2,27,0.5909090909090909,0.045454545454545456,1.04,0.5909090909090909,0.06896551724137931,0.045454545454545456
Cardiac-valvular Ehlers-Danlos syndrome,32052,3,49,25,21,4,17,4,13,0.42857142857142855,0.08163265306122448,0.84,0.42857142857142855,0.23529411764705882,0.08163265306122448
Developmental delay-facial dysmorphism syndrome due to MED13L deficiency,28191,2,66,17,3,14,28,4,24,0.045454545454545456,0.06060606060606061,0.17647058823529413,0.045454545454545456,0.14285714285714285,0.06060606060606061
Autosomal dominant Charcot-Marie-Tooth disease type 2Z,29098,2,73,28,14,14,20,6,14,0.1917808219178082,0.0821917808219178,0.5,0.1917808219178082,0.3,0.0821917808219178
Combined deficiency of factor V and factor VIII,31415,10,18,23,4,19,20,4,16,0.2222222222222222,0.2222222222222222,0.17391304347826086,0.2222222222222222,0.2,0.2222222222222222
Tetanus,95672,14,30,19,5,14,18,7,11,0.16666666666666666,0.23333333333333334,0.2631578947368421,0.16666666666666666,0.3888888888888889,0.23333333333333334
Plague,33193,5,55,17,19,-2,29,11,18,0.34545454545454546,0.2,1.1176470588235294,0.34545454545454546,0.3793103448275862,0.2
Rat-bite fever,33329,3,32,16,16,0,16,6,10,0.5,0.1875,1.0,0.5,0.375,0.1875
Nocardiosis,33334,4,52,17,18,-1,22,9,13,0.34615384615384615,0.17307692307692307,1.0588235294117647,0.34615384615384615,0.4090909090909091,0.17307692307692307
Intellectual disability-brachydactyly-Pierre Robin syndrome,32698,3,43,24,22,2,26,3,23,0.5116279069767442,0.06976744186046512,0.9166666666666666,0.5116279069767442,0.11538461538461539,0.06976744186046512
Brooke-Spiegler syndrome,28649,1,20,22,20,2,35,1,34,1.0,0.05,0.9090909090909091,1.0,0.02857142857142857,0.05
Chronic actinic dermatitis,32235,5,12,18,9,9,13,2,11,0.75,0.16666666666666666,0.5,0.75,0.15384615384615385,0.16666666666666666
Severe combined immunodeficiency due to complete RAG1/2 deficiency,30125,1,29,29,28,1,30,2,28,0.9655172413793104,0.06896551724137931,0.9655172413793104,0.9655172413793104,0.06666666666666667,0.06896551724137931
Preeclampsia,33512,4,27,16,15,1,18,7,11,0.5555555555555556,0.25925925925925924,0.9375,0.5555555555555556,0.3888888888888889,0.25925925925925924
Combined malonic and methylmalonic acidemia,39044,15,26,21,2,19,28,4,24,0.07692307692307693,0.15384615384615385,0.09523809523809523,0.07692307692307693,0.14285714285714285,0.15384615384615385
Kaposiform lymphangiomatosis,33541,2,46,28,30,-2,35,9,26,0.6521739130434783,0.1956521739130435,1.0714285714285714,0.6521739130434783,0.2571428571428571,0.1956521739130435
Atelosteogenesis type I,30049,1,32,16,7,9,26,1,25,0.21875,0.03125,0.4375,0.21875,0.038461538461538464,0.03125
Neonatal lupus erythematosus,27752,6,36,22,24,-2,29,11,18,0.6666666666666666,0.3055555555555556,1.0909090909090908,0.6666666666666666,0.3793103448275862,0.3055555555555556
Secondary non-traumatic avascular necrosis,32646,1,13,11,11,0,21,2,19,0.8461538461538461,0.15384615384615385,1.0,0.8461538461538461,0.09523809523809523,0.15384615384615385
Microcephalic cortical malformations-short stature due to RTTN deficiency,33395,1,73,66,68,-2,24,2,22,0.9315068493150684,0.0273972602739726,1.0303030303030303,0.9315068493150684,0.08333333333333333,0.0273972602739726
Schuurs-Hoeijmakers syndrome,29025,0,59,59,49,10,4,0,4,0.8305084745762712,0.0,0.8305084745762712,0.8305084745762712,0.0,0.0
Aphonia-deafness-retinal dystrophy-bifid halluces-intellectual disability syndrome,32784,1,35,30,30,0,33,1,32,0.8571428571428571,0.02857142857142857,1.0,0.8571428571428571,0.030303030303030304,0.02857142857142857
"Microcephalic primordial dwarfism, Dauber type",30346,4,22,39,4,35,44,2,42,0.18181818181818182,0.09090909090909091,0.10256410256410256,0.18181818181818182,0.045454545454545456,0.09090909090909091
Glycogen storage disease due to liver phosphorylase kinase deficiency,32211,2,51,17,14,3,22,6,16,0.27450980392156865,0.11764705882352941,0.8235294117647058,0.27450980392156865,0.2727272727272727,0.11764705882352941
Isolated posterior meningocele,33600,1,21,27,3,24,19,1,18,0.14285714285714285,0.047619047619047616,0.1111111111111111,0.14285714285714285,0.05263157894736842,0.047619047619047616
Autism spectrum disorder due to AUTS2 deficiency,29985,2,55,25,23,2,24,2,22,0.41818181818181815,0.03636363636363636,0.92,0.41818181818181815,0.08333333333333333,0.03636363636363636
Pulmonary arteriovenous malformation,32523,4,28,16,16,0,21,8,13,0.5714285714285714,0.2857142857142857,1.0,0.5714285714285714,0.38095238095238093,0.2857142857142857
Glomuvenous malformation,28459,0,16,17,17,0,32,0,32,1.0625,0.0,1.0,1.0625,0.0,0.0
Jervell and Lange-Nielsen syndrome,38598,17,11,32,3,29,21,1,20,0.2727272727272727,0.09090909090909091,0.09375,0.2727272727272727,0.047619047619047616,0.09090909090909091
Gyrate atrophy of choroid and retina,96982,19,16,24,3,21,30,4,26,0.1875,0.25,0.125,0.1875,0.13333333333333333,0.25
Herpes simplex virus encephalitis,33127,3,30,23,23,0,25,4,21,0.7666666666666667,0.13333333333333333,1.0,0.7666666666666667,0.16,0.13333333333333333
Congenital enterovirus infection,99420,8,39,22,2,20,35,9,26,0.05128205128205128,0.23076923076923078,0.09090909090909091,0.05128205128205128,0.2571428571428571,0.23076923076923078
Multicentric osteolysis-nodulosis-arthropathy spectrum,29152,2,39,33,9,24,30,4,26,0.23076923076923078,0.10256410256410256,0.2727272727272727,0.23076923076923078,0.13333333333333333,0.10256410256410256
Cryptococcosis,32601,2,42,16,14,2,21,6,15,0.3333333333333333,0.14285714285714285,0.875,0.3333333333333333,0.2857142857142857,0.14285714285714285
Microsporidiosis,32749,4,51,17,18,-1,16,5,11,0.35294117647058826,0.09803921568627451,1.0588235294117647,0.35294117647058826,0.3125,0.09803921568627451
Relapsing fever,32949,5,32,17,18,-1,21,6,15,0.5625,0.1875,1.0588235294117647,0.5625,0.2857142857142857,0.1875
Short ulna-dysmorphism-hypotonia-intellectual disability syndrome,28248,2,25,24,21,3,46,3,43,0.84,0.12,0.875,0.84,0.06521739130434782,0.12
19p13.13 microdeletion syndrome,31251,2,47,28,25,3,29,1,28,0.5319148936170213,0.02127659574468085,0.8928571428571429,0.5319148936170213,0.034482758620689655,0.02127659574468085
ANK3-related intellectual disability-sleep disturbance syndrome,30443,2,13,14,11,3,20,1,19,0.8461538461538461,0.07692307692307693,0.7857142857142857,0.8461538461538461,0.05,0.07692307692307693
Syndromic diarrhea,99693,15,52,18,0,18,26,0,26,0.0,0.0,0.0,0.0,0.0,0.0
Congenital analbuminemia,31640,1,19,17,16,1,32,2,30,0.8421052631578947,0.10526315789473684,0.9411764705882353,0.8421052631578947,0.0625,0.10526315789473684
Acquired von Willebrand syndrome,39535,13,27,24,3,21,19,3,16,0.1111111111111111,0.1111111111111111,0.125,0.1111111111111111,0.15789473684210525,0.1111111111111111
Hereditary methemoglobinemia,30126,10,26,22,3,19,26,2,24,0.11538461538461539,0.07692307692307693,0.13636363636363635,0.11538461538461539,0.07692307692307693,0.07692307692307693
Overhydrated hereditary stomatocytosis,28159,0,11,30,12,18,14,0,14,1.0909090909090908,0.0,0.4,1.0909090909090908,0.0,0.0
"Blepharophimosis-intellectual disability syndrome, Verloes type",35826,11,32,22,0,22,30,1,29,0.0,0.03125,0.0,0.0,0.03333333333333333,0.03125
11p15.4 microduplication syndrome,32497,1,18,17,16,1,20,1,19,0.8888888888888888,0.05555555555555555,0.9411764705882353,0.8888888888888888,0.05,0.05555555555555555
Polymicrogyria due to TUBB2B mutation,27528,10,30,16,6,10,27,4,23,0.2,0.13333333333333333,0.375,0.2,0.14814814814814814,0.13333333333333333
20p13 microdeletion syndrome,32620,2,35,27,25,2,27,4,23,0.7142857142857143,0.11428571428571428,0.9259259259259259,0.7142857142857143,0.14814814814814814,0.11428571428571428
"Phosphoserine aminotransferase deficiency, infantile/juvenile form",30849,0,40,41,36,5,23,0,23,0.9,0.0,0.8780487804878049,0.9,0.0,0.0
Early-onset epileptic encephalopathy and intellectual disability due to GRIN2A mutation,33426,0,29,25,23,2,24,1,23,0.7931034482758621,0.034482758620689655,0.92,0.7931034482758621,0.041666666666666664,0.034482758620689655
Intellectual disability-alacrima-achalasia syndrome,27364,2,16,16,5,11,16,3,13,0.3125,0.1875,0.3125,0.3125,0.1875,0.1875
"Blepharophimosis-intellectual disability syndrome, MKB type",35826,19,8,26,3,23,24,2,22,0.375,0.25,0.11538461538461539,0.375,0.08333333333333333,0.25
Kagami-Ogata syndrome,32472,0,40,17,17,0,30,0,30,0.425,0.0,1.0,0.425,0.0,0.0
21q22.11q22.12 microdeletion syndrome,32429,6,59,104,16,88,34,3,31,0.2711864406779661,0.05084745762711865,0.15384615384615385,0.2711864406779661,0.08823529411764706,0.05084745762711865
Infantile spasms-psychomotor retardation-progressive brain atrophy-basal ganglia disease syndrome,32498,4,25,20,21,-1,49,7,42,0.84,0.28,1.05,0.84,0.14285714285714285,0.28
Recessive intellectual disability-motor dysfunction-multiple joint contractures syndrome,32650,0,20,20,17,3,27,0,27,0.85,0.0,0.85,0.85,0.0,0.0
Pyknoachondrogenesis,29554,0,23,16,14,2,24,0,24,0.6086956521739131,0.0,0.875,0.6086956521739131,0.0,0.0
Distal deletion 10q syndrome,29728,4,92,87,67,20,27,6,21,0.7282608695652174,0.06521739130434782,0.7701149425287356,0.7282608695652174,0.2222222222222222,0.06521739130434782
Isolated tibial hemimelia,30666,0,33,23,21,2,12,1,11,0.6363636363636364,0.030303030303030304,0.9130434782608695,0.6363636363636364,0.08333333333333333,0.030303030303030304
Neonatal acute respiratory distress syndrome,39872,6,11,26,4,22,22,1,21,0.36363636363636365,0.09090909090909091,0.15384615384615385,0.36363636363636365,0.045454545454545456,0.09090909090909091
Congenitally corrected transposition of the great arteries,38925,7,49,23,7,16,20,3,17,0.14285714285714285,0.061224489795918366,0.30434782608695654,0.14285714285714285,0.15,0.061224489795918366
Stevens-Johnson syndrome/toxic epidermal necrolysis spectrum,32746,8,64,32,8,24,28,9,19,0.125,0.140625,0.25,0.125,0.32142857142857145,0.140625
Intellectual disability-hypotonia-brachycephaly-pyloric stenosis-cryptorchidism syndrome,32599,5,14,16,2,14,20,2,18,0.14285714285714285,0.14285714285714285,0.125,0.14285714285714285,0.1,0.14285714285714285
2q23.1 microduplication syndrome,31466,3,37,19,3,16,31,2,29,0.08108108108108109,0.05405405405405406,0.15789473684210525,0.08108108108108109,0.06451612903225806,0.05405405405405406
Distal 17p13.1 microdeletion syndrome,95065,17,23,22,3,19,22,2,20,0.13043478260869565,0.08695652173913043,0.13636363636363635,0.13043478260869565,0.09090909090909091,0.08695652173913043
Mycetoma,32734,0,29,16,15,1,24,0,24,0.5172413793103449,0.0,0.9375,0.5172413793103449,0.0,0.0
Leptospirosis,33314,5,40,17,17,0,21,9,12,0.425,0.225,1.0,0.425,0.42857142857142855,0.225
Neonatal intrahepatic cholestasis due to citrin deficiency,29408,6,41,24,10,14,20,6,14,0.24390243902439024,0.14634146341463414,0.4166666666666667,0.24390243902439024,0.3,0.14634146341463414
Brachydactyly type A7,29488,2,17,16,2,14,14,0,14,0.11764705882352941,0.0,0.125,0.11764705882352941,0.0,0.0
Multiple acyl-CoA dehydrogenase deficiency,98500,18,58,24,5,19,34,6,28,0.08620689655172414,0.10344827586206896,0.20833333333333334,0.08620689655172414,0.17647058823529413,0.10344827586206896
Isolated biliary atresia,99178,10,28,17,5,12,16,4,12,0.17857142857142858,0.14285714285714285,0.29411764705882354,0.17857142857142858,0.25,0.14285714285714285
MAN1B1-CDG,33411,0,53,36,35,1,13,0,13,0.660377358490566,0.0,0.9722222222222222,0.660377358490566,0.0,0.0
PGM3-CDG,31521,0,63,46,37,9,23,0,23,0.5873015873015873,0.0,0.8043478260869565,0.5873015873015873,0.0,0.0
XYLT1-CDG,32288,1,29,26,26,0,21,1,20,0.896551724137931,0.034482758620689655,1.0,0.896551724137931,0.047619047619047616,0.034482758620689655
Congenital muscular dystrophy with intellectual disability and severe epilepsy,29208,3,40,87,35,52,29,1,28,0.875,0.025,0.40229885057471265,0.875,0.034482758620689655,0.025
Temtamy preaxial brachydactyly syndrome,28256,0,48,23,20,3,30,1,29,0.4166666666666667,0.020833333333333332,0.8695652173913043,0.4166666666666667,0.03333333333333333,0.020833333333333332
Alpha-dystroglycan-related limb-girdle muscular dystrophy R16,27315,2,15,14,0,14,24,0,24,0.0,0.0,0.0,0.0,0.0,0.0
SRD5A3-CDG,27783,1,33,18,9,9,27,2,25,0.2727272727272727,0.06060606060606061,0.5,0.2727272727272727,0.07407407407407407,0.06060606060606061
COG1-CDG,28894,1,43,56,39,17,21,1,20,0.9069767441860465,0.023255813953488372,0.6964285714285714,0.9069767441860465,0.047619047619047616,0.023255813953488372
ALG11-CDG,31434,1,40,23,22,1,16,2,14,0.55,0.05,0.9565217391304348,0.55,0.125,0.05
COG5-CDG,28972,2,46,42,39,3,23,0,23,0.8478260869565217,0.0,0.9285714285714286,0.8478260869565217,0.0,0.0
"Spondyloepiphyseal dysplasia tarda, Kohn type",31270,0,11,39,2,37,21,0,21,0.18181818181818182,0.0,0.05128205128205128,0.18181818181818182,0.0,0.0
COG8-CDG,29748,0,24,21,2,19,26,2,24,0.08333333333333333,0.08333333333333333,0.09523809523809523,0.08333333333333333,0.07692307692307693,0.08333333333333333
POMT2-related limb-girdle muscular dystrophy R14,29368,6,20,16,2,14,26,1,25,0.1,0.05,0.125,0.1,0.038461538461538464,0.05
Temple syndrome,28286,0,28,17,1,16,24,0,24,0.03571428571428571,0.0,0.058823529411764705,0.03571428571428571,0.0,0.0
Polymicrogyria with optic nerve hypoplasia,31794,2,14,18,15,3,32,1,31,1.0714285714285714,0.07142857142857142,0.8333333333333334,1.0714285714285714,0.03125,0.07142857142857142
Hyperphosphatasia-intellectual disability syndrome,27923,2,62,75,22,53,32,2,30,0.3548387096774194,0.03225806451612903,0.29333333333333333,0.3548387096774194,0.0625,0.03225806451612903
X-linked Charcot-Marie-Tooth disease type 6,27530,7,16,30,2,28,27,3,24,0.125,0.1875,0.06666666666666667,0.125,0.1111111111111111,0.1875
Alazami syndrome,31536,1,31,17,0,17,48,2,46,0.0,0.06451612903225806,0.0,0.0,0.041666666666666664,0.06451612903225806
Syndromic multisystem autoimmune disease due to Itch deficiency,31599,0,38,18,10,8,10,0,10,0.2631578947368421,0.0,0.5555555555555556,0.2631578947368421,0.0,0.0
Pseudoaminopterin syndrome,31751,0,63,70,54,16,33,0,33,0.8571428571428571,0.0,0.7714285714285715,0.8571428571428571,0.0,0.0
Zechi-Ceide syndrome,32162,0,34,19,17,2,6,0,6,0.5,0.0,0.8947368421052632,0.5,0.0,0.0
Brain-lung-thyroid syndrome,27955,2,60,33,31,2,14,4,10,0.5166666666666667,0.06666666666666667,0.9393939393939394,0.5166666666666667,0.2857142857142857,0.06666666666666667
Combined oxidative phosphorylation defect type 27,38594,16,29,29,0,29,29,2,27,0.0,0.06896551724137931,0.0,0.0,0.06896551724137931,0.06896551724137931
SLC39A8-CDG,29977,0,41,17,2,15,23,0,23,0.04878048780487805,0.0,0.11764705882352941,0.04878048780487805,0.0,0.0
T-B+ severe combined immunodeficiency due to CD3delta/CD3epsilon/CD3zeta,32891,1,23,17,18,-1,15,1,14,0.782608695652174,0.043478260869565216,1.0588235294117647,0.782608695652174,0.06666666666666667,0.043478260869565216
T-B+ severe combined immunodeficiency due to IL-7Ralpha deficiency,32859,1,29,18,17,1,36,4,32,0.5862068965517241,0.13793103448275862,0.9444444444444444,0.5862068965517241,0.1111111111111111,0.13793103448275862
Isobutyryl-CoA dehydrogenase deficiency,30332,9,11,22,7,15,20,1,19,0.6363636363636364,0.09090909090909091,0.3181818181818182,0.6363636363636364,0.05,0.09090909090909091
Atresia of urethra,32640,2,14,17,11,6,20,2,18,0.7857142857142857,0.14285714285714285,0.6470588235294118,0.7857142857142857,0.1,0.14285714285714285
Duplication of urethra,32457,3,26,20,21,-1,21,5,16,0.8076923076923077,0.19230769230769232,1.05,0.8076923076923077,0.23809523809523808,0.19230769230769232
Developmental and epileptic encephalopathy with spike-wave activation in sleep,33205,3,30,18,22,-4,28,4,24,0.7333333333333333,0.13333333333333333,1.2222222222222223,0.7333333333333333,0.14285714285714285,0.13333333333333333
Short chain acyl-CoA dehydrogenase deficiency,38510,18,24,30,3,27,26,1,25,0.125,0.041666666666666664,0.1,0.125,0.038461538461538464,0.041666666666666664
Glucose-galactose malabsorption,28234,4,15,19,13,6,24,4,20,0.8666666666666667,0.26666666666666666,0.6842105263157895,0.8666666666666667,0.16666666666666666,0.26666666666666666
Serotonin syndrome,33091,9,34,21,23,-2,27,16,11,0.6764705882352942,0.47058823529411764,1.0952380952380953,0.6764705882352942,0.5925925925925926,0.47058823529411764
Idiopathic neonatal atrial flutter,32647,2,15,14,15,-1,23,3,20,1.0,0.2,1.0714285714285714,1.0,0.13043478260869565,0.2
Galactokinase deficiency,30605,1,26,17,15,2,21,1,20,0.5769230769230769,0.038461538461538464,0.8823529411764706,0.5769230769230769,0.047619047619047616,0.038461538461538464
Classic galactosemia,39443,12,54,23,9,14,35,10,25,0.16666666666666666,0.18518518518518517,0.391304347826087,0.16666666666666666,0.2857142857142857,0.18518518518518517
Proximal renal tubular acidosis,31011,2,34,18,4,14,25,4,21,0.11764705882352941,0.11764705882352941,0.2222222222222222,0.11764705882352941,0.16,0.11764705882352941
Generalized arterial calcification of infancy,33393,2,64,27,30,-3,35,4,31,0.46875,0.0625,1.1111111111111112,0.46875,0.11428571428571428,0.0625
Caroli disease,27699,3,33,17,15,2,22,10,12,0.45454545454545453,0.30303030303030304,0.8823529411764706,0.45454545454545453,0.45454545454545453,0.30303030303030304
Pulmonary nodular lymphoid hyperplasia,29261,4,10,16,11,5,26,4,22,1.1,0.4,0.6875,1.1,0.15384615384615385,0.4
Distal renal tubular acidosis,31011,4,38,17,5,12,19,9,10,0.13157894736842105,0.23684210526315788,0.29411764705882354,0.13157894736842105,0.47368421052631576,0.23684210526315788
Fanconi-Bickel syndrome,28453,16,31,22,3,19,29,9,20,0.0967741935483871,0.2903225806451613,0.13636363636363635,0.0967741935483871,0.3103448275862069,0.2903225806451613
Oligomeganephronia,33501,2,30,26,26,0,27,5,22,0.8666666666666667,0.16666666666666666,1.0,0.8666666666666667,0.18518518518518517,0.16666666666666666
Hereditary hypophosphatemic rickets with hypercalciuria,27464,1,21,33,16,17,20,3,17,0.7619047619047619,0.14285714285714285,0.48484848484848486,0.7619047619047619,0.15,0.14285714285714285
Opsoclonus-myoclonus syndrome,33201,2,22,18,18,0,21,3,18,0.8181818181818182,0.13636363636363635,1.0,0.8181818181818182,0.14285714285714285,0.13636363636363635
Primary Fanconi renotubular syndrome,38277,8,29,35,4,31,25,3,22,0.13793103448275862,0.10344827586206896,0.11428571428571428,0.13793103448275862,0.12,0.10344827586206896
Tracheobronchopathia osteochondroplastica,29623,7,23,18,18,0,25,9,16,0.782608695652174,0.391304347826087,1.0,0.782608695652174,0.36,0.391304347826087
Rasmussen subacute encephalitis,33120,1,48,29,24,5,22,4,18,0.5,0.08333333333333333,0.8275862068965517,0.5,0.18181818181818182,0.08333333333333333
Gorham-Stout disease,29373,3,36,26,25,1,18,4,14,0.6944444444444444,0.1111111111111111,0.9615384615384616,0.6944444444444444,0.2222222222222222,0.1111111111111111
Pyruvate carboxylase deficiency,31962,5,70,75,66,9,23,5,18,0.9428571428571428,0.07142857142857142,0.88,0.9428571428571428,0.21739130434782608,0.07142857142857142
Congenital plasminogen activator inhibitor type 1 deficiency,27824,2,25,17,15,2,32,5,27,0.6,0.2,0.8823529411764706,0.6,0.15625,0.2
Oculocutaneous albinism type 3,84278,8,13,28,4,24,32,2,30,0.3076923076923077,0.15384615384615385,0.14285714285714285,0.3076923076923077,0.0625,0.15384615384615385
Asbestos intoxication,33056,3,35,16,15,1,20,8,12,0.42857142857142855,0.22857142857142856,0.9375,0.42857142857142855,0.4,0.22857142857142856
Mosaic trisomy 16 syndrome,33435,4,43,17,17,0,43,7,36,0.3953488372093023,0.16279069767441862,1.0,0.3953488372093023,0.16279069767441862,0.16279069767441862
Hereditary xanthinuria,33353,4,22,18,16,2,19,5,14,0.7272727272727273,0.22727272727272727,0.8888888888888888,0.7272727272727273,0.2631578947368421,0.22727272727272727
Pontocerebellar hypoplasia type 2,27716,7,40,33,8,25,25,0,25,0.2,0.0,0.24242424242424243,0.2,0.0,0.0
Localized scleroderma,33228,5,55,20,20,0,38,9,29,0.36363636363636365,0.16363636363636364,1.0,0.36363636363636365,0.23684210526315788,0.16363636363636364
Ring chromosome 21 syndrome,32369,2,30,16,16,0,26,4,22,0.5333333333333333,0.13333333333333333,1.0,0.5333333333333333,0.15384615384615385,0.13333333333333333
Pentosuria,31585,1,3,20,4,16,36,0,36,1.3333333333333333,0.0,0.2,1.3333333333333333,0.0,0.0
Pterin-4 alpha-carbinolamine dehydratase deficiency,30189,1,13,16,11,5,20,1,19,0.8461538461538461,0.07692307692307693,0.6875,0.8461538461538461,0.05,0.07692307692307693
Mosaic trisomy 20 syndrome,27822,2,39,17,19,-2,28,5,23,0.48717948717948717,0.1282051282051282,1.1176470588235294,0.48717948717948717,0.17857142857142858,0.1282051282051282
Sweet syndrome,28845,4,39,17,16,1,23,6,17,0.41025641025641024,0.15384615384615385,0.9411764705882353,0.41025641025641024,0.2608695652173913,0.15384615384615385
X-linked hypophosphatemia,27285,0,51,17,12,5,28,5,23,0.23529411764705882,0.09803921568627451,0.7058823529411765,0.23529411764705882,0.17857142857142858,0.09803921568627451
Systemic sclerosis,94641,11,86,18,10,8,25,11,14,0.11627906976744186,0.12790697674418605,0.5555555555555556,0.11627906976744186,0.44,0.12790697674418605
SATB2-associated syndrome due to a pathogenic variant,39006,21,48,36,5,31,39,2,37,0.10416666666666667,0.041666666666666664,0.1388888888888889,0.10416666666666667,0.05128205128205128,0.041666666666666664
SATB2-associated syndrome due to a chromosomal rearrangement,38194,18,82,31,2,29,36,3,33,0.024390243902439025,0.036585365853658534,0.06451612903225806,0.024390243902439025,0.08333333333333333,0.036585365853658534
Prader-Willi syndrome due to imprinting mutation,32961,5,18,53,8,45,41,4,37,0.4444444444444444,0.2222222222222222,0.1509433962264151,0.4444444444444444,0.0975609756097561,0.2222222222222222
Prader-Willi syndrome due to translocation,32961,6,93,54,18,36,23,10,13,0.1935483870967742,0.10752688172043011,0.3333333333333333,0.1935483870967742,0.43478260869565216,0.10752688172043011
Silver-Russell syndrome due to 7p11.2p13 microduplication,32175,3,29,28,27,1,32,2,30,0.9310344827586207,0.06896551724137931,0.9642857142857143,0.9310344827586207,0.0625,0.06896551724137931
Silver-Russell syndrome due to a point mutation,32863,2,36,18,18,0,30,3,27,0.5,0.08333333333333333,1.0,0.5,0.1,0.08333333333333333
Silver-Russell syndrome due to maternal uniparental disomy of chromosome 11,32180,1,20,19,20,-1,19,2,17,1.0,0.1,1.0526315789473684,1.0,0.10526315789473684,0.1
Silver-Russell syndrome due to maternal uniparental disomy of chromosome 7,32180,1,59,19,14,5,18,2,16,0.23728813559322035,0.03389830508474576,0.7368421052631579,0.23728813559322035,0.1111111111111111,0.03389830508474576
Alveolar echinococcosis,32435,2,50,18,19,-1,26,11,15,0.38,0.22,1.0555555555555556,0.38,0.4230769230769231,0.22
Tularemia,95763,18,38,29,5,24,25,5,20,0.13157894736842105,0.13157894736842105,0.1724137931034483,0.13157894736842105,0.2,0.13157894736842105
Silver-Russell syndrome due to 11p15 microduplication,32181,2,19,17,18,-1,33,3,30,0.9473684210526315,0.15789473684210525,1.0588235294117647,0.9473684210526315,0.09090909090909091,0.15789473684210525
Silver-Russell syndrome due to an imprinting defect of 11p15,32179,3,28,17,18,-1,35,5,30,0.6428571428571429,0.17857142857142858,1.0588235294117647,0.6428571428571429,0.14285714285714285,0.17857142857142858
"Glycogen storage disease due to acid maltase deficiency, infantile onset",32861,3,35,17,19,-2,30,6,24,0.5428571428571428,0.17142857142857143,1.1176470588235294,0.5428571428571428,0.2,0.17142857142857143
Glycogen storage disease due to acid maltase deficiency,94893,14,73,23,5,18,26,5,21,0.0684931506849315,0.0684931506849315,0.21739130434782608,0.0684931506849315,0.19230769230769232,0.0684931506849315
Cysticercosis,30926,10,49,24,0,24,27,3,24,0.0,0.061224489795918366,0.0,0.0,0.1111111111111111,0.061224489795918366
Autosomal dominant Charcot-Marie-Tooth disease type 2E,99891,10,24,17,2,15,28,4,24,0.08333333333333333,0.16666666666666666,0.11764705882352941,0.08333333333333333,0.14285714285714285,0.16666666666666666
Charcot-Marie-Tooth disease type 4D,27530,6,22,24,2,22,25,1,24,0.09090909090909091,0.045454545454545456,0.08333333333333333,0.09090909090909091,0.04,0.045454545454545456
Ectodermal dysplasia-skin fragility syndrome,32141,1,26,17,2,15,29,1,28,0.07692307692307693,0.038461538461538464,0.11764705882352941,0.07692307692307693,0.034482758620689655,0.038461538461538464
"Autosomal dominant generalized epidermolysis bullosa simplex, intermediate form",27434,3,17,24,8,16,14,3,11,0.47058823529411764,0.17647058823529413,0.3333333333333333,0.47058823529411764,0.21428571428571427,0.17647058823529413
Charcot-Marie-Tooth disease type 1F,30728,0,50,17,5,12,18,7,11,0.1,0.14,0.29411764705882354,0.1,0.3888888888888889,0.14
Capillary malformation-arteriovenous malformation,28829,0,29,17,21,-4,23,2,21,0.7241379310344828,0.06896551724137931,1.2352941176470589,0.7241379310344828,0.08695652173913043,0.06896551724137931
"Spondyloepimetaphyseal dysplasia, Handigodu type",33300,3,29,17,17,0,41,4,37,0.5862068965517241,0.13793103448275862,1.0,0.5862068965517241,0.0975609756097561,0.13793103448275862
Hemimegalencephaly,32312,1,33,17,17,0,27,1,26,0.5151515151515151,0.030303030303030304,1.0,0.5151515151515151,0.037037037037037035,0.030303030303030304
Pulmonary capillary hemangiomatosis,38758,18,25,22,5,17,23,6,17,0.2,0.24,0.22727272727272727,0.2,0.2608695652173913,0.24
Immune-mediated necrotizing myopathy,32963,0,24,20,20,0,18,0,18,0.8333333333333334,0.0,1.0,0.8333333333333334,0.0,0.0
Mal de débarquement,27838,10,17,16,14,2,22,9,13,0.8235294117647058,0.5294117647058824,0.875,0.8235294117647058,0.4090909090909091,0.5294117647058824
Autosomal recessive generalized epidermolysis bullosa simplex,38011,6,20,6,2,4,23,3,20,0.1,0.15,0.3333333333333333,0.1,0.13043478260869565,0.15
Autosomal dominant epilepsy with auditory features,27649,1,19,16,14,2,36,1,35,0.7368421052631579,0.05263157894736842,0.875,0.7368421052631579,0.027777777777777776,0.05263157894736842
Polyrrhinia,32486,0,9,13,4,9,15,0,15,0.4444444444444444,0.0,0.3076923076923077,0.4444444444444444,0.0,0.0
Scleromyxedema,27681,0,41,16,16,0,34,2,32,0.3902439024390244,0.04878048780487805,1.0,0.3902439024390244,0.058823529411764705,0.04878048780487805
Trisomy 10p syndrome,33475,1,63,50,48,2,28,6,22,0.7619047619047619,0.09523809523809523,0.96,0.7619047619047619,0.21428571428571427,0.09523809523809523
Hereditary renal hypouricemia,28528,17,16,26,5,21,23,2,21,0.3125,0.125,0.19230769230769232,0.3125,0.08695652173913043,0.125
Renal hypoplasia,32923,5,20,17,19,-2,21,9,12,0.95,0.45,1.1176470588235294,0.95,0.42857142857142855,0.45
Robinow syndrome,29073,1,65,17,10,7,41,3,38,0.15384615384615385,0.046153846153846156,0.5882352941176471,0.15384615384615385,0.07317073170731707,0.046153846153846156
Non-syndromic posterior hypospadias,32912,2,16,16,12,4,14,2,12,0.75,0.125,0.75,0.75,0.14285714285714285,0.125
Variant ABeta2M amyloidosis,33133,1,24,17,1,16,32,0,32,0.041666666666666664,0.0,0.058823529411764705,0.041666666666666664,0.0,0.0
Congenital tufting enteropathy,38695,18,26,27,3,24,24,4,20,0.11538461538461539,0.15384615384615385,0.1111111111111111,0.11538461538461539,0.16666666666666666,0.15384615384615385
Pauci-immune glomerulonephritis,27729,5,37,30,30,0,22,5,17,0.8108108108108109,0.13513513513513514,1.0,0.8108108108108109,0.22727272727272727,0.13513513513513514
Roussy-Lévy syndrome,31973,0,27,17,12,5,31,0,31,0.4444444444444444,0.0,0.7058823529411765,0.4444444444444444,0.0,0.0
Autosomal dominant Charcot-Marie-Tooth disease type 2Y,29098,1,44,24,16,8,18,4,14,0.36363636363636365,0.09090909090909091,0.6666666666666666,0.36363636363636365,0.2222222222222222,0.09090909090909091
Abnormal origin of right or left pulmonary artery from the aorta,31649,10,26,21,4,17,16,3,13,0.15384615384615385,0.11538461538461539,0.19047619047619047,0.15384615384615385,0.1875,0.11538461538461539
Thiel-Behnke corneal dystrophy,29290,9,9,17,7,10,23,1,22,0.7777777777777778,0.1111111111111111,0.4117647058823529,0.7777777777777778,0.043478260869565216,0.1111111111111111
Autosomal dominant nocturnal frontal lobe epilepsy,27354,3,22,18,9,9,28,5,23,0.4090909090909091,0.22727272727272727,0.5,0.4090909090909091,0.17857142857142858,0.22727272727272727
Lattice corneal dystrophy type I,28275,5,17,17,13,4,22,8,14,0.7647058823529411,0.47058823529411764,0.7647058823529411,0.7647058823529411,0.36363636363636365,0.47058823529411764
X-linked Charcot-Marie-Tooth disease type 3,27530,4,28,22,5,17,20,3,17,0.17857142857142858,0.10714285714285714,0.22727272727272727,0.17857142857142858,0.15,0.10714285714285714
X-linked Charcot-Marie-Tooth disease type 2,27530,2,26,30,4,26,15,1,14,0.15384615384615385,0.038461538461538464,0.13333333333333333,0.15384615384615385,0.06666666666666667,0.038461538461538464
Bothnia retinal dystrophy,27827,2,23,17,18,-1,24,3,21,0.782608695652174,0.13043478260869565,1.0588235294117647,0.782608695652174,0.125,0.13043478260869565
Leigh syndrome,33401,2,98,23,16,7,27,6,21,0.16326530612244897,0.061224489795918366,0.6956521739130435,0.16326530612244897,0.2222222222222222,0.061224489795918366
Regional odontodysplasia,32323,4,24,17,18,-1,14,8,6,0.75,0.3333333333333333,1.0588235294117647,0.75,0.5714285714285714,0.3333333333333333
Acute disseminated encephalomyelitis,32501,7,53,51,46,5,31,8,23,0.8679245283018868,0.1509433962264151,0.9019607843137255,0.8679245283018868,0.25806451612903225,0.1509433962264151
Brachytelephalangic chondrodysplasia punctata,38558,17,56,42,1,41,33,1,32,0.017857142857142856,0.017857142857142856,0.023809523809523808,0.017857142857142856,0.030303030303030304,0.017857142857142856
Pseudopseudohypoparathyroidism,27647,4,18,19,7,12,30,7,23,0.3888888888888889,0.3888888888888889,0.3684210526315789,0.3888888888888889,0.23333333333333334,0.3888888888888889
GM1 gangliosidosis type 1,27167,2,53,16,7,9,34,3,31,0.1320754716981132,0.05660377358490566,0.4375,0.1320754716981132,0.08823529411764706,0.05660377358490566
Glycogen storage disease due to glucose-6-phosphatase deficiency type Ib,27295,7,61,25,16,9,23,5,18,0.26229508196721313,0.08196721311475409,0.64,0.26229508196721313,0.21739130434782608,0.08196721311475409
Tubulointerstitial nephritis and uveitis syndrome,31617,5,53,18,18,0,23,7,16,0.33962264150943394,0.1320754716981132,1.0,0.33962264150943394,0.30434782608695654,0.1320754716981132
Lupus erythematosus tumidus,27789,0,12,13,10,3,38,1,37,0.8333333333333334,0.08333333333333333,0.7692307692307693,0.8333333333333334,0.02631578947368421,0.08333333333333333
Charcot-Marie-Tooth disease type 1E,99891,16,40,29,5,24,27,4,23,0.125,0.1,0.1724137931034483,0.125,0.14814814814814814,0.1
Inflammatory pseudotumor of the liver,27702,4,17,10,8,2,19,5,14,0.47058823529411764,0.29411764705882354,0.8,0.47058823529411764,0.2631578947368421,0.29411764705882354
"Hereditary motor and sensory neuropathy, Okinawa type",31920,1,28,43,29,14,26,1,25,1.0357142857142858,0.03571428571428571,0.6744186046511628,1.0357142857142858,0.038461538461538464,0.03571428571428571
Non-syndromic genetic deafness,32254,1,13,13,11,2,24,1,23,0.8461538461538461,0.07692307692307693,0.8461538461538461,0.8461538461538461,0.041666666666666664,0.07692307692307693
Bartter syndrome type 4,27629,2,36,34,10,24,35,5,30,0.2777777777777778,0.1388888888888889,0.29411764705882354,0.2777777777777778,0.14285714285714285,0.1388888888888889
Renal nutcracker syndrome,33362,3,25,18,19,-1,11,5,6,0.76,0.2,1.0555555555555556,0.76,0.45454545454545453,0.2
Immunodeficiency due to selective anti-polysaccharide antibody deficiency,27759,6,19,18,14,4,40,4,36,0.7368421052631579,0.21052631578947367,0.7777777777777778,0.7368421052631579,0.1,0.21052631578947367
Intrahepatic cholestasis of pregnancy,30714,2,27,16,6,10,12,4,8,0.2222222222222222,0.14814814814814814,0.375,0.2222222222222222,0.3333333333333333,0.14814814814814814
Infantile neuroaxonal dystrophy,33527,0,52,21,5,16,27,4,23,0.09615384615384616,0.07692307692307693,0.23809523809523808,0.09615384615384616,0.14814814814814814,0.07692307692307693
Pantothenate kinase-associated neurodegeneration,28116,5,60,105,61,44,19,3,16,1.0166666666666666,0.05,0.580952380952381,1.0166666666666666,0.15789473684210525,0.05
Tako-Tsubo cardiomyopathy,27751,4,36,16,17,-1,23,8,15,0.4722222222222222,0.2222222222222222,1.0625,0.4722222222222222,0.34782608695652173,0.2222222222222222
Isolated focal cortical dysplasia,28599,1,21,16,13,3,19,4,15,0.6190476190476191,0.19047619047619047,0.8125,0.6190476190476191,0.21052631578947367,0.19047619047619047
Pruritic urticarial papules and plaques of pregnancy,27756,5,21,17,19,-2,18,7,11,0.9047619047619048,0.3333333333333333,1.1176470588235294,0.9047619047619048,0.3888888888888889,0.3333333333333333
Acrokeratosis verruciformis of Hopf,27270,2,12,16,10,6,27,3,24,0.8333333333333334,0.25,0.625,0.8333333333333334,0.1111111111111111,0.25
"Hereditary bullous dystrophy, macular type",31784,1,23,20,18,2,30,2,28,0.782608695652174,0.08695652173913043,0.9,0.782608695652174,0.06666666666666667,0.08695652173913043
Elastosis perforans serpiginosa,30716,5,11,14,11,3,26,5,21,1.0,0.45454545454545453,0.7857142857142857,1.0,0.19230769230769232,0.45454545454545453
Isolated congenital onychodysplasia,29598,0,22,25,2,23,13,3,10,0.09090909090909091,0.13636363636363635,0.08,0.09090909090909091,0.23076923076923078,0.13636363636363635
Tropical endomyocardial fibrosis,33141,4,48,26,27,-1,32,6,26,0.5625,0.125,1.0384615384615385,0.5625,0.1875,0.125
Oguchi disease,27726,4,13,20,12,8,33,3,30,0.9230769230769231,0.23076923076923078,0.6,0.9230769230769231,0.09090909090909091,0.23076923076923078
Cancer-associated retinopathy,32583,1,35,16,16,0,24,3,21,0.45714285714285713,0.08571428571428572,1.0,0.45714285714285713,0.125,0.08571428571428572
Cerebral visual impairment,94880,16,41,21,1,20,19,1,18,0.024390243902439025,0.024390243902439025,0.047619047619047616,0.024390243902439025,0.05263157894736842,0.024390243902439025
Proton-pump inhibitor-responsive esophageal eosinophilia,84163,14,29,18,8,10,20,8,12,0.27586206896551724,0.27586206896551724,0.4444444444444444,0.27586206896551724,0.4,0.27586206896551724
Congenital adrenal hyperplasia due to cytochrome P450 oxidoreductase deficiency,31352,4,108,30,13,17,26,7,19,0.12037037037037036,0.06481481481481481,0.43333333333333335,0.12037037037037036,0.2692307692307692,0.06481481481481481
Symptomatic form of fragile X syndrome in female carriers,98561,18,41,37,13,24,27,8,19,0.3170731707317073,0.1951219512195122,0.35135135135135137,0.3170731707317073,0.2962962962962963,0.1951219512195122
Oncogenic osteomalacia,98450,14,34,30,5,25,24,2,22,0.14705882352941177,0.058823529411764705,0.16666666666666666,0.14705882352941177,0.08333333333333333,0.058823529411764705
Selective IgM deficiency,96370,11,64,37,13,24,27,7,20,0.203125,0.109375,0.35135135135135137,0.203125,0.25925925925925924,0.109375
Acute encephalopathy with biphasic seizures and late reduced diffusion,94659,14,12,22,1,21,17,0,17,0.08333333333333333,0.0,0.045454545454545456,0.08333333333333333,0.0,0.0
Burning mouth syndrome,39709,8,17,26,4,22,12,4,8,0.23529411764705882,0.23529411764705882,0.15384615384615385,0.23529411764705882,0.3333333333333333,0.23529411764705882
Severe early-childhood-onset retinal dystrophy,38728,16,33,21,7,14,22,8,14,0.21212121212121213,0.24242424242424243,0.3333333333333333,0.21212121212121213,0.36363636363636365,0.24242424242424243
New-onset refractory status epilepticus,98472,8,37,23,5,18,22,2,20,0.13513513513513514,0.05405405405405406,0.21739130434782608,0.13513513513513514,0.09090909090909091,0.05405405405405406
Persistent idiopathic facial pain,98506,6,11,23,3,20,18,2,16,0.2727272727272727,0.18181818181818182,0.13043478260869565,0.2727272727272727,0.1111111111111111,0.18181818181818182
Refractory celiac disease,84045,14,28,21,5,16,26,6,20,0.17857142857142858,0.21428571428571427,0.23809523809523808,0.17857142857142858,0.23076923076923078,0.21428571428571427
IgG4-related pachymeningitis,98562,13,39,27,4,23,29,6,23,0.10256410256410256,0.15384615384615385,0.14814814814814814,0.10256410256410256,0.20689655172413793,0.15384615384615385
Epithelial recurrent erosion dystrophy,31238,0,11,20,8,12,36,0,36,0.7272727272727273,0.0,0.4,0.7272727272727273,0.0,0.0
Mendelian susceptibility to mycobacterial diseases due to complete IL12RB1 deficiency,30220,6,15,22,2,20,26,1,25,0.13333333333333333,0.06666666666666667,0.09090909090909091,0.13333333333333333,0.038461538461538464,0.06666666666666667
Fixed drug eruption,98285,14,18,23,3,20,24,3,21,0.16666666666666666,0.16666666666666666,0.13043478260869565,0.16666666666666666,0.125,0.16666666666666666
Isolated absence of upper arm and forearm with hand present,39389,3,18,28,0,28,38,0,38,0.0,0.0,0.0,0.0,0.0,0.0
Autoerythrocyte sensitization syndrome,98416,6,42,30,7,23,22,8,14,0.16666666666666666,0.19047619047619047,0.23333333333333334,0.16666666666666666,0.36363636363636365,0.19047619047619047
Intermittent hydrarthrosis,36157,10,5,27,3,24,21,1,20,0.6,0.2,0.1111111111111111,0.6,0.047619047619047616,0.2
Coffin-Siris syndrome,27378,0,65,119,39,80,20,0,20,0.6,0.0,0.3277310924369748,0.6,0.0,0.0
Nail-patella syndrome,29780,2,72,24,7,17,29,6,23,0.09722222222222222,0.08333333333333333,0.2916666666666667,0.09722222222222222,0.20689655172413793,0.08333333333333333
Angelman syndrome,29997,3,71,35,21,14,18,4,14,0.29577464788732394,0.056338028169014086,0.6,0.29577464788732394,0.2222222222222222,0.056338028169014086
Proximal 16p11.2 microdeletion syndrome,28865,3,52,20,15,5,26,3,23,0.28846153846153844,0.057692307692307696,0.75,0.28846153846153844,0.11538461538461539,0.057692307692307696
IgG4-related aortitis,98563,16,25,32,4,28,26,5,21,0.16,0.2,0.125,0.16,0.19230769230769232,0.2
IgG4-related kidney disease,98562,16,59,22,8,14,26,9,17,0.13559322033898305,0.15254237288135594,0.36363636363636365,0.13559322033898305,0.34615384615384615,0.15254237288135594
Autosomal dominant optic atrophy plus syndrome,31888,3,26,18,1,17,29,4,25,0.038461538461538464,0.15384615384615385,0.05555555555555555,0.038461538461538464,0.13793103448275862,0.15384615384615385
Proximal spinal muscular atrophy,28247,0,50,19,6,13,16,5,11,0.12,0.1,0.3157894736842105,0.12,0.3125,0.1
Tay-Sachs disease,94924,21,69,26,7,19,27,6,21,0.10144927536231885,0.08695652173913043,0.2692307692307692,0.10144927536231885,0.2222222222222222,0.08695652173913043
Pyridoxine-dependent epilepsy,32707,4,35,21,6,15,21,4,17,0.17142857142857143,0.11428571428571428,0.2857142857142857,0.17142857142857143,0.19047619047619047,0.11428571428571428
Opitz GBBB syndrome,28702,2,75,19,14,5,37,10,27,0.18666666666666668,0.13333333333333333,0.7368421052631579,0.18666666666666668,0.2702702702702703,0.13333333333333333
Cerebrotendinous xanthomatosis,33508,1,91,18,0,18,22,1,21,0.0,0.01098901098901099,0.0,0.0,0.045454545454545456,0.01098901098901099
Allan-Herndon-Dudley syndrome,28090,0,51,48,15,33,17,0,17,0.29411764705882354,0.0,0.3125,0.29411764705882354,0.0,0.0
Congenital adrenal hyperplasia due to 11-beta-hydroxylase deficiency,28999,1,32,17,4,13,15,7,8,0.125,0.21875,0.23529411764705882,0.125,0.4666666666666667,0.21875
Classic congenital adrenal hyperplasia due to 21-hydroxylase deficiency,30111,4,56,20,11,9,26,8,18,0.19642857142857142,0.14285714285714285,0.55,0.19642857142857142,0.3076923076923077,0.14285714285714285
Congenital adrenal hyperplasia due to 17-alpha-hydroxylase deficiency,29496,0,41,21,8,13,22,4,18,0.1951219512195122,0.0975609756097561,0.38095238095238093,0.1951219512195122,0.18181818181818182,0.0975609756097561
Autosomal recessive spastic paraplegia type 11,39424,16,49,23,3,20,32,6,26,0.061224489795918366,0.12244897959183673,0.13043478260869565,0.061224489795918366,0.1875,0.12244897959183673
Familial adenomatous polyposis,29041,0,40,17,12,5,35,2,33,0.3,0.05,0.7058823529411765,0.3,0.05714285714285714,0.05
Myoclonic-astatic epilepsy,33113,0,44,21,8,13,15,1,14,0.18181818181818182,0.022727272727272728,0.38095238095238093,0.18181818181818182,0.06666666666666667,0.022727272727272728
Familial focal epilepsy with variable foci,28855,1,26,17,11,6,37,0,37,0.4230769230769231,0.0,0.6470588235294118,0.4230769230769231,0.0,0.0
Charcot-Marie-Tooth disease type 4C,27530,4,49,20,3,17,28,3,25,0.061224489795918366,0.061224489795918366,0.15,0.061224489795918366,0.10714285714285714,0.061224489795918366
Adrenomyeloneuropathy,32783,0,49,21,23,-2,28,4,24,0.46938775510204084,0.08163265306122448,1.0952380952380953,0.46938775510204084,0.14285714285714285,0.08163265306122448
Reversible cerebral vasoconstriction syndrome,33346,0,24,3,2,1,34,3,31,0.08333333333333333,0.125,0.6666666666666666,0.08333333333333333,0.08823529411764706,0.125
Acute zonal occult outer retinopathy,33483,4,24,20,22,-2,32,9,23,0.9166666666666666,0.375,1.1,0.9166666666666666,0.28125,0.375
Landau-Kleffner syndrome,31969,3,44,16,13,3,19,7,12,0.29545454545454547,0.1590909090909091,0.8125,0.29545454545454547,0.3684210526315789,0.1590909090909091
15q11.2 microdeletion syndrome,32429,1,31,16,3,13,17,2,15,0.0967741935483871,0.06451612903225806,0.1875,0.0967741935483871,0.11764705882352941,0.06451612903225806
Congenital lipoid adrenal hyperplasia due to STAR deficency,28115,3,25,26,22,4,21,3,18,0.88,0.12,0.8461538461538461,0.88,0.14285714285714285,0.12
Marchiafava-Bignami disease,33363,4,50,16,15,1,30,8,22,0.3,0.16,0.9375,0.3,0.26666666666666666,0.16
Epidermolysis bullosa simplex with circinate migratory erythema,27687,3,19,16,14,2,12,2,10,0.7368421052631579,0.10526315789473684,0.875,0.7368421052631579,0.16666666666666666,0.10526315789473684
Lower motor neuron syndrome with late-adult onset,27736,4,26,16,12,4,19,4,15,0.46153846153846156,0.15384615384615385,0.75,0.46153846153846156,0.21052631578947367,0.15384615384615385
Glossopharyngeal neuralgia,33352,3,28,21,19,2,23,4,19,0.6785714285714286,0.14285714285714285,0.9047619047619048,0.6785714285714286,0.17391304347826086,0.14285714285714285
Superficial siderosis,32713,0,49,23,26,-3,23,0,23,0.5306122448979592,0.0,1.1304347826086956,0.5306122448979592,0.0,0.0
Familial hemophagocytic lymphohistiocytosis,29161,7,45,51,22,29,32,14,18,0.4888888888888889,0.3111111111111111,0.43137254901960786,0.4888888888888889,0.4375,0.3111111111111111
Blepharophimosis-ptosis-epicanthus inversus syndrome plus,27485,3,35,17,9,8,20,4,16,0.2571428571428571,0.11428571428571428,0.5294117647058824,0.2571428571428571,0.2,0.11428571428571428
Autosomal dominant keratitis,28824,10,16,20,4,16,15,1,14,0.25,0.0625,0.2,0.25,0.06666666666666667,0.0625
Fibrous dysplasia of bone,38425,11,62,27,8,19,30,5,25,0.12903225806451613,0.08064516129032258,0.2962962962962963,0.12903225806451613,0.16666666666666666,0.08064516129032258
Exstrophy-epispadias complex,38726,8,40,17,2,15,24,4,20,0.05,0.1,0.11764705882352941,0.05,0.16666666666666666,0.1
Glycogen storage disease due to aldolase A deficiency,29225,3,21,18,3,15,29,1,28,0.14285714285714285,0.047619047619047616,0.16666666666666666,0.14285714285714285,0.034482758620689655,0.047619047619047616
Dyggve-Melchior-Clausen disease,27562,0,59,18,6,12,10,0,10,0.1016949152542373,0.0,0.3333333333333333,0.1016949152542373,0.0,0.0
Idiopathic steroid-resistant nephrotic syndrome,39544,15,24,24,4,20,16,4,12,0.16666666666666666,0.16666666666666666,0.16666666666666666,0.16666666666666666,0.25,0.16666666666666666
Autosomal recessive otospondylomegaepiphyseal dysplasia,35450,5,43,34,4,30,26,1,25,0.09302325581395349,0.023255813953488372,0.11764705882352941,0.09302325581395349,0.038461538461538464,0.023255813953488372
Progressive pseudorheumatoid dysplasia,30070,0,45,17,10,7,32,4,28,0.2222222222222222,0.08888888888888889,0.5882352941176471,0.2222222222222222,0.125,0.08888888888888889
Glycogen storage disease due to lactate dehydrogenase M-subunit deficiency,33023,10,23,20,0,20,23,0,23,0.0,0.0,0.0,0.0,0.0,0.0
Mueller-Weiss syndrome,30327,0,21,27,0,27,35,0,35,0.0,0.0,0.0,0.0,0.0,0.0
Idiopathic steroid-sensitive nephrotic syndrome with secondary steroid resistance,33491,16,28,20,6,14,20,6,14,0.21428571428571427,0.21428571428571427,0.3,0.21428571428571427,0.3,0.21428571428571427
Systemic mastocytosis with associated hematologic neoplasm,32837,9,45,21,11,10,19,7,12,0.24444444444444444,0.15555555555555556,0.5238095238095238,0.24444444444444444,0.3684210526315789,0.15555555555555556
Aggressive systemic mastocytosis,32834,3,39,19,7,12,17,8,9,0.1794871794871795,0.20512820512820512,0.3684210526315789,0.1794871794871795,0.47058823529411764,0.20512820512820512
Partial androgen insensitivity syndrome,28616,7,26,20,8,12,26,2,24,0.3076923076923077,0.07692307692307693,0.4,0.3076923076923077,0.07692307692307693,0.07692307692307693
Complete androgen insensitivity syndrome,31630,2,23,18,11,7,29,2,27,0.4782608695652174,0.08695652173913043,0.6111111111111112,0.4782608695652174,0.06896551724137931,0.08695652173913043
Osteochondrosis of the metatarsal bone,39722,12,19,17,2,15,31,4,27,0.10526315789473684,0.21052631578947367,0.11764705882352941,0.10526315789473684,0.12903225806451613,0.21052631578947367
Primary triglyceride deposit cardiomyovasculopathy,38564,18,29,21,4,17,24,5,19,0.13793103448275862,0.1724137931034483,0.19047619047619047,0.13793103448275862,0.20833333333333334,0.1724137931034483
Hypothyroidism due to deficient transcription factors involved in pituitary development or function,32711,2,51,16,5,11,29,4,25,0.09803921568627451,0.0784313725490196,0.3125,0.09803921568627451,0.13793103448275862,0.0784313725490196
Indolent systemic mastocytosis,32834,5,21,21,4,17,20,2,18,0.19047619047619047,0.09523809523809523,0.19047619047619047,0.19047619047619047,0.1,0.09523809523809523
Congenital tricuspid valve dysplasia,33663,5,20,21,5,16,18,2,16,0.25,0.1,0.23809523809523808,0.25,0.1111111111111111,0.1
IgA pemphigus,99686,7,19,14,4,10,22,2,20,0.21052631578947367,0.10526315789473684,0.2857142857142857,0.21052631578947367,0.09090909090909091,0.10526315789473684
Primary biliary cholangitis/primary sclerosing cholangitis and autoimmune hepatitis overlap syndrome,99692,17,36,23,6,17,30,5,25,0.16666666666666666,0.1388888888888889,0.2608695652173913,0.16666666666666666,0.16666666666666666,0.1388888888888889
Osteochondrosis of the tarsal bone,39722,9,13,27,2,25,26,3,23,0.15384615384615385,0.23076923076923078,0.07407407407407407,0.15384615384615385,0.11538461538461539,0.23076923076923078
Isolated thyroid-stimulating hormone deficiency,30196,1,42,18,7,11,17,4,13,0.16666666666666666,0.09523809523809523,0.3888888888888889,0.16666666666666666,0.23529411764705882,0.09523809523809523
Resistance to thyrotropin-releasing hormone syndrome,32345,3,23,16,4,12,25,5,20,0.17391304347826086,0.21739130434782608,0.25,0.17391304347826086,0.2,0.21739130434782608
Livedoid vasculopathy,99643,0,49,9,1,8,14,3,11,0.02040816326530612,0.061224489795918366,0.1111111111111111,0.02040816326530612,0.21428571428571427,0.061224489795918366
Infection-related hemolytic uremic syndrome,99684,16,52,27,9,18,20,10,10,0.17307692307692307,0.19230769230769232,0.3333333333333333,0.17307692307692307,0.5,0.19230769230769232
Idiopathic congenital hypothyroidism,38624,8,24,20,1,19,20,2,18,0.041666666666666664,0.08333333333333333,0.05,0.041666666666666664,0.1,0.08333333333333333
Familial thyroid dyshormonogenesis,30902,4,30,16,5,11,19,2,17,0.16666666666666666,0.06666666666666667,0.3125,0.16666666666666666,0.10526315789473684,0.06666666666666667
Hypothyroidism due to TSH receptor mutations,29150,2,28,17,4,13,21,1,20,0.14285714285714285,0.03571428571428571,0.23529411764705882,0.14285714285714285,0.047619047619047616,0.03571428571428571
Necrobiosis lipoidica,84213,14,21,25,4,21,16,4,12,0.19047619047619047,0.19047619047619047,0.16,0.19047619047619047,0.25,0.19047619047619047
CAR T cell therapy-associated cytokine release syndrome,32520,1,31,18,4,14,18,8,10,0.12903225806451613,0.25806451612903225,0.2222222222222222,0.12903225806451613,0.4444444444444444,0.25806451612903225
KRT1-related diffuse nonepidermolytic keratoderma,28842,7,15,15,0,15,17,0,17,0.0,0.0,0.0,0.0,0.0,0.0
Mirizzi syndrome,99822,13,20,13,6,7,13,6,7,0.3,0.3,0.46153846153846156,0.3,0.46153846153846156,0.3
Aquagenic palmoplantar keratoderma,30262,10,12,12,2,10,10,1,9,0.16666666666666666,0.08333333333333333,0.16666666666666666,0.16666666666666666,0.1,0.08333333333333333
Extracranial carotid artery aneurysm,99882,10,28,26,2,24,27,1,26,0.07142857142857142,0.03571428571428571,0.07692307692307693,0.07142857142857142,0.037037037037037035,0.03571428571428571
Female infertility due to oocyte meiotic arrest,99878,16,6,24,4,20,28,1,27,0.6666666666666666,0.16666666666666666,0.16666666666666666,0.6666666666666666,0.03571428571428571,0.16666666666666666
Obesity-colitis-hypothyroidism-cardiac hypertrophy-developmental delay syndrome,32798,11,7,24,1,23,54,1,53,0.14285714285714285,0.14285714285714285,0.041666666666666664,0.14285714285714285,0.018518518518518517,0.14285714285714285
Caroli syndrome,27699,7,36,34,20,14,25,7,18,0.5555555555555556,0.19444444444444445,0.5882352941176471,0.5555555555555556,0.28,0.19444444444444445
Primary condylar hyperplasia,98598,3,6,16,2,14,10,2,8,0.3333333333333333,0.3333333333333333,0.125,0.3333333333333333,0.2,0.3333333333333333
Severe primary trimethylaminuria,28676,8,10,18,0,18,28,0,28,0.0,0.0,0.0,0.0,0.0,0.0
Exercise-induced malignant hyperthermia,83838,16,41,22,6,16,27,6,21,0.14634146341463414,0.14634146341463414,0.2727272727272727,0.14634146341463414,0.2222222222222222,0.14634146341463414
Catastrophic antiphospholipid syndrome,98579,11,52,12,5,7,25,9,16,0.09615384615384616,0.17307692307692307,0.4166666666666667,0.09615384615384616,0.36,0.17307692307692307
Neonatal alloimmune neutropenia,98581,17,12,32,6,26,35,3,32,0.5,0.25,0.1875,0.5,0.08571428571428572,0.25
Isolated splenogonadal fusion,98575,1,13,25,0,25,38,1,37,0.0,0.07692307692307693,0.0,0.0,0.02631578947368421,0.07692307692307693
Multifocal lymphangioendotheliomatosis-thrombocytopenia syndrome,98578,11,46,30,4,26,19,2,17,0.08695652173913043,0.043478260869565216,0.13333333333333333,0.08695652173913043,0.10526315789473684,0.043478260869565216
IgG4-related submandibular gland disease,98564,13,25,23,4,19,19,4,15,0.16,0.16,0.17391304347826086,0.16,0.21052631578947367,0.16
IgG4-related ophthalmic disease,39512,20,42,27,5,22,27,3,24,0.11904761904761904,0.07142857142857142,0.18518518518518517,0.11904761904761904,0.1111111111111111,0.07142857142857142
Rheumatoid factor-negative polyarticular juvenile idiopathic arthritis,32699,6,31,18,4,14,24,6,18,0.12903225806451613,0.1935483870967742,0.2222222222222222,0.12903225806451613,0.25,0.1935483870967742
Oligoarticular juvenile idiopathic arthritis,98152,11,20,24,1,23,23,0,23,0.05,0.0,0.041666666666666664,0.05,0.0,0.0
Enthesitis-related juvenile idiopathic arthritis,32728,6,34,17,2,15,31,4,27,0.058823529411764705,0.11764705882352941,0.11764705882352941,0.058823529411764705,0.12903225806451613,0.11764705882352941
Porphyria cutanea tarda,33179,3,39,16,7,9,15,3,12,0.1794871794871795,0.07692307692307693,0.4375,0.1794871794871795,0.2,0.07692307692307693
Porphyria due to ALA dehydratase deficiency,30913,1,43,17,5,12,22,3,19,0.11627906976744186,0.06976744186046512,0.29411764705882354,0.11627906976744186,0.13636363636363635,0.06976744186046512
Hepatoerythropoietic porphyria,36330,16,37,31,3,28,36,2,34,0.08108108108108109,0.05405405405405406,0.0967741935483871,0.08108108108108109,0.05555555555555555,0.05405405405405406
Congenital erythropoietic porphyria,29134,8,50,22,4,18,39,4,35,0.08,0.08,0.18181818181818182,0.08,0.10256410256410256,0.08
Leprosy,33293,2,47,39,40,-1,29,3,26,0.851063829787234,0.06382978723404255,1.0256410256410255,0.851063829787234,0.10344827586206896,0.06382978723404255
African trypanosomiasis,32503,0,87,18,15,3,29,11,18,0.1724137931034483,0.12643678160919541,0.8333333333333334,0.1724137931034483,0.3793103448275862,0.12643678160919541
Scorpion envenomation,33066,0,58,17,17,0,24,8,16,0.29310344827586204,0.13793103448275862,1.0,0.29310344827586204,0.3333333333333333,0.13793103448275862
DNM1L-related encephalopathy due to mitochondrial and peroxisomal fission defect,29090,2,30,18,12,6,20,0,20,0.4,0.0,0.6666666666666666,0.4,0.0,0.0
Shigellosis,32999,6,46,24,25,-1,23,7,16,0.5434782608695652,0.15217391304347827,1.0416666666666667,0.5434782608695652,0.30434782608695654,0.15217391304347827
Trichinellosis,32815,0,42,16,16,0,17,2,15,0.38095238095238093,0.047619047619047616,1.0,0.38095238095238093,0.11764705882352941,0.047619047619047616
Amoebiasis due to Entamoeba histolytica,32326,5,27,23,20,3,19,8,11,0.7407407407407407,0.2962962962962963,0.8695652173913043,0.7407407407407407,0.42105263157894735,0.2962962962962963
Listeriosis,33297,4,68,17,16,1,24,12,12,0.23529411764705882,0.17647058823529413,0.9411764705882353,0.23529411764705882,0.5,0.17647058823529413
Tick-borne encephalitis,32422,4,63,17,15,2,30,13,17,0.23809523809523808,0.20634920634920634,0.8823529411764706,0.23809523809523808,0.43333333333333335,0.20634920634920634
Cholera,32626,6,34,16,18,-2,17,9,8,0.5294117647058824,0.2647058823529412,1.125,0.5294117647058824,0.5294117647058824,0.2647058823529412
Q fever,32959,4,62,16,14,2,23,8,15,0.22580645161290322,0.12903225806451613,0.875,0.22580645161290322,0.34782608695652173,0.12903225806451613
Lymphatic filariasis,32524,2,33,17,19,-2,34,6,28,0.5757575757575758,0.18181818181818182,1.1176470588235294,0.5757575757575758,0.17647058823529413,0.18181818181818182
Aspergillosis,33216,6,56,35,34,1,24,7,17,0.6071428571428571,0.125,0.9714285714285714,0.6071428571428571,0.2916666666666667,0.125
Amoebiasis due to free-living amoebae,32327,2,68,19,18,1,22,4,18,0.2647058823529412,0.058823529411764705,0.9473684210526315,0.2647058823529412,0.18181818181818182,0.058823529411764705
Primary ciliary dyskinesia,32022,10,47,17,9,8,17,6,11,0.19148936170212766,0.1276595744680851,0.5294117647058824,0.19148936170212766,0.35294117647058826,0.1276595744680851
Brucellosis,32932,5,77,19,19,0,20,12,8,0.24675324675324675,0.15584415584415584,1.0,0.24675324675324675,0.6,0.15584415584415584
Acute lung injury,32483,5,21,16,16,0,14,7,7,0.7619047619047619,0.3333333333333333,1.0,0.7619047619047619,0.5,0.3333333333333333
Angiostrongyliasis,32338,6,39,23,25,-2,24,8,16,0.6410256410256411,0.20512820512820512,1.0869565217391304,0.6410256410256411,0.3333333333333333,0.20512820512820512
Cardiogenic shock,29525,9,30,22,8,14,20,8,12,0.26666666666666666,0.26666666666666666,0.36363636363636365,0.26666666666666666,0.4,0.26666666666666666
Avian influenza,33079,7,41,19,18,1,21,9,12,0.43902439024390244,0.21951219512195122,0.9473684210526315,0.43902439024390244,0.42857142857142855,0.21951219512195122
Cockayne syndrome,27995,3,119,81,51,30,26,4,22,0.42857142857142855,0.03361344537815126,0.6296296296296297,0.42857142857142855,0.15384615384615385,0.03361344537815126
Neurofibromatosis type 1 due to NF1 mutation or intragenic deletion,27275,0,71,17,1,16,36,10,26,0.014084507042253521,0.14084507042253522,0.058823529411764705,0.014084507042253521,0.2777777777777778,0.14084507042253522
Scedosporiosis,32793,2,34,16,15,1,25,4,21,0.4411764705882353,0.11764705882352941,0.9375,0.4411764705882353,0.16,0.11764705882352941
Pneumocystosis,33210,3,23,16,18,-2,20,5,15,0.782608695652174,0.21739130434782608,1.125,0.782608695652174,0.25,0.21739130434782608
Alport syndrome,28039,2,38,19,4,15,28,7,21,0.10526315789473684,0.18421052631578946,0.21052631578947367,0.10526315789473684,0.25,0.18421052631578946
Chromomycosis,32764,0,33,16,17,-1,12,3,9,0.5151515151515151,0.09090909090909091,1.0625,0.5151515151515151,0.25,0.09090909090909091
Rotor syndrome,27728,4,10,17,10,7,28,2,26,1.0,0.2,0.5882352941176471,1.0,0.07142857142857142,0.2
Sotos syndrome,31089,1,107,17,16,1,35,4,31,0.14953271028037382,0.037383177570093455,0.9411764705882353,0.14953271028037382,0.11428571428571428,0.037383177570093455
Classical Ehlers-Danlos syndrome,94824,12,66,24,6,18,33,12,21,0.09090909090909091,0.18181818181818182,0.25,0.09090909090909091,0.36363636363636365,0.18181818181818182
Bacterial toxic-shock syndrome,32395,3,60,14,16,-2,22,8,14,0.26666666666666666,0.13333333333333333,1.1428571428571428,0.26666666666666666,0.36363636363636365,0.13333333333333333
Rett syndrome,28856,1,36,47,26,21,28,2,26,0.7222222222222222,0.05555555555555555,0.5531914893617021,0.7222222222222222,0.07142857142857142,0.05555555555555555
Steinert myotonic dystrophy,27540,5,108,58,45,13,26,6,20,0.4166666666666667,0.05555555555555555,0.7758620689655172,0.4166666666666667,0.23076923076923078,0.05555555555555555
Poliomyelitis,33284,8,53,27,28,-1,23,11,12,0.5283018867924528,0.20754716981132076,1.037037037037037,0.5283018867924528,0.4782608695652174,0.20754716981132076
MELAS,30419,3,87,18,15,3,23,6,17,0.1724137931034483,0.06896551724137931,0.8333333333333334,0.1724137931034483,0.2608695652173913,0.06896551724137931
Methanol poisoning,33019,2,29,18,19,-1,30,3,27,0.6551724137931034,0.10344827586206896,1.0555555555555556,0.6551724137931034,0.1,0.10344827586206896
Homocystinuria due to methylene tetrahydrofolate reductase deficiency,31682,1,50,18,19,-1,25,3,22,0.38,0.06,1.0555555555555556,0.38,0.12,0.06
Cocaine intoxication,32933,4,63,18,18,0,23,11,12,0.2857142857142857,0.1746031746031746,1.0,0.2857142857142857,0.4782608695652174,0.1746031746031746
Ethylene glycol poisoning,33020,3,44,17,18,-1,17,10,7,0.4090909090909091,0.22727272727272727,1.0588235294117647,0.4090909090909091,0.5882352941176471,0.22727272727272727
Lead poisoning,32274,4,62,16,14,2,36,11,25,0.22580645161290322,0.1774193548387097,0.875,0.22580645161290322,0.3055555555555556,0.1774193548387097
Chikungunya,32982,7,51,17,18,-1,32,13,19,0.35294117647058826,0.2549019607843137,1.0588235294117647,0.35294117647058826,0.40625,0.2549019607843137
Autosomal recessive polycystic kidney disease,28262,5,51,24,18,6,34,4,30,0.35294117647058826,0.0784313725490196,0.75,0.35294117647058826,0.11764705882352941,0.0784313725490196
Zika virus disease,33321,8,34,23,22,1,27,9,18,0.6470588235294118,0.2647058823529412,0.9565217391304348,0.6470588235294118,0.3333333333333333,0.2647058823529412
"Atrial septal defect, ostium secundum type",32487,4,35,19,22,-3,21,7,14,0.6285714285714286,0.2,1.1578947368421053,0.6285714285714286,0.3333333333333333,0.2
MFF-related encephalopathy due to mitochondrial and peroxisomal fission defect,29090,0,29,24,6,18,33,4,29,0.20689655172413793,0.13793103448275862,0.25,0.20689655172413793,0.12121212121212122,0.13793103448275862
"Atrial septal defect, coronary sinus type",32438,7,26,16,18,-2,25,9,16,0.6923076923076923,0.34615384615384615,1.125,0.6923076923076923,0.36,0.34615384615384615
"Atrial septal defect, sinus venosus type",32439,4,27,16,18,-2,20,5,15,0.6666666666666666,0.18518518518518517,1.125,0.6666666666666666,0.25,0.18518518518518517
"Atrial septal defect, ostium primum type",32440,3,38,17,17,0,19,4,15,0.4473684210526316,0.10526315789473684,1.0,0.4473684210526316,0.21052631578947367,0.10526315789473684
15q24 microdeletion syndrome,32429,3,52,16,5,11,22,5,17,0.09615384615384616,0.09615384615384616,0.3125,0.09615384615384616,0.22727272727272727,0.09615384615384616
SIN3-related intellectual disability syndrome due to a point mutation,32771,0,20,20,20,0,26,1,25,1.0,0.05,1.0,1.0,0.038461538461538464,0.05
Diffuse alveolar hemorrhage,32934,5,34,24,20,4,24,6,18,0.5882352941176471,0.17647058823529413,0.8333333333333334,0.5882352941176471,0.25,0.17647058823529413
Acute liver failure,32928,3,50,17,18,-1,23,8,15,0.36,0.16,1.0588235294117647,0.36,0.34782608695652173,0.16
Acquired aneurysmal subarachnoid hemorrhage,32930,2,34,19,21,-2,25,5,20,0.6176470588235294,0.14705882352941177,1.105263157894737,0.6176470588235294,0.2,0.14705882352941177
Huntington disease,38307,17,53,20,3,17,21,4,17,0.05660377358490566,0.07547169811320754,0.15,0.05660377358490566,0.19047619047619047,0.07547169811320754
Multiple endocrine neoplasia type 1,28426,7,74,30,16,14,25,10,15,0.21621621621621623,0.13513513513513514,0.5333333333333333,0.21621621621621623,0.4,0.13513513513513514
Full NF2-related schwannomatosis,27477,0,47,16,2,14,30,3,27,0.0425531914893617,0.06382978723404255,0.125,0.0425531914893617,0.1,0.06382978723404255
Necrotizing enterocolitis,33306,2,34,16,18,-2,19,6,13,0.5294117647058824,0.17647058823529413,1.125,0.5294117647058824,0.3157894736842105,0.17647058823529413
Central retinal vein occlusion,95670,18,16,20,3,17,25,3,22,0.1875,0.1875,0.15,0.1875,0.12,0.1875
Uremic pruritus,31981,2,18,15,4,11,24,1,23,0.2222222222222222,0.05555555555555555,0.26666666666666666,0.2222222222222222,0.041666666666666664,0.05555555555555555
Congenital generalized lipodystrophy,38009,11,37,41,4,37,29,1,28,0.10810810810810811,0.02702702702702703,0.0975609756097561,0.10810810810810811,0.034482758620689655,0.02702702702702703
Cyclic neutropenia,29352,4,32,20,17,3,19,2,17,0.53125,0.0625,0.85,0.53125,0.10526315789473684,0.0625
Self-limited infantile epilepsy,99969,7,24,34,1,33,21,0,21,0.041666666666666664,0.0,0.029411764705882353,0.041666666666666664,0.0,0.0
Glutaryl-CoA dehydrogenase deficiency,31606,1,43,19,13,6,19,0,19,0.3023255813953488,0.0,0.6842105263157895,0.3023255813953488,0.0,0.0
Atypical Rett syndrome,27725,7,54,47,50,-3,28,11,17,0.9259259259259259,0.2037037037037037,1.0638297872340425,0.9259259259259259,0.39285714285714285,0.2037037037037037
Spondyloperipheral dysplasia-short ulna syndrome,28561,1,23,31,15,16,26,0,26,0.6521739130434783,0.0,0.4838709677419355,0.6521739130434783,0.0,0.0
Rothmund-Thomson syndrome,27814,5,56,103,44,59,27,7,20,0.7857142857142857,0.125,0.42718446601941745,0.7857142857142857,0.25925925925925924,0.125
Pseudoachondroplasia,27298,1,45,61,50,11,31,2,29,1.1111111111111112,0.044444444444444446,0.819672131147541,1.1111111111111112,0.06451612903225806,0.044444444444444446
Semilobar holoprosencephaly,32634,1,72,33,20,13,42,7,35,0.2777777777777778,0.09722222222222222,0.6060606060606061,0.2777777777777778,0.16666666666666666,0.09722222222222222
Rubinstein-Taybi syndrome due to 16p13.3 microdeletion,28368,2,88,20,13,7,30,6,24,0.14772727272727273,0.06818181818181818,0.65,0.14772727272727273,0.2,0.06818181818181818
Rubinstein-Taybi syndrome due to EP300 haploinsufficiency,31755,3,123,49,40,9,29,7,22,0.3252032520325203,0.056910569105691054,0.8163265306122449,0.3252032520325203,0.2413793103448276,0.056910569105691054
Midline interhemispheric variant of holoprosencephaly,32633,1,72,16,5,11,29,3,26,0.06944444444444445,0.041666666666666664,0.3125,0.06944444444444445,0.10344827586206896,0.041666666666666664
Alobar holoprosencephaly,32634,1,72,18,5,13,31,4,27,0.06944444444444445,0.05555555555555555,0.2777777777777778,0.06944444444444445,0.12903225806451613,0.05555555555555555
Lobar holoprosencephaly,32634,1,72,22,13,9,37,6,31,0.18055555555555555,0.08333333333333333,0.5909090909090909,0.18055555555555555,0.16216216216216217,0.08333333333333333
Rubinstein-Taybi syndrome due to CREBBP mutations,27993,4,123,35,24,11,30,6,24,0.1951219512195122,0.04878048780487805,0.6857142857142857,0.1951219512195122,0.2,0.04878048780487805
Shwachman-Diamond syndrome,30543,1,69,17,13,4,29,9,20,0.18840579710144928,0.13043478260869565,0.7647058823529411,0.18840579710144928,0.3103448275862069,0.13043478260869565
Achromatopsia,28348,4,20,16,13,3,27,4,23,0.65,0.2,0.8125,0.65,0.14814814814814814,0.2
Hereditary coproporphyria,27842,6,33,45,29,16,24,6,18,0.8787878787878788,0.18181818181818182,0.6444444444444445,0.8787878787878788,0.25,0.18181818181818182
PURA-related severe neonatal hypotonia-seizures-encephalopathy syndrome,29245,5,86,21,11,10,29,10,19,0.12790697674418605,0.11627906976744186,0.5238095238095238,0.12790697674418605,0.3448275862068966,0.11627906976744186
Infantile convulsions and choreoathetosis,27409,7,14,21,15,6,33,4,29,1.0714285714285714,0.2857142857142857,0.7142857142857143,1.0714285714285714,0.12121212121212122,0.2857142857142857
Mowat-Wilson syndrome due to a ZEB2 point mutation,32708,3,147,29,29,0,32,8,24,0.19727891156462585,0.05442176870748299,1.0,0.19727891156462585,0.25,0.05442176870748299
Colobomatous microphthalmia-obesity-hypogenitalism-intellectual disability syndrome,30814,6,14,16,12,4,17,5,12,0.8571428571428571,0.35714285714285715,0.75,0.8571428571428571,0.29411764705882354,0.35714285714285715
Mowat-Wilson syndrome due to monosomy 2q22,31695,2,129,17,6,11,42,8,34,0.046511627906976744,0.06201550387596899,0.35294117647058826,0.046511627906976744,0.19047619047619047,0.06201550387596899
Septopreoptic holoprosencephaly,32278,1,24,20,19,1,36,2,34,0.7916666666666666,0.08333333333333333,0.95,0.7916666666666666,0.05555555555555555,0.08333333333333333
Moyamoya angiopathy-short stature-facial dysmorphism-hypergonadotropic hypogonadism syndrome,29135,3,27,17,11,6,30,4,26,0.4074074074074074,0.14814814814814814,0.6470588235294118,0.4074074074074074,0.13333333333333333,0.14814814814814814
Combined immunodeficiency with facio-oculo-skeletal anomalies,27997,1,69,31,28,3,47,3,44,0.4057971014492754,0.043478260869565216,0.9032258064516129,0.4057971014492754,0.06382978723404255,0.043478260869565216
RNF13-related severe early-onset epileptic encephalopathy,98472,18,49,26,2,24,25,1,24,0.04081632653061224,0.02040816326530612,0.07692307692307693,0.04081632653061224,0.04,0.02040816326530612
Pancreatic agenesis-holoprosencephaly syndrome,31432,0,23,18,5,13,29,2,27,0.21739130434782608,0.08695652173913043,0.2777777777777778,0.21739130434782608,0.06896551724137931,0.08695652173913043
Severe generalized junctional epidermolysis bullosa,27638,3,61,20,19,1,20,3,17,0.3114754098360656,0.04918032786885246,0.95,0.3114754098360656,0.15,0.04918032786885246
Infantile multisystem neurologic-endocrine-pancreatic disease,29775,2,48,47,33,14,25,2,23,0.6875,0.041666666666666664,0.7021276595744681,0.6875,0.08,0.041666666666666664
Diamond-Blackfan anemia,27452,6,59,34,17,17,26,5,21,0.288135593220339,0.0847457627118644,0.5,0.288135593220339,0.19230769230769232,0.0847457627118644
"Carnitine palmitoyl transferase II deficiency, myopathic form",30379,2,21,18,16,2,19,3,16,0.7619047619047619,0.14285714285714285,0.8888888888888888,0.7619047619047619,0.15789473684210525,0.14285714285714285
Chédiak-Higashi syndrome,33060,1,76,16,10,6,9,2,7,0.13157894736842105,0.02631578947368421,0.625,0.13157894736842105,0.2222222222222222,0.02631578947368421
"Carnitine palmitoyl transferase II deficiency, neonatal form",30701,2,43,18,8,10,28,2,26,0.18604651162790697,0.046511627906976744,0.4444444444444444,0.18604651162790697,0.07142857142857142,0.046511627906976744
Carnitine palmitoyltransferase II deficiency,27251,2,42,17,5,12,31,9,22,0.11904761904761904,0.21428571428571427,0.29411764705882354,0.11904761904761904,0.2903225806451613,0.21428571428571427
Bloom syndrome,28619,0,67,24,20,4,35,2,33,0.29850746268656714,0.029850746268656716,0.8333333333333334,0.29850746268656714,0.05714285714285714,0.029850746268656716
"Carnitine palmitoyl transferase II deficiency, severe infantile form",30701,1,29,18,14,4,21,4,17,0.4827586206896552,0.13793103448275862,0.7777777777777778,0.4827586206896552,0.19047619047619047,0.13793103448275862
Zygomycosis,32249,1,76,25,23,2,16,3,13,0.3026315789473684,0.039473684210526314,0.92,0.3026315789473684,0.1875,0.039473684210526314
Staphylococcal necrotizing pneumonia,32393,4,38,16,17,-1,17,5,12,0.4473684210526316,0.13157894736842105,1.0625,0.4473684210526316,0.29411764705882354,0.13157894736842105
Boutonneuse fever,33543,6,26,24,24,0,26,8,18,0.9230769230769231,0.3076923076923077,1.0,0.9230769230769231,0.3076923076923077,0.3076923076923077
Japanese encephalitis,33372,3,82,17,16,1,31,8,23,0.1951219512195122,0.0975609756097561,0.9411764705882353,0.1951219512195122,0.25806451612903225,0.0975609756097561
Congenital stationary night blindness,27390,3,15,25,15,10,27,6,21,1.0,0.4,0.6,1.0,0.2222222222222222,0.4
Multiple endocrine neoplasia type 2,28426,8,48,25,4,21,33,5,28,0.08333333333333333,0.10416666666666667,0.16,0.08333333333333333,0.15151515151515152,0.10416666666666667
Pearson syndrome,29112,2,70,17,16,1,38,7,31,0.22857142857142856,0.1,0.9411764705882353,0.22857142857142856,0.18421052631578946,0.1
Li-Fraumeni syndrome,30516,3,35,17,14,3,20,5,15,0.4,0.14285714285714285,0.8235294117647058,0.4,0.25,0.14285714285714285
Cerebral autosomal dominant arteriopathy-subcortical infarcts-leukoencephalopathy,35890,20,40,35,9,26,30,8,22,0.225,0.2,0.2571428571428571,0.225,0.26666666666666666,0.2
Familial or sporadic hemiplegic migraine,33302,0,51,18,16,2,9,2,7,0.3137254901960784,0.0392156862745098,0.8888888888888888,0.3137254901960784,0.2222222222222222,0.0392156862745098
Alström syndrome,30145,1,117,19,14,5,25,5,20,0.11965811965811966,0.042735042735042736,0.7368421052631579,0.11965811965811966,0.2,0.042735042735042736
Autosomal recessive cerebelloparenchymal disorder type 3,28611,7,29,22,6,16,21,10,11,0.20689655172413793,0.3448275862068966,0.2727272727272727,0.20689655172413793,0.47619047619047616,0.3448275862068966
Fusariosis,32664,2,47,19,18,1,17,3,14,0.3829787234042553,0.06382978723404255,0.9473684210526315,0.3829787234042553,0.17647058823529413,0.06382978723404255
Pulmonary non-tuberculous mycobacterial infection,33377,7,21,15,17,-2,23,10,13,0.8095238095238095,0.47619047619047616,1.1333333333333333,0.8095238095238095,0.43478260869565216,0.47619047619047616
Self-limited neonatal epilepsy,33100,0,17,16,13,3,22,1,21,0.7647058823529411,0.058823529411764705,0.8125,0.7647058823529411,0.045454545454545456,0.058823529411764705
Kniest dysplasia,28026,1,51,44,37,7,29,3,26,0.7254901960784313,0.058823529411764705,0.8409090909090909,0.7254901960784313,0.10344827586206896,0.058823529411764705
Spinal muscular atrophy-progressive myoclonic epilepsy syndrome,27253,2,33,18,12,6,23,3,20,0.36363636363636365,0.09090909090909091,0.6666666666666666,0.36363636363636365,0.13043478260869565,0.09090909090909091
Lethal ataxia with deafness and optic atrophy,31740,4,30,16,7,9,25,7,18,0.23333333333333334,0.23333333333333334,0.4375,0.23333333333333334,0.28,0.23333333333333334
"Metaphyseal chondrodysplasia, Schmid type",31897,0,33,18,17,1,12,0,12,0.5151515151515151,0.0,0.9444444444444444,0.5151515151515151,0.0,0.0
Frontometaphyseal dysplasia,29683,0,62,66,50,16,4,0,4,0.8064516129032258,0.0,0.7575757575757576,0.8064516129032258,0.0,0.0
Lissencephaly type 1 due to doublecortin gene mutation,29958,4,30,27,14,13,25,1,24,0.4666666666666667,0.03333333333333333,0.5185185185185185,0.4666666666666667,0.04,0.03333333333333333
Facial dysmorphism-developmental delay-behavioral abnormalities syndrome due to WAC point mutation,30416,2,68,22,16,6,17,5,12,0.23529411764705882,0.07352941176470588,0.7272727272727273,0.23529411764705882,0.29411764705882354,0.07352941176470588
Cockayne syndrome type 1,27995,4,58,29,9,20,37,7,30,0.15517241379310345,0.1206896551724138,0.3103448275862069,0.15517241379310345,0.1891891891891892,0.1206896551724138
Facial dysmorphism-developmental delay-behavioral abnormalities syndrome due to 10p11.21p12.31 microdeletion,33024,3,46,17,15,2,21,3,18,0.32608695652173914,0.06521739130434782,0.8823529411764706,0.32608695652173914,0.14285714285714285,0.06521739130434782
Intellectual disability syndrome due to a DYRK1A point mutation,33278,1,68,23,19,4,26,5,21,0.27941176470588236,0.07352941176470588,0.8260869565217391,0.27941176470588236,0.19230769230769232,0.07352941176470588
Cockayne syndrome type 2,27995,6,41,17,5,12,33,7,26,0.12195121951219512,0.17073170731707318,0.29411764705882354,0.12195121951219512,0.21212121212121213,0.17073170731707318
"Spondyloepimetaphyseal dysplasia congenita, Strudwick type",31270,7,24,25,1,24,27,1,26,0.041666666666666664,0.041666666666666664,0.04,0.041666666666666664,0.037037037037037035,0.041666666666666664
Spondyloepiphyseal dysplasia congenita,38339,13,42,29,6,23,32,5,27,0.14285714285714285,0.11904761904761904,0.20689655172413793,0.14285714285714285,0.15625,0.11904761904761904
Dystrophic epidermolysis bullosa pruriginosa,27640,0,20,19,9,10,5,2,3,0.45,0.1,0.47368421052631576,0.45,0.4,0.1
Autosomal recessive cutis laxa type 1,27841,5,37,23,7,16,31,2,29,0.1891891891891892,0.05405405405405406,0.30434782608695654,0.1891891891891892,0.06451612903225806,0.05405405405405406
"Autosomal recessive generalized dystrophic epidermolysis bullosa, intermediate form",27641,2,46,24,22,2,22,4,18,0.4782608695652174,0.08695652173913043,0.9166666666666666,0.4782608695652174,0.18181818181818182,0.08695652173913043
Multiple epiphyseal dysplasia type 1,28099,0,21,111,18,93,5,0,5,0.8571428571428571,0.0,0.16216216216216217,0.8571428571428571,0.0,0.0
Multiple epiphyseal dysplasia type 5,28099,0,23,121,23,98,13,0,13,1.0,0.0,0.19008264462809918,1.0,0.0,0.0
Congenital sialidosis type 2,33392,0,42,37,39,-2,2,0,2,0.9285714285714286,0.0,1.054054054054054,0.9285714285714286,0.0,0.0
DYRK1A-related intellectual disability syndrome due to 21q22.13q22.2 microdeletion,33291,2,97,24,22,2,24,4,20,0.2268041237113402,0.041237113402061855,0.9166666666666666,0.2268041237113402,0.16666666666666666,0.041237113402061855
Ocular cystinosis,27613,7,4,16,4,12,18,2,16,1.0,0.5,0.25,1.0,0.1111111111111111,0.5
Unilateral focal polymicrogyria,28089,2,29,17,4,13,18,3,15,0.13793103448275862,0.10344827586206896,0.23529411764705882,0.13793103448275862,0.16666666666666666,0.10344827586206896
Unilateral hemispheric polymicrogyria,31034,1,14,16,1,15,30,4,26,0.07142857142857142,0.2857142857142857,0.0625,0.07142857142857142,0.13333333333333333,0.2857142857142857
Bilateral generalized polymicrogyria,27528,7,51,17,0,17,26,1,25,0.0,0.0196078431372549,0.0,0.0,0.038461538461538464,0.0196078431372549
"Localized dystrophic epidermolysis bullosa, acral form",94830,10,20,25,1,24,24,2,22,0.05,0.1,0.04,0.05,0.08333333333333333,0.1
Neuroferritinopathy,31590,7,43,44,36,8,24,5,19,0.8372093023255814,0.11627906976744186,0.8181818181818182,0.8372093023255814,0.20833333333333334,0.11627906976744186
Juvenile nephropathic cystinosis,27421,2,39,81,44,37,14,2,12,1.1282051282051282,0.05128205128205128,0.5432098765432098,1.1282051282051282,0.14285714285714285,0.05128205128205128
Gaucher disease-ophthalmoplegia-cardiovascular calcification syndrome,31032,6,63,59,56,3,46,10,36,0.8888888888888888,0.15873015873015872,0.9491525423728814,0.8888888888888888,0.21739130434782608,0.15873015873015872
Subependymal nodular heterotopia,32223,1,23,20,23,-3,27,3,24,1.0,0.13043478260869565,1.15,1.0,0.1111111111111111,0.13043478260869565
Sub-cortical nodular heterotopia,32232,1,15,17,12,5,14,1,13,0.8,0.06666666666666667,0.7058823529411765,0.8,0.07142857142857142,0.06666666666666667
Cockayne syndrome type 3,27995,5,74,17,6,11,33,3,30,0.08108108108108109,0.04054054054054054,0.35294117647058826,0.08108108108108109,0.09090909090909091,0.04054054054054054
Bilateral frontal polymicrogyria,27722,6,11,19,11,8,24,2,22,1.0,0.18181818181818182,0.5789473684210527,1.0,0.08333333333333333,0.18181818181818182
Bilateral parasagittal parieto-occipital polymicrogyria,28089,4,29,18,16,2,25,5,20,0.5517241379310345,0.1724137931034483,0.8888888888888888,0.5517241379310345,0.2,0.1724137931034483
Bilateral frontoparietal polymicrogyria,27722,6,24,20,5,15,24,1,23,0.20833333333333334,0.041666666666666664,0.25,0.20833333333333334,0.041666666666666664,0.041666666666666664
Bilateral perisylvian polymicrogyria,27528,8,49,17,5,12,30,5,25,0.10204081632653061,0.10204081632653061,0.29411764705882354,0.10204081632653061,0.16666666666666666,0.10204081632653061
Lissencephaly due to LIS1 mutation,31829,1,44,18,14,4,18,1,17,0.3181818181818182,0.022727272727272728,0.7777777777777778,0.3181818181818182,0.05555555555555555,0.022727272727272728
Autosomal recessive cutis laxa type 2A,27841,2,53,32,14,18,17,2,15,0.2641509433962264,0.03773584905660377,0.4375,0.2641509433962264,0.11764705882352941,0.03773584905660377
Neonatal inflammatory skin and bowel disease,29248,3,18,19,10,9,12,2,10,0.5555555555555556,0.1111111111111111,0.5263157894736842,0.5555555555555556,0.16666666666666666,0.1111111111111111
Lamb-Shaffer syndrome,30622,0,34,17,13,4,16,0,16,0.38235294117647056,0.0,0.7647058823529411,0.38235294117647056,0.0,0.0
Growth delay-intellectual disability-hepatopathy syndrome,29710,2,35,21,18,3,26,4,22,0.5142857142857142,0.11428571428571428,0.8571428571428571,0.5142857142857142,0.15384615384615385,0.11428571428571428
GNB5-related intellectual disability-cardiac arrhythmia syndrome,28481,2,22,19,18,1,29,2,27,0.8181818181818182,0.09090909090909091,0.9473684210526315,0.8181818181818182,0.06896551724137931,0.09090909090909091
SYNGAP1-related developmental and epileptic encephalopathy,32579,3,41,27,26,1,24,5,19,0.6341463414634146,0.12195121951219512,0.9629629629629629,0.6341463414634146,0.20833333333333334,0.12195121951219512
Cobblestone lissencephaly without muscular or ocular involvement,27730,2,13,16,7,9,26,0,26,0.5384615384615384,0.0,0.4375,0.5384615384615384,0.0,0.0
Muscle-eye-brain disease with bilateral multicystic leucodystrophy,32226,0,23,17,16,1,33,0,33,0.6956521739130435,0.0,0.9411764705882353,0.6956521739130435,0.0,0.0
Isolated lissencephaly type 1 without known genetic defects,32992,1,17,17,16,1,36,1,35,0.9411764705882353,0.058823529411764705,0.9411764705882353,0.9411764705882353,0.027777777777777776,0.058823529411764705
"Autosomal recessive generalized dystrophic epidermolysis bullosa, severe form",27641,1,58,16,12,4,16,5,11,0.20689655172413793,0.08620689655172414,0.75,0.20689655172413793,0.3125,0.08620689655172414
"Localized dystrophic epidermolysis bullosa, pretibial form",27640,1,35,31,13,18,13,4,9,0.37142857142857144,0.11428571428571428,0.41935483870967744,0.37142857142857144,0.3076923076923077,0.11428571428571428
Recessive dystrophic epidermolysis bullosa inversa,27641,4,28,30,13,17,16,6,10,0.4642857142857143,0.21428571428571427,0.43333333333333335,0.4642857142857143,0.375,0.21428571428571427
Self-improving dystrophic epidermolysis bullosa,27640,0,27,18,4,14,8,3,5,0.14814814814814814,0.1111111111111111,0.2222222222222222,0.14814814814814814,0.375,0.1111111111111111
"Autosomal recessive ataxia, Beauce type",30231,4,41,38,38,0,15,8,7,0.926829268292683,0.1951219512195122,1.0,0.926829268292683,0.5333333333333333,0.1951219512195122
"X-linked intellectual disability, Porteous type",28944,3,14,19,2,17,33,1,32,0.14285714285714285,0.07142857142857142,0.10526315789473684,0.14285714285714285,0.030303030303030304,0.07142857142857142
Isolated anencephaly,29207,0,8,21,0,21,15,0,15,0.0,0.0,0.0,0.0,0.0,0.0
"X-linked intellectual disability, Sutherland-Haan type",38443,19,18,22,2,20,32,2,30,0.1111111111111111,0.1111111111111111,0.09090909090909091,0.1111111111111111,0.0625,0.1111111111111111
Juvenile sialidosis type 2,33195,0,38,32,34,-2,6,0,6,0.8947368421052632,0.0,1.0625,0.8947368421052632,0.0,0.0
Isolated exencephaly,29207,4,16,26,0,26,30,2,28,0.0,0.125,0.0,0.0,0.06666666666666667,0.125
Variegate porphyria,29457,4,48,44,39,5,25,7,18,0.8125,0.14583333333333334,0.8863636363636364,0.8125,0.28,0.14583333333333334
Spondyloenchondrodysplasia,38339,13,52,21,3,18,45,5,40,0.057692307692307696,0.09615384615384616,0.14285714285714285,0.057692307692307696,0.1111111111111111,0.09615384615384616
FOXG1 syndrome,39034,14,49,29,2,27,29,4,25,0.04081632653061224,0.08163265306122448,0.06896551724137931,0.04081632653061224,0.13793103448275862,0.08163265306122448
Global developmental delay-alopecia-macrocephaly-facial dysmorphism-structural brain anomalies syndrome,32887,3,56,19,18,1,39,2,37,0.32142857142857145,0.03571428571428571,0.9473684210526315,0.32142857142857145,0.05128205128205128,0.03571428571428571
Combined oxidative phosphorylation defect type 39,38594,17,52,22,1,21,29,3,26,0.019230769230769232,0.057692307692307696,0.045454545454545456,0.019230769230769232,0.10344827586206896,0.057692307692307696
Primary hypomagnesemia-refractory seizures-intellectual disability syndrome,32060,12,12,24,1,23,26,0,26,0.08333333333333333,0.0,0.041666666666666664,0.08333333333333333,0.0,0.0
WARS2-related combined oxidative phosphorylation defect,39041,17,57,27,7,20,27,6,21,0.12280701754385964,0.10526315789473684,0.25925925925925924,0.12280701754385964,0.2222222222222222,0.10526315789473684
17q21.31 microdeletion syndrome,32429,6,124,100,100,0,28,6,22,0.8064516129032258,0.04838709677419355,1.0,0.8064516129032258,0.21428571428571427,0.04838709677419355
Koolen-De Vries syndrome due to a point mutation,32595,4,124,98,99,-1,34,12,22,0.7983870967741935,0.0967741935483871,1.010204081632653,0.7983870967741935,0.35294117647058826,0.0967741935483871
Angelman syndrome due to a point mutation,33073,3,34,20,17,3,26,2,24,0.5,0.058823529411764705,0.85,0.5,0.07692307692307693,0.058823529411764705
Angelman syndrome due to imprinting defect in 15q11-q13,33074,1,27,20,19,1,21,1,20,0.7037037037037037,0.037037037037037035,0.95,0.7037037037037037,0.047619047619047616,0.037037037037037035
Angelman syndrome due to maternal 15q11q13 deletion,32657,2,50,19,17,2,20,3,17,0.34,0.06,0.8947368421052632,0.34,0.15,0.06
Angelman syndrome due to paternal uniparental disomy of chromosome 15,32658,1,28,19,20,-1,25,1,24,0.7142857142857143,0.03571428571428571,1.0526315789473684,0.7142857142857143,0.04,0.03571428571428571
Rothmund-Thomson syndrome type 2,27814,3,67,48,21,27,31,5,26,0.31343283582089554,0.07462686567164178,0.4375,0.31343283582089554,0.16129032258064516,0.07462686567164178
"Methylmalonic acidemia with homocystinuria, type cblC",33171,6,76,17,11,6,28,5,23,0.14473684210526316,0.06578947368421052,0.6470588235294118,0.14473684210526316,0.17857142857142858,0.06578947368421052
Rothmund-Thomson syndrome type 1,27814,4,64,27,14,13,33,6,27,0.21875,0.09375,0.5185185185185185,0.21875,0.18181818181818182,0.09375
Temple syndrome due to paternal 14q32.2 microdeletion,32465,2,22,18,19,-1,28,3,25,0.8636363636363636,0.13636363636363635,1.0555555555555556,0.8636363636363636,0.10714285714285714,0.13636363636363635
Temple syndrome due to paternal 14q32.2 hypomethylation,32461,2,28,19,19,0,51,3,48,0.6785714285714286,0.10714285714285714,1.0,0.6785714285714286,0.058823529411764705,0.10714285714285714
B3GALT6-related spondylodysplastic Ehlers-Danlos syndrome,31142,2,83,33,12,21,23,3,20,0.14457831325301204,0.03614457831325301,0.36363636363636365,0.14457831325301204,0.13043478260869565,0.03614457831325301
Temple syndrome due to maternal uniparental disomy of chromosome 14,29482,4,35,45,29,16,26,4,22,0.8285714285714286,0.11428571428571428,0.6444444444444445,0.8285714285714286,0.15384615384615385,0.11428571428571428
Prader-Willi syndrome due to paternal deletion of 15q11q13 type 2,32961,5,71,18,10,8,50,10,40,0.14084507042253522,0.14084507042253522,0.5555555555555556,0.14084507042253522,0.2,0.14084507042253522
Prader-Willi syndrome due to paternal deletion of 15q11q13 type 1,32961,5,71,18,9,9,34,7,27,0.1267605633802817,0.09859154929577464,0.5,0.1267605633802817,0.20588235294117646,0.09859154929577464
Prader-Willi syndrome due to paternal 15q11q13 deletion,32961,4,70,17,9,8,33,6,27,0.12857142857142856,0.08571428571428572,0.5294117647058824,0.12857142857142856,0.18181818181818182,0.08571428571428572
Neurodevelopmental disorder-craniofacial dysmorphism-cardiac defect-skeletal anomalies syndrome due to a point mutation,29350,0,90,18,3,15,35,8,27,0.03333333333333333,0.08888888888888889,0.16666666666666666,0.03333333333333333,0.22857142857142856,0.08888888888888889
Neurodevelopmental disorder-craniofacial dysmorphism-cardiac defect-skeletal anomalies syndrome due to 9q21.3 microdeletion,33183,2,90,17,2,15,19,6,13,0.022222222222222223,0.06666666666666667,0.11764705882352941,0.022222222222222223,0.3157894736842105,0.06666666666666667
PURA-related severe neonatal hypotonia-seizures-encephalopathy syndrome due to a point mutation,29245,4,38,17,8,9,31,5,26,0.21052631578947367,0.13157894736842105,0.47058823529411764,0.21052631578947367,0.16129032258064516,0.13157894736842105
Severe neonatal hypotonia-seizures-encephalopathy syndrome due to 5q31.3 microdeletion,33289,2,37,19,19,0,29,3,26,0.5135135135135135,0.08108108108108109,1.0,0.5135135135135135,0.10344827586206896,0.08108108108108109
Distal triplication 15q syndrome,33436,1,45,17,6,11,38,2,36,0.13333333333333333,0.044444444444444446,0.35294117647058826,0.13333333333333333,0.05263157894736842,0.044444444444444446
Kleefstra syndrome due to a point mutation,32549,4,50,23,20,3,27,8,19,0.4,0.16,0.8695652173913043,0.4,0.2962962962962963,0.16
Kagami-Ogata syndrome due to maternal 14q32.2 hypermethylation,32462,3,19,18,13,5,44,1,43,0.6842105263157895,0.05263157894736842,0.7222222222222222,0.6842105263157895,0.022727272727272728,0.05263157894736842
Familial infantile myoclonic epilepsy,29656,0,25,17,12,5,15,1,14,0.48,0.04,0.7058823529411765,0.48,0.06666666666666667,0.04
Methylmalonic acidemia with homocystinuria type cblF,33171,7,28,22,6,16,34,1,33,0.21428571428571427,0.03571428571428571,0.2727272727272727,0.21428571428571427,0.029411764705882353,0.03571428571428571
Kagami-Ogata syndrome due to maternal 14q32.2 microdeletion,32472,1,38,17,5,12,34,1,33,0.13157894736842105,0.02631578947368421,0.29411764705882354,0.13157894736842105,0.029411764705882353,0.02631578947368421
Kagami-Ogata syndrome due to paternal uniparental disomy of chromosome 14,32472,1,120,17,13,4,34,4,30,0.10833333333333334,0.03333333333333333,0.7647058823529411,0.10833333333333334,0.11764705882352941,0.03333333333333333
Autosomal spastic paraplegia type 18,30156,2,34,20,4,16,19,3,16,0.11764705882352941,0.08823529411764706,0.2,0.11764705882352941,0.15789473684210525,0.08823529411764706
Autosomal dominant generalized dystrophic epidermolysis bullosa,27641,3,15,22,9,13,22,7,15,0.6,0.4666666666666667,0.4090909090909091,0.6,0.3181818181818182,0.4666666666666667
Retinal vasculopathy with cerebral leukoencephalopathy and systemic manifestations,28728,0,50,19,0,19,20,2,18,0.0,0.04,0.0,0.0,0.1,0.04
Pyruvate dehydrogenase E2 deficiency,29463,1,32,27,18,9,33,1,32,0.5625,0.03125,0.6666666666666666,0.5625,0.030303030303030304,0.03125
"Mucopolysaccharidosis type 2, attenuated form",27436,9,79,19,8,11,31,9,22,0.10126582278481013,0.11392405063291139,0.42105263157894735,0.10126582278481013,0.2903225806451613,0.11392405063291139
Pyruvate dehydrogenase E1-alpha deficiency,30558,2,55,20,10,10,30,2,28,0.18181818181818182,0.03636363636363636,0.5,0.18181818181818182,0.06666666666666667,0.03636363636363636
Multiple epiphyseal dysplasia due to collagen 9 anomaly,32964,1,24,22,22,0,27,2,25,0.9166666666666666,0.08333333333333333,1.0,0.9166666666666666,0.07407407407407407,0.08333333333333333
EAST syndrome,30292,0,26,17,14,3,33,0,33,0.5384615384615384,0.0,0.8235294117647058,0.5384615384615384,0.0,0.0
Pelizaeus-Merzbacher disease in female carriers,32449,2,29,17,19,-2,33,3,30,0.6551724137931034,0.10344827586206896,1.1176470588235294,0.6551724137931034,0.09090909090909091,0.10344827586206896
Null syndrome,32447,2,15,18,13,5,47,0,47,0.8666666666666667,0.0,0.7222222222222222,0.8666666666666667,0.0,0.0
X-linked intellectual disability with isolated growth hormone deficiency,33232,3,14,22,14,8,25,2,23,1.0,0.14285714285714285,0.6363636363636364,1.0,0.08,0.14285714285714285
"Mucopolysaccharidosis type 2, severe form",27436,9,77,20,6,14,21,7,14,0.07792207792207792,0.09090909090909091,0.3,0.07792207792207792,0.3333333333333333,0.09090909090909091
"Lissencephaly syndrome, Norman-Roberts type",29674,2,35,41,32,9,34,3,31,0.9142857142857143,0.08571428571428572,0.7804878048780488,0.9142857142857143,0.08823529411764706,0.08571428571428572
"Pelizaeus-Merzbacher disease, connatal form",32449,2,27,17,6,11,30,5,25,0.2222222222222222,0.18518518518518517,0.35294117647058826,0.2222222222222222,0.16666666666666666,0.18518518518518517
"Pelizaeus-Merzbacher disease, classic form",32148,12,27,26,4,22,28,7,21,0.14814814814814814,0.25925925925925924,0.15384615384615385,0.14814814814814814,0.25,0.25925925925925924
"Pelizaeus-Merzbacher disease, transitional form",32148,11,5,26,0,26,32,0,32,0.0,0.0,0.0,0.0,0.0,0.0
"HSD10 disease, infantile type",32958,1,51,51,49,2,18,1,17,0.9607843137254902,0.0196078431372549,0.9607843137254902,0.9607843137254902,0.05555555555555555,0.0196078431372549
Achondrogenesis type 2,27350,2,25,33,13,20,34,3,31,0.52,0.12,0.3939393939393939,0.52,0.08823529411764706,0.12
Leukocyte adhesion deficiency type II,28125,0,58,19,8,11,24,3,21,0.13793103448275862,0.05172413793103448,0.42105263157894735,0.13793103448275862,0.125,0.05172413793103448
"HSD10 disease, neonatal type",32958,0,9,17,4,13,14,0,14,0.4444444444444444,0.0,0.23529411764705882,0.4444444444444444,0.0,0.0
17q11 microdeletion syndrome,32429,4,94,99,15,84,25,5,20,0.1595744680851064,0.05319148936170213,0.15151515151515152,0.1595744680851064,0.2,0.05319148936170213
Juvenile amyotrophic lateral sclerosis,31996,5,46,43,41,2,25,6,19,0.8913043478260869,0.13043478260869565,0.9534883720930233,0.8913043478260869,0.24,0.13043478260869565
X-linked cerebral adrenoleukodystrophy,30664,3,51,24,15,9,33,4,29,0.29411764705882354,0.0784313725490196,0.625,0.29411764705882354,0.12121212121212122,0.0784313725490196
X-linked complicated spastic paraplegia type 1,38818,12,9,22,1,21,14,1,13,0.1111111111111111,0.1111111111111111,0.045454545454545456,0.1111111111111111,0.07142857142857142,0.1111111111111111
Pyruvate dehydrogenase E1-beta deficiency,30558,2,23,20,18,2,24,2,22,0.782608695652174,0.08695652173913043,0.9,0.782608695652174,0.08333333333333333,0.08695652173913043
Pyruvate dehydrogenase phosphatase deficiency,28544,1,11,19,9,10,22,1,21,0.8181818181818182,0.09090909090909091,0.47368421052631576,0.8181818181818182,0.045454545454545456,0.09090909090909091
Pyruvate dehydrogenase E3-binding protein deficiency,29726,2,23,19,10,9,25,2,23,0.43478260869565216,0.08695652173913043,0.5263157894736842,0.43478260869565216,0.08,0.08695652173913043
Mucolipidosis type III alpha/beta,27333,0,36,18,7,11,19,0,19,0.19444444444444445,0.0,0.3888888888888889,0.19444444444444445,0.0,0.0
Aromatic L-amino acid decarboxylase deficiency,29414,0,38,21,10,11,35,0,35,0.2631578947368421,0.0,0.47619047619047616,0.2631578947368421,0.0,0.0
High-grade dysplasia in patients with Barrett esophagus,96748,15,4,21,1,20,22,1,21,0.25,0.25,0.047619047619047616,0.25,0.045454545454545456,0.25
AIDS wasting syndrome,94952,10,8,25,4,21,32,2,30,0.5,0.25,0.16,0.5,0.0625,0.25
Pouchitis,97049,13,10,19,6,13,20,6,14,0.6,0.6,0.3157894736842105,0.6,0.3,0.6
Full schwannomatosis,27477,2,21,26,2,24,24,0,24,0.09523809523809523,0.0,0.07692307692307693,0.09523809523809523,0.0,0.0
Isolated corpus callosum agenesis,29786,6,12,29,3,26,32,3,29,0.25,0.25,0.10344827586206896,0.25,0.09375,0.25
Interatrial communication,38046,10,19,27,6,21,19,4,15,0.3157894736842105,0.21052631578947367,0.2222222222222222,0.3157894736842105,0.21052631578947367,0.21052631578947367
Multicystic dysplastic kidney,95053,10,15,23,3,20,21,3,18,0.2,0.2,0.13043478260869565,0.2,0.14285714285714285,0.2
Weiss-Kruszka Syndrome,30327,0,29,22,9,13,34,1,33,0.3103448275862069,0.034482758620689655,0.4090909090909091,0.3103448275862069,0.029411764705882353,0.034482758620689655
Congenital syphilis,84178,8,46,23,1,22,22,4,18,0.021739130434782608,0.08695652173913043,0.043478260869565216,0.021739130434782608,0.18181818181818182,0.08695652173913043
Spinal cord injury,84275,12,15,25,3,22,25,4,21,0.2,0.26666666666666666,0.12,0.2,0.16,0.26666666666666666
Hepatitis delta,97156,14,18,24,8,16,22,10,12,0.4444444444444444,0.5555555555555556,0.3333333333333333,0.4444444444444444,0.45454545454545453,0.5555555555555556
Patent urachus,94583,11,10,21,2,19,26,2,24,0.2,0.2,0.09523809523809523,0.2,0.07692307692307693,0.2
Gelatinous drop-like corneal dystrophy,28604,12,11,19,5,14,17,4,13,0.45454545454545453,0.36363636363636365,0.2631578947368421,0.45454545454545453,0.23529411764705882,0.36363636363636365
Sympathetic ophthalmia,84096,17,25,24,3,21,23,5,18,0.12,0.2,0.125,0.12,0.21739130434782608,0.2
Congenital fibrosis of extraocular muscles,29189,20,35,29,6,23,26,5,21,0.17142857142857143,0.14285714285714285,0.20689655172413793,0.17142857142857143,0.19230769230769232,0.14285714285714285
Autosomal dominant adult-onset proximal spinal muscular atrophy,28247,0,20,20,4,16,25,3,22,0.2,0.15,0.2,0.2,0.12,0.15
Kleine-Levin syndrome,29682,12,35,23,9,14,29,10,19,0.2571428571428571,0.2857142857142857,0.391304347826087,0.2571428571428571,0.3448275862068966,0.2857142857142857
Acute radiation syndrome,95048,19,24,19,4,15,31,6,25,0.16666666666666666,0.25,0.21052631578947367,0.16666666666666666,0.1935483870967742,0.25
Congenital heart block,29836,5,29,16,3,13,22,4,18,0.10344827586206896,0.13793103448275862,0.1875,0.10344827586206896,0.18181818181818182,0.13793103448275862
Hydroa vacciniforme,38905,0,18,1,0,1,21,2,19,0.0,0.1111111111111111,0.0,0.0,0.09523809523809523,0.1111111111111111
Acute generalized exanthematous pustulosis,98282,5,23,25,3,22,16,2,14,0.13043478260869565,0.08695652173913043,0.12,0.13043478260869565,0.125,0.08695652173913043
Generalized pustular psoriasis,95091,9,27,32,7,25,33,6,27,0.25925925925925924,0.2222222222222222,0.21875,0.25925925925925924,0.18181818181818182,0.2222222222222222
Subacute cutaneous lupus erythematosus,84252,4,19,30,3,27,22,0,22,0.15789473684210525,0.0,0.1,0.15789473684210525,0.0,0.0
High altitude pulmonary edema,28417,10,21,21,10,11,23,13,10,0.47619047619047616,0.6190476190476191,0.47619047619047616,0.47619047619047616,0.5652173913043478,0.6190476190476191
Multifocal atrial tachycardia,84050,13,23,19,7,12,19,5,14,0.30434782608695654,0.21739130434782608,0.3684210526315789,0.30434782608695654,0.2631578947368421,0.21739130434782608
Fuchs heterochromic iridocyclitis,98202,10,22,26,8,18,20,5,15,0.36363636363636365,0.22727272727272727,0.3076923076923077,0.36363636363636365,0.25,0.22727272727272727
ALECT2 amyloidosis,98538,8,11,30,1,29,23,0,23,0.09090909090909091,0.0,0.03333333333333333,0.09090909090909091,0.0,0.0
Cerebral Amyloid Angiopathy,29399,9,13,18,5,13,23,1,22,0.38461538461538464,0.07692307692307693,0.2777777777777778,0.38461538461538464,0.043478260869565216,0.07692307692307693
Hereditary ATTR amyloidosis,37798,20,36,30,8,22,27,7,20,0.2222222222222222,0.19444444444444445,0.26666666666666666,0.2222222222222222,0.25925925925925924,0.19444444444444445
ITM2B amyloidosis,30929,2,8,17,2,15,23,0,23,0.25,0.0,0.11764705882352941,0.25,0.0,0.0
Paraneoplastic sensory ganglionopathy,97534,21,1,35,0,35,26,0,26,0.0,0.0,0.0,0.0,0.0,0.0
Morvan syndrome,97658,17,1,25,0,25,24,0,24,0.0,0.0,0.0,0.0,0.0,0.0
Post-transplant lymphoproliferative disease,84332,20,16,27,8,19,22,6,16,0.5,0.375,0.2962962962962963,0.5,0.2727272727272727,0.375
AH amyloidosis,33591,0,8,10,3,7,26,0,26,0.375,0.0,0.3,0.375,0.0,0.0
Visual snow syndrome,98517,14,23,23,9,14,22,8,14,0.391304347826087,0.34782608695652173,0.391304347826087,0.391304347826087,0.36363636363636365,0.34782608695652173
Cat-scratch disease,84076,10,22,14,2,12,18,3,15,0.09090909090909091,0.13636363636363635,0.14285714285714285,0.09090909090909091,0.16666666666666666,0.13636363636363635
Submucosal cleft palate,94758,9,6,18,0,18,24,1,23,0.0,0.16666666666666666,0.0,0.0,0.041666666666666664,0.16666666666666666
Soft and hard cleft palate,28138,9,4,27,0,27,26,1,25,0.0,0.25,0.0,0.0,0.038461538461538464,0.25
Menke-Hennekam syndrome,31425,1,44,18,10,8,41,4,37,0.22727272727272727,0.09090909090909091,0.5555555555555556,0.22727272727272727,0.0975609756097561,0.09090909090909091
X-linked lymphoproliferative disease due to XIAP deficiency,30730,3,22,19,11,8,36,6,30,0.5,0.2727272727272727,0.5789473684210527,0.5,0.16666666666666666,0.2727272727272727
GATA2 deficiency spectrum,39053,12,28,31,0,31,30,1,29,0.0,0.03571428571428571,0.0,0.0,0.03333333333333333,0.03571428571428571
Hereditary angioedema with C1Inh deficiency,28441,4,22,9,5,4,29,7,22,0.22727272727272727,0.3181818181818182,0.5555555555555556,0.22727272727272727,0.2413793103448276,0.3181818181818182
Pellagra,27367,9,43,17,6,11,26,10,16,0.13953488372093023,0.23255813953488372,0.35294117647058826,0.13953488372093023,0.38461538461538464,0.23255813953488372
Congenital infiltrating lipomatosis of the face,28575,2,20,16,0,16,30,3,27,0.0,0.15,0.0,0.0,0.1,0.15
Idiopathic small fibers neuropathy,39080,11,22,25,2,23,41,5,36,0.09090909090909091,0.22727272727272727,0.08,0.09090909090909091,0.12195121951219512,0.22727272727272727
Antiphospholipid syndrome,30256,8,39,16,5,11,25,7,18,0.1282051282051282,0.1794871794871795,0.3125,0.1282051282051282,0.28,0.1794871794871795
Immunoglobulin A nephropathy,28827,3,17,18,3,15,17,3,14,0.17647058823529413,0.17647058823529413,0.16666666666666666,0.17647058823529413,0.17647058823529413,0.17647058823529413
TAFRO syndrome,98574,9,25,9,0,9,10,1,9,0.0,0.04,0.0,0.0,0.1,0.04
CLOVES syndrome,27909,1,43,16,8,8,27,1,26,0.18604651162790697,0.023255813953488372,0.5,0.18604651162790697,0.037037037037037035,0.023255813953488372
IgG4-related systemic disease,39127,12,30,32,4,28,23,6,17,0.13333333333333333,0.2,0.125,0.13333333333333333,0.2608695652173913,0.2
Undifferentiated connective tissue syndrome,98675,20,3,26,0,26,31,0,31,0.0,0.0,0.0,0.0,0.0,0.0
Primary membranous glomerulonephritis,94687,10,1,19,0,19,28,0,28,0.0,0.0,0.0,0.0,0.0,0.0
Immune-mediated thrombotic thrombocytopenic purpura,29935,4,40,18,10,8,24,9,15,0.25,0.225,0.5555555555555556,0.25,0.375,0.225
Macrodactyly of fingers,98332,4,8,14,1,13,22,1,21,0.125,0.125,0.07142857142857142,0.125,0.045454545454545456,0.125
Segmental progressive overgrowth syndrome with fibroadipose hyperplasia,98376,1,14,15,0,15,43,2,41,0.0,0.14285714285714285,0.0,0.0,0.046511627906976744,0.14285714285714285
MYT1L-related developmental delay-intellectual disability-obesity syndrome,30178,4,64,48,16,32,31,7,24,0.25,0.109375,0.3333333333333333,0.25,0.22580645161290322,0.109375
Macrodactyly of toes,98334,2,17,4,0,4,19,0,19,0.0,0.0,0.0,0.0,0.0,0.0
Focal stiff limb syndrome,98552,12,17,20,0,20,32,3,29,0.0,0.17647058823529413,0.0,0.0,0.09375,0.17647058823529413
Sternal cleft,32538,0,6,14,1,13,29,6,23,0.16666666666666666,1.0,0.07142857142857142,0.16666666666666666,0.20689655172413793,1.0
Isolated proximal femoral focal deficiency,27536,2,7,27,2,25,20,2,18,0.2857142857142857,0.2857142857142857,0.07407407407407407,0.2857142857142857,0.1,0.2857142857142857
Langerhans cell histiocytosis,36458,14,27,25,7,18,35,9,26,0.25925925925925924,0.3333333333333333,0.28,0.25925925925925924,0.2571428571428571,0.3333333333333333
Body integrity dysphoria,95275,8,6,29,1,28,26,2,24,0.16666666666666666,0.3333333333333333,0.034482758620689655,0.16666666666666666,0.07692307692307693,0.3333333333333333
Paraneoplastic cerebellar degeneration,99919,14,23,16,5,11,14,5,9,0.21739130434782608,0.21739130434782608,0.3125,0.21739130434782608,0.35714285714285715,0.21739130434782608
Hyperphenylalaninemia due to tetrahydrobiopterin deficiency,38743,19,23,27,3,24,31,5,26,0.13043478260869565,0.21739130434782608,0.1111111111111111,0.13043478260869565,0.16129032258064516,0.21739130434782608
Non-syndromic unicoronal craniosynostosis,27344,1,14,19,1,18,30,2,28,0.07142857142857142,0.14285714285714285,0.05263157894736842,0.07142857142857142,0.06666666666666667,0.14285714285714285
Ring chromosome 20 syndrome,97976,18,12,29,3,26,28,3,25,0.25,0.25,0.10344827586206896,0.25,0.10714285714285714,0.25
Glycogen storage disease due to muscle phosphorylase kinase deficiency,32211,2,16,18,2,16,23,3,20,0.125,0.1875,0.1111111111111111,0.125,0.13043478260869565,0.1875
Sitosterolemia,28490,2,13,17,7,10,32,2,30,0.5384615384615384,0.15384615384615385,0.4117647058823529,0.5384615384615384,0.0625,0.15384615384615385
Ring chromosome 18 syndrome,97974,18,14,23,5,18,26,5,21,0.35714285714285715,0.35714285714285715,0.21739130434782608,0.35714285714285715,0.19230769230769232,0.35714285714285715
Hereditary angioedema with normal C1Inh,38991,21,13,26,4,22,33,4,29,0.3076923076923077,0.3076923076923077,0.15384615384615385,0.3076923076923077,0.12121212121212122,0.3076923076923077
Subacute sclerosing leukoencephalitis,28636,7,34,19,1,18,19,2,17,0.029411764705882353,0.058823529411764705,0.05263157894736842,0.029411764705882353,0.10526315789473684,0.058823529411764705
Severe disseminated cytomegalovirus infection in immunocompetent patients,98445,22,29,32,10,22,31,8,23,0.3448275862068966,0.27586206896551724,0.3125,0.3448275862068966,0.25806451612903225,0.27586206896551724
Discoid lupus erythematosus,84030,21,10,28,0,28,30,2,28,0.0,0.2,0.0,0.0,0.06666666666666667,0.2
Pediatric acute respiratory distress syndrome,38762,7,16,22,7,15,19,6,13,0.4375,0.375,0.3181818181818182,0.4375,0.3157894736842105,0.375
Idiopathic bilateral vestibulopathy,98027,15,10,25,3,22,27,3,24,0.3,0.3,0.12,0.3,0.1111111111111111,0.3
Cleft hard palate,28138,4,5,11,2,9,34,3,31,0.4,0.6,0.18181818181818182,0.4,0.08823529411764706,0.6
Oculo-auriculo-vertebral spectrum,29829,1,29,17,1,16,26,3,23,0.034482758620689655,0.10344827586206896,0.058823529411764705,0.034482758620689655,0.11538461538461539,0.10344827586206896
Resistance to thyroid hormone due to a mutation in thyroid hormone receptor beta,38315,2,20,5,0,5,21,0,21,0.0,0.0,0.0,0.0,0.0,0.0
Holmes-Adie syndrome,30340,2,11,24,1,23,31,2,29,0.09090909090909091,0.18181818181818182,0.041666666666666664,0.09090909090909091,0.06451612903225806,0.18181818181818182
Hemifacial hyperplasia,28014,3,14,19,3,16,35,1,34,0.21428571428571427,0.07142857142857142,0.15789473684210525,0.21428571428571427,0.02857142857142857,0.07142857142857142
Isolated tracheoesophageal fistula,83963,14,10,21,4,17,17,4,13,0.4,0.4,0.19047619047619047,0.4,0.23529411764705882,0.4
X-linked adrenal hypoplasia congenita,27878,6,24,18,4,14,31,3,28,0.16666666666666666,0.125,0.2222222222222222,0.16666666666666666,0.0967741935483871,0.125
Nevus of Ito,94967,5,3,18,0,18,16,1,15,0.0,0.3333333333333333,0.0,0.0,0.0625,0.3333333333333333
Apnea of prematurity,98872,19,5,26,5,21,23,5,18,1.0,1.0,0.19230769230769232,1.0,0.21739130434782608,1.0
Autoimmune limbic encephalitis,98243,17,22,25,4,21,28,4,24,0.18181818181818182,0.18181818181818182,0.16,0.18181818181818182,0.14285714285714285,0.18181818181818182
Methotrexate toxicity,99694,16,22,35,10,25,30,10,20,0.45454545454545453,0.45454545454545453,0.2857142857142857,0.45454545454545453,0.3333333333333333,0.45454545454545453
Univentricular heart,98819,9,14,18,3,15,28,2,26,0.21428571428571427,0.14285714285714285,0.16666666666666666,0.21428571428571427,0.07142857142857142,0.14285714285714285
Fatal familial insomnia,31404,4,34,19,11,8,35,9,26,0.3235294117647059,0.2647058823529412,0.5789473684210527,0.3235294117647059,0.2571428571428571,0.2647058823529412
Cytomegalovirus disease in patients with impaired cell mediated immunity deemed at risk,98445,16,13,17,3,14,19,3,16,0.23076923076923078,0.23076923076923078,0.17647058823529413,0.23076923076923078,0.15789473684210525,0.23076923076923078
"Dyssegmental dysplasia, Silverman-Handmaker type",31173,1,41,18,10,8,30,4,26,0.24390243902439024,0.0975609756097561,0.5555555555555556,0.24390243902439024,0.13333333333333333,0.0975609756097561
Schimke immuno-osseous dysplasia,38670,4,73,29,3,26,30,3,27,0.0410958904109589,0.0410958904109589,0.10344827586206896,0.0410958904109589,0.1,0.0410958904109589
Spondyloepiphyseal dysplasia tarda,31270,0,54,29,1,28,23,3,20,0.018518518518518517,0.05555555555555555,0.034482758620689655,0.018518518518518517,0.13043478260869565,0.05555555555555555
"Brachydactylous dwarfism, Mseleni type",29239,1,19,17,3,14,31,2,29,0.15789473684210525,0.10526315789473684,0.17647058823529413,0.15789473684210525,0.06451612903225806,0.10526315789473684
Parenteral nutrition-associated cholestasis,38577,18,22,21,4,17,26,4,22,0.18181818181818182,0.18181818181818182,0.19047619047619047,0.18181818181818182,0.15384615384615385,0.18181818181818182
Dihydropyrimidine dehydrogenase deficiency,31257,0,55,16,3,13,18,0,18,0.05454545454545454,0.0,0.1875,0.05454545454545454,0.0,0.0
Alternating hemiplegia of childhood,39246,15,65,20,4,16,31,7,24,0.06153846153846154,0.1076923076923077,0.2,0.06153846153846154,0.22580645161290322,0.1076923076923077
Bronchogenic cyst,94624,11,33,15,7,8,23,9,14,0.21212121212121213,0.2727272727272727,0.4666666666666667,0.21212121212121213,0.391304347826087,0.2727272727272727
Congenital factor XII deficiency,30298,7,9,29,4,25,18,1,17,0.4444444444444444,0.1111111111111111,0.13793103448275862,0.4444444444444444,0.05555555555555555,0.1111111111111111
"Spondyloepimetaphyseal dysplasia, Missouri type",38339,2,12,32,1,31,33,0,33,0.08333333333333333,0.0,0.03125,0.08333333333333333,0.0,0.0
"Spondyloepimetaphyseal dysplasia, Shohat type",38339,17,33,28,5,23,42,5,37,0.15151515151515152,0.15151515151515152,0.17857142857142858,0.15151515151515152,0.11904761904761904,0.15151515151515152
Fatal infantile lactic acidosis with methylmalonic aciduria,27243,9,64,49,15,34,33,8,25,0.234375,0.125,0.30612244897959184,0.234375,0.24242424242424243,0.125
Chronic beryllium disease,83795,15,19,23,5,18,17,6,11,0.2631578947368421,0.3157894736842105,0.21739130434782608,0.2631578947368421,0.35294117647058826,0.3157894736842105
Hydrops fetalis,33587,11,24,20,3,17,26,2,24,0.125,0.08333333333333333,0.15,0.125,0.07692307692307693,0.08333333333333333
Progressive deafness with stapes fixation,31891,8,2,24,2,22,20,0,20,1.0,0.0,0.08333333333333333,1.0,0.0,0.0
Common arterial trunk,28716,0,36,32,4,28,31,3,28,0.1111111111111111,0.08333333333333333,0.125,0.1111111111111111,0.0967741935483871,0.08333333333333333
Atrial standstill,28629,3,32,10,8,2,26,5,21,0.25,0.15625,0.8,0.25,0.19230769230769232,0.15625
"Spondyloepimetaphyseal dysplasia with joint laxity, leptodactylic type",31270,6,41,23,4,19,31,8,23,0.0975609756097561,0.1951219512195122,0.17391304347826086,0.0975609756097561,0.25806451612903225,0.1951219512195122
Neurogenic arthrogryposis multiplex congenita,31166,1,33,17,5,12,30,3,27,0.15151515151515152,0.09090909090909091,0.29411764705882354,0.15151515151515152,0.1,0.09090909090909091
Saccharopinuria,28325,2,19,22,5,17,29,0,29,0.2631578947368421,0.0,0.22727272727272727,0.2631578947368421,0.0,0.0
D-glyceric aciduria,30677,1,26,16,6,10,30,1,29,0.23076923076923078,0.038461538461538464,0.375,0.23076923076923078,0.03333333333333333,0.038461538461538464
Congenital microcoria,28258,14,18,24,5,19,43,6,37,0.2777777777777778,0.3333333333333333,0.20833333333333334,0.2777777777777778,0.13953488372093023,0.3333333333333333
Essential fructosuria,29513,8,6,17,2,15,20,0,20,0.3333333333333333,0.0,0.11764705882352941,0.3333333333333333,0.0,0.0
Hyperlysinemia,29302,3,57,18,6,12,28,2,26,0.10526315789473684,0.03508771929824561,0.3333333333333333,0.10526315789473684,0.07142857142857142,0.03508771929824561
Infantile-onset X-linked spinal muscular atrophy,30356,1,37,36,11,25,34,2,32,0.2972972972972973,0.05405405405405406,0.3055555555555556,0.2972972972972973,0.058823529411764705,0.05405405405405406
Multiple epiphyseal dysplasia type 4,28099,0,58,121,26,95,10,0,10,0.4482758620689655,0.0,0.21487603305785125,0.4482758620689655,0.0,0.0
"Spondylometaphyseal dysplasia, Kozlowski type",31451,1,45,28,13,15,36,5,31,0.28888888888888886,0.1111111111111111,0.4642857142857143,0.28888888888888886,0.1388888888888889,0.1111111111111111
Spondylometaphyseal dysplasia-cone-rod dystrophy syndrome,27381,1,39,37,14,23,37,3,34,0.358974358974359,0.07692307692307693,0.3783783783783784,0.358974358974359,0.08108108108108109,0.07692307692307693
Fixed subaortic stenosis,38779,11,28,19,7,12,15,6,9,0.25,0.21428571428571427,0.3684210526315789,0.25,0.4,0.21428571428571427
Aortic arch interruption,94903,10,32,27,5,22,28,2,26,0.15625,0.0625,0.18518518518518517,0.15625,0.07142857142857142,0.0625
Isolated right ventricular hypoplasia,29542,14,19,16,3,13,23,5,18,0.15789473684210525,0.2631578947368421,0.1875,0.15789473684210525,0.21739130434782608,0.2631578947368421
Coronary arterial fistula,98070,14,27,23,6,17,24,6,18,0.2222222222222222,0.2222222222222222,0.2608695652173913,0.2222222222222222,0.25,0.2222222222222222
Cardiac diverticulum,33710,4,42,19,5,14,20,3,17,0.11904761904761904,0.07142857142857142,0.2631578947368421,0.11904761904761904,0.15,0.07142857142857142
Hemoglobin E disease,94921,2,13,23,2,21,23,4,19,0.15384615384615385,0.3076923076923077,0.08695652173913043,0.15384615384615385,0.17391304347826086,0.3076923076923077
Idiopathic camptocormia,97932,0,33,14,0,14,15,0,15,0.0,0.0,0.0,0.0,0.0,0.0
Hereditary steroid-resistant nephrotic syndrome,38873,17,17,29,4,25,18,3,15,0.23529411764705882,0.17647058823529413,0.13793103448275862,0.23529411764705882,0.16666666666666666,0.17647058823529413
Congenitally uncorrected transposition of the great arteries,38925,7,33,23,3,20,26,2,24,0.09090909090909091,0.06060606060606061,0.13043478260869565,0.09090909090909091,0.07692307692307693,0.06060606060606061
Porokeratosis plantaris palmaris et disseminata,30735,8,10,17,4,13,16,4,12,0.4,0.4,0.23529411764705882,0.4,0.25,0.4
Axial spondylometaphyseal dysplasia,38339,7,47,17,0,17,26,4,22,0.0,0.0851063829787234,0.0,0.0,0.15384615384615385,0.0851063829787234
"Spondylometaphyseal dysplasia, Schmidt type",31621,3,30,18,10,8,44,8,36,0.3333333333333333,0.26666666666666666,0.5555555555555556,0.3333333333333333,0.18181818181818182,0.26666666666666666
"Spondylometaphyseal dysplasia, 'corner fracture' type",29065,2,54,24,5,19,39,7,32,0.09259259259259259,0.12962962962962962,0.20833333333333334,0.09259259259259259,0.1794871794871795,0.12962962962962962
Marburg hemorrhagic fever,32353,6,74,17,13,4,24,16,8,0.17567567567567569,0.21621621621621623,0.7647058823529411,0.17567567567567569,0.6666666666666666,0.21621621621621623
Familial exudative vitreoretinopathy,33668,8,27,17,3,14,27,4,23,0.1111111111111111,0.14814814814814814,0.17647058823529413,0.1111111111111111,0.14814814814814814,0.14814814814814814
Punctate palmoplantar keratoderma type 1,30262,14,25,16,4,12,16,4,12,0.16,0.16,0.25,0.16,0.25,0.16
Idiopathic chronic eosinophilic pneumonia,33206,9,27,17,6,11,19,4,15,0.2222222222222222,0.14814814814814814,0.35294117647058826,0.2222222222222222,0.21052631578947367,0.14814814814814814
Microlissencephaly,38724,13,22,28,4,24,37,3,34,0.18181818181818182,0.13636363636363635,0.14285714285714285,0.18181818181818182,0.08108108108108109,0.13636363636363635
Arachnoid cyst,38459,13,67,20,5,15,29,6,23,0.07462686567164178,0.08955223880597014,0.25,0.07462686567164178,0.20689655172413793,0.08955223880597014
Eales disease,98513,16,30,30,4,26,25,2,23,0.13333333333333333,0.06666666666666667,0.13333333333333333,0.13333333333333333,0.08,0.06666666666666667
Crimean-Congo hemorrhagic fever,32347,8,78,15,10,5,29,12,17,0.1282051282051282,0.15384615384615385,0.6666666666666666,0.1282051282051282,0.41379310344827586,0.15384615384615385
Hereditary sensory and autonomic neuropathy type 1,27625,3,29,33,5,28,27,4,23,0.1724137931034483,0.13793103448275862,0.15151515151515152,0.1724137931034483,0.14814814814814814,0.13793103448275862
Andersen-Tawil syndrome,30353,0,51,43,26,17,29,1,28,0.5098039215686274,0.0196078431372549,0.6046511627906976,0.5098039215686274,0.034482758620689655,0.0196078431372549
Glutaric acidemia type 3,29395,15,13,29,1,28,33,0,33,0.07692307692307693,0.0,0.034482758620689655,0.07692307692307693,0.0,0.0
Imerslund-Gräsbeck syndrome,27327,7,30,24,4,20,24,2,22,0.13333333333333333,0.06666666666666667,0.16666666666666666,0.13333333333333333,0.08333333333333333,0.06666666666666667
Familial idiopathic dilatation of the right atrium,98017,14,24,23,8,15,21,6,15,0.3333333333333333,0.25,0.34782608695652173,0.3333333333333333,0.2857142857142857,0.25
Urachal cyst,94604,8,16,19,3,16,13,3,10,0.1875,0.1875,0.15789473684210525,0.1875,0.23076923076923078,0.1875
Yellow fever,32350,5,47,16,8,8,24,8,16,0.1702127659574468,0.1702127659574468,0.5,0.1702127659574468,0.3333333333333333,0.1702127659574468
Bietti crystalline dystrophy,29132,2,19,20,5,15,29,2,27,0.2631578947368421,0.10526315789473684,0.25,0.2631578947368421,0.06896551724137931,0.10526315789473684
Formiminoglutamic aciduria,29436,5,13,25,1,24,20,3,17,0.07692307692307693,0.23076923076923078,0.04,0.07692307692307693,0.15,0.23076923076923078
Postinfectious vasculitis,98608,10,57,15,4,11,32,7,25,0.07017543859649122,0.12280701754385964,0.26666666666666666,0.07017543859649122,0.21875,0.12280701754385964
Hereditary geniospasm,29238,11,7,22,1,21,20,0,20,0.14285714285714285,0.0,0.045454545454545456,0.14285714285714285,0.0,0.0
Schilder disease,95018,1,19,29,1,28,31,3,28,0.05263157894736842,0.15789473684210525,0.034482758620689655,0.05263157894736842,0.0967741935483871,0.15789473684210525
Sorsby pseudoinflammatory fundus dystrophy,29952,8,17,20,2,18,23,1,22,0.11764705882352941,0.058823529411764705,0.1,0.11764705882352941,0.043478260869565216,0.058823529411764705
Iridocorneal endothelial syndrome,39584,18,16,23,3,20,24,3,21,0.1875,0.1875,0.13043478260869565,0.1875,0.125,0.1875
Pulmonary alveolar microlithiasis,31555,9,43,21,13,8,22,11,11,0.3023255813953488,0.2558139534883721,0.6190476190476191,0.3023255813953488,0.5,0.2558139534883721
MPI-CDG,28759,0,22,17,8,9,39,2,37,0.36363636363636365,0.09090909090909091,0.47058823529411764,0.36363636363636365,0.05128205128205128,0.09090909090909091
Rift valley fever,32954,4,44,17,4,13,29,6,23,0.09090909090909091,0.13636363636363635,0.23529411764705882,0.09090909090909091,0.20689655172413793,0.13636363636363635
ALG12-CDG,30614,0,93,17,10,7,22,1,21,0.10752688172043011,0.010752688172043012,0.5882352941176471,0.10752688172043011,0.045454545454545456,0.010752688172043012
ALG6-CDG,31949,8,35,22,3,19,28,2,26,0.08571428571428572,0.05714285714285714,0.13636363636363635,0.08571428571428572,0.07142857142857142,0.05714285714285714
IgG4-related thyroid disease,98622,10,25,17,6,11,20,1,19,0.24,0.04,0.35294117647058826,0.24,0.05,0.04
Hepatoportal sclerosis,98621,15,30,26,4,22,19,7,12,0.13333333333333333,0.23333333333333334,0.15384615384615385,0.13333333333333333,0.3684210526315789,0.23333333333333334
Vaginal atresia,94553,3,12,13,0,13,12,0,12,0.0,0.0,0.0,0.0,0.0,0.0
Late-onset retinal degeneration,31421,5,22,20,2,18,26,2,24,0.09090909090909091,0.09090909090909091,0.1,0.09090909090909091,0.07692307692307693,0.09090909090909091
Familial renal glucosuria,30252,6,13,22,3,19,22,2,20,0.23076923076923078,0.15384615384615385,0.13636363636363635,0.23076923076923078,0.09090909090909091,0.15384615384615385
Low phospholipid-associated cholelithiasis,31501,5,19,18,7,11,19,4,15,0.3684210526315789,0.21052631578947367,0.3888888888888889,0.3684210526315789,0.21052631578947367,0.21052631578947367
Warty dyskeratoma,98626,2,19,20,3,17,8,2,6,0.15789473684210525,0.10526315789473684,0.15,0.15789473684210525,0.25,0.10526315789473684
"Congenital lactic acidosis, Saguenay-Lac-Saint-Jean type",28087,5,45,17,8,9,20,4,16,0.17777777777777778,0.08888888888888889,0.47058823529411764,0.17777777777777778,0.2,0.08888888888888889
Rh deficiency syndrome,28631,5,20,21,7,14,22,2,20,0.35,0.1,0.3333333333333333,0.35,0.09090909090909091,0.1
ALG2-CDG,31949,7,25,20,7,13,27,1,26,0.28,0.04,0.35,0.28,0.037037037037037035,0.04
ALG1-CDG,31949,7,33,18,4,14,25,2,23,0.12121212121212122,0.06060606060606061,0.2222222222222222,0.12121212121212122,0.08,0.06060606060606061
ALG9-CDG,31949,6,86,21,4,17,21,1,20,0.046511627906976744,0.011627906976744186,0.19047619047619047,0.046511627906976744,0.047619047619047616,0.011627906976744186
MGAT2-CDG,30985,0,57,18,6,12,27,0,27,0.10526315789473684,0.0,0.3333333333333333,0.10526315789473684,0.0,0.0
Familial drusen,31699,9,20,28,4,24,41,1,40,0.2,0.05,0.14285714285714285,0.2,0.024390243902439025,0.05
Angioosteohypotrophic syndrome,98631,14,21,38,2,36,38,3,35,0.09523809523809523,0.14285714285714285,0.05263157894736842,0.09523809523809523,0.07894736842105263,0.14285714285714285
Loeffler endocarditis,95004,17,27,28,7,21,32,8,24,0.25925925925925924,0.2962962962962963,0.25,0.25925925925925924,0.25,0.2962962962962963
MORM syndrome,28252,2,18,17,6,11,17,0,17,0.3333333333333333,0.0,0.35294117647058826,0.3333333333333333,0.0,0.0
Morgagni-Stewart-Morel syndrome,31919,0,30,35,4,31,17,0,17,0.13333333333333333,0.0,0.11428571428571428,0.13333333333333333,0.0,0.0
DPAGT1-CDG,31900,1,69,16,6,10,21,3,18,0.08695652173913043,0.043478260869565216,0.375,0.08695652173913043,0.14285714285714285,0.043478260869565216
MOGS-CDG,27895,1,44,16,8,8,34,0,34,0.18181818181818182,0.0,0.5,0.18181818181818182,0.0,0.0
Foix-Alajouanine syndrome,31536,0,33,17,0,17,10,0,10,0.0,0.0,0.0,0.0,0.0,0.0
IgG4-related dacryoadenitis and sialadenitis,98632,8,33,20,8,12,10,6,4,0.24242424242424243,0.18181818181818182,0.4,0.24242424242424243,0.6,0.18181818181818182
Folinic acid-responsive seizures,94786,9,38,29,4,25,28,5,23,0.10526315789473684,0.13157894736842105,0.13793103448275862,0.10526315789473684,0.17857142857142858,0.13157894736842105
DPM1-CDG,28471,1,59,16,2,14,16,0,16,0.03389830508474576,0.0,0.125,0.03389830508474576,0.0,0.0
Paroxysmal nocturnal hemoglobinuria,27950,7,44,17,6,11,25,8,17,0.13636363636363635,0.18181818181818182,0.35294117647058826,0.13636363636363635,0.32,0.18181818181818182
Multiple osteochondromas,32248,3,56,29,9,20,30,7,23,0.16071428571428573,0.125,0.3103448275862069,0.16071428571428573,0.23333333333333334,0.125
Lymphoid interstitial pneumonia,28002,12,34,23,7,16,25,6,19,0.20588235294117646,0.17647058823529413,0.30434782608695654,0.20588235294117646,0.24,0.17647058823529413
Respiratory bronchiolitis-interstitial lung disease syndrome,98635,13,22,16,8,8,18,6,12,0.36363636363636365,0.2727272727272727,0.5,0.36363636363636365,0.3333333333333333,0.2727272727272727
Hyperprolinemia type 2,28903,1,51,16,8,8,24,4,20,0.1568627450980392,0.0784313725490196,0.5,0.1568627450980392,0.16666666666666666,0.0784313725490196
Atrophoderma vermiculata,30218,9,17,22,0,22,33,5,28,0.0,0.29411764705882354,0.0,0.0,0.15151515151515152,0.29411764705882354
MPDU1-CDG,29713,0,26,17,4,13,29,1,28,0.15384615384615385,0.038461538461538464,0.23529411764705882,0.15384615384615385,0.034482758620689655,0.038461538461538464
Idiopathic trachyonychia,38902,11,17,13,4,9,13,4,9,0.23529411764705882,0.23529411764705882,0.3076923076923077,0.23529411764705882,0.3076923076923077,0.23529411764705882
Dowling-Degos disease,27573,3,25,15,7,8,16,4,12,0.28,0.16,0.4666666666666667,0.28,0.25,0.16
Bickerstaff brainstem encephalitis,95013,13,47,21,4,17,24,5,19,0.0851063829787234,0.10638297872340426,0.19047619047619047,0.0851063829787234,0.20833333333333334,0.10638297872340426
COG7-CDG,28972,1,33,43,12,31,19,0,19,0.36363636363636365,0.0,0.27906976744186046,0.36363636363636365,0.0,0.0
Glycogen storage disease due to liver and muscle phosphorylase kinase deficiency,32211,2,43,17,8,9,26,5,21,0.18604651162790697,0.11627906976744186,0.47058823529411764,0.18604651162790697,0.19230769230769232,0.11627906976744186
DK1-CDG,27334,0,32,17,4,13,28,5,23,0.125,0.15625,0.23529411764705882,0.125,0.17857142857142858,0.15625
T-cell immunodeficiency with thymic aplasia,38584,6,36,18,1,17,20,7,13,0.027777777777777776,0.19444444444444445,0.05555555555555555,0.027777777777777776,0.35,0.19444444444444445
Senior-Boichis syndrome,39040,9,34,34,1,33,39,0,39,0.029411764705882353,0.0,0.029411764705882353,0.029411764705882353,0.0,0.0
Autosomal recessive hyperinsulinism due to Kir6.2 deficiency,98643,20,20,30,4,26,28,3,25,0.2,0.15,0.13333333333333333,0.2,0.10714285714285714,0.15
Florid cemento-osseous dysplasia,98647,8,23,22,2,20,31,4,27,0.08695652173913043,0.17391304347826086,0.09090909090909091,0.08695652173913043,0.12903225806451613,0.17391304347826086
ATTRV122I amyloidosis,33159,4,25,17,0,17,21,1,20,0.0,0.04,0.0,0.0,0.047619047619047616,0.04
Osteopetrosis with renal tubular acidosis,31011,7,60,19,3,16,22,6,16,0.05,0.1,0.15789473684210525,0.05,0.2727272727272727,0.1
"Metaphyseal dysplasia, Braun-Tinschert type",97797,8,31,48,3,45,20,2,18,0.0967741935483871,0.06451612903225806,0.0625,0.0967741935483871,0.1,0.06451612903225806
Hereditary amyloidosis with primary renal involvement,98538,16,43,23,9,14,25,7,18,0.20930232558139536,0.16279069767441862,0.391304347826087,0.20930232558139536,0.28,0.16279069767441862
Hypotrichosis simplex of the scalp,38321,9,21,21,6,15,25,2,23,0.2857142857142857,0.09523809523809523,0.2857142857142857,0.2857142857142857,0.08,0.09523809523809523
Pycnodysostosis,29524,1,66,20,7,13,28,3,25,0.10606060606060606,0.045454545454545456,0.35,0.10606060606060606,0.10714285714285714,0.045454545454545456
Hemoglobin D disease,94922,6,14,29,6,23,28,4,24,0.42857142857142855,0.2857142857142857,0.20689655172413793,0.42857142857142855,0.14285714285714285,0.2857142857142857
Congenital tracheomalacia,33607,8,45,18,9,9,22,10,12,0.2,0.2222222222222222,0.5,0.2,0.45454545454545453,0.2222222222222222
Dural sinus malformation,98780,0,48,2,0,2,23,7,16,0.0,0.14583333333333334,0.0,0.0,0.30434782608695654,0.14583333333333334
Charcot-Marie-Tooth disease type 2B1,27530,7,33,34,12,22,25,5,20,0.36363636363636365,0.15151515151515152,0.35294117647058826,0.36363636363636365,0.2,0.15151515151515152
Granular corneal dystrophy type I,31074,11,10,26,6,20,20,3,17,0.6,0.3,0.23076923076923078,0.6,0.15,0.3
X-linked dominant chondrodysplasia punctata,27823,1,46,43,5,38,37,2,35,0.10869565217391304,0.043478260869565216,0.11627906976744186,0.10869565217391304,0.05405405405405406,0.043478260869565216
X-linked centronuclear myopathy,30705,2,24,18,0,18,30,0,30,0.0,0.0,0.0,0.0,0.0,0.0
Ulerythema ophryogenesis,33383,0,14,17,1,16,14,0,14,0.07142857142857142,0.0,0.058823529411764705,0.07142857142857142,0.0,0.0
Blue diaper syndrome,28399,2,12,15,2,13,36,2,34,0.16666666666666666,0.16666666666666666,0.13333333333333333,0.16666666666666666,0.05555555555555555,0.16666666666666666
Persistent hyperplastic primary vitreous,31357,5,24,20,14,6,26,8,18,0.5833333333333334,0.3333333333333333,0.7,0.5833333333333334,0.3076923076923077,0.3333333333333333
Renal dysplasia,39543,9,28,15,2,13,39,9,30,0.07142857142857142,0.32142857142857145,0.13333333333333333,0.07142857142857142,0.23076923076923078,0.32142857142857145
Isolated osteopoikilosis,32799,1,33,25,4,21,28,7,21,0.12121212121212122,0.21212121212121213,0.16,0.12121212121212122,0.25,0.21212121212121213
Simple cryoglobulinemia,39715,11,55,22,4,18,18,5,13,0.07272727272727272,0.09090909090909091,0.18181818181818182,0.07272727272727272,0.2777777777777778,0.09090909090909091
Chronic pneumonitis of infancy,98690,15,13,18,7,11,23,8,15,0.5384615384615384,0.6153846153846154,0.3888888888888889,0.5384615384615384,0.34782608695652173,0.6153846153846154
Marcus-Gunn syndrome,98803,11,21,13,0,13,33,0,33,0.0,0.0,0.0,0.0,0.0,0.0
Apolipoprotein A-I deficiency,33460,5,9,23,4,19,24,3,21,0.4444444444444444,0.3333333333333333,0.17391304347826086,0.4444444444444444,0.125,0.3333333333333333
Renin-angiotensin-aldosterone system-blocker-induced angioedema,83772,17,13,25,2,23,33,3,30,0.15384615384615385,0.23076923076923078,0.08,0.15384615384615385,0.09090909090909091,0.23076923076923078
Idiopathic pulmonary hemosiderosis,29605,11,29,20,7,13,18,5,13,0.2413793103448276,0.1724137931034483,0.35,0.2413793103448276,0.2777777777777778,0.1724137931034483
Genetic recurrent myoglobinuria,32122,7,32,19,6,13,28,4,24,0.1875,0.125,0.3157894736842105,0.1875,0.14285714285714285,0.125
Charcot-Marie-Tooth disease type 4B2,27530,3,40,28,7,21,18,5,13,0.175,0.125,0.25,0.175,0.2777777777777778,0.125
Charcot-Marie-Tooth disease type 4A,27530,6,40,27,5,22,20,1,19,0.125,0.025,0.18518518518518517,0.125,0.05,0.025
Fuchs endothelial corneal dystrophy,28626,4,9,13,7,6,20,5,15,0.7777777777777778,0.5555555555555556,0.5384615384615384,0.7777777777777778,0.25,0.5555555555555556
Metaphyseal chondromatosis with D-2-hydroxyglutaric aciduria,94942,17,71,28,5,23,28,4,24,0.07042253521126761,0.056338028169014086,0.17857142857142858,0.07042253521126761,0.14285714285714285,0.056338028169014086
Congenital Gerbode defect,98836,5,28,8,0,8,6,0,6,0.0,0.0,0.0,0.0,0.0,0.0
Cushing disease,28977,2,64,16,3,13,25,11,14,0.046875,0.171875,0.1875,0.046875,0.44,0.171875
Granular corneal dystrophy type II,31074,13,9,25,6,19,19,2,17,0.6666666666666666,0.2222222222222222,0.24,0.6666666666666666,0.10526315789473684,0.2222222222222222
Cushing syndrome due to bilateral macronodular adrenocortical disease,33101,6,39,19,7,12,29,10,19,0.1794871794871795,0.2564102564102564,0.3684210526315789,0.1794871794871795,0.3448275862068966,0.2564102564102564
Craniofaciofrontodigital syndrome,28512,1,69,18,5,13,43,1,42,0.07246376811594203,0.014492753623188406,0.2777777777777778,0.07246376811594203,0.023255813953488372,0.014492753623188406
Isolated congenital hypoglossia/aglossia,39017,1,16,3,0,3,29,4,25,0.0,0.25,0.0,0.0,0.13793103448275862,0.25
Diffuse cutaneous mastocytosis,32208,4,31,14,8,6,19,7,12,0.25806451612903225,0.22580645161290322,0.5714285714285714,0.25806451612903225,0.3684210526315789,0.22580645161290322
Proboscis lateralis,97956,5,49,13,1,12,12,1,11,0.02040816326530612,0.02040816326530612,0.07692307692307693,0.02040816326530612,0.08333333333333333,0.02040816326530612
Nasolacrimal duct cyst,97955,13,25,17,3,14,27,7,20,0.12,0.28,0.17647058823529413,0.12,0.25925925925925924,0.28
Cutaneous mastocytoma,98930,4,31,15,2,13,23,6,17,0.06451612903225806,0.1935483870967742,0.13333333333333333,0.06451612903225806,0.2608695652173913,0.1935483870967742
Pemphigus erythematosus,32580,8,14,21,5,16,20,3,17,0.35714285714285715,0.21428571428571427,0.23809523809523808,0.35714285714285715,0.15,0.21428571428571427
Pemphigus foliaceus,32581,6,20,20,7,13,25,5,20,0.35,0.25,0.35,0.35,0.2,0.25
Epilepsy with eyelid myoclonia,99971,8,23,18,1,17,32,1,31,0.043478260869565216,0.043478260869565216,0.05555555555555555,0.043478260869565216,0.03125,0.043478260869565216
Secondary intestinal lymphangiectasia,28962,9,40,22,6,16,21,5,16,0.15,0.125,0.2727272727272727,0.15,0.23809523809523808,0.125
Legius syndrome,38110,0,42,23,1,22,29,0,29,0.023809523809523808,0.0,0.043478260869565216,0.023809523809523808,0.0,0.0
Acute transverse myelitis,97946,18,52,30,11,19,30,10,20,0.21153846153846154,0.19230769230769232,0.36666666666666664,0.21153846153846154,0.3333333333333333,0.19230769230769232
Trehalase deficiency,29215,0,7,16,0,16,16,0,16,0.0,0.0,0.0,0.0,0.0,0.0
Tropical pancreatitis,31493,8,12,17,6,11,20,4,16,0.5,0.3333333333333333,0.35294117647058826,0.5,0.2,0.3333333333333333
Autosomal recessive Charcot-Marie-Tooth disease with hoarseness,27720,2,37,24,7,17,34,3,31,0.1891891891891892,0.08108108108108109,0.2916666666666667,0.1891891891891892,0.08823529411764706,0.08108108108108109
Chronic diarrhea due to glucoamylase deficiency,97919,15,10,20,5,15,20,5,15,0.5,0.5,0.25,0.5,0.25,0.5
Cerebral autosomal recessive arteriopathy-subcortical infarcts-leukoencephalopathy,35890,15,32,24,7,17,32,9,23,0.21875,0.28125,0.2916666666666667,0.21875,0.28125,0.28125
Recurrent infections associated with rare immunoglobulin isotypes deficiency,30569,12,47,20,5,15,26,13,13,0.10638297872340426,0.2765957446808511,0.25,0.10638297872340426,0.5,0.2765957446808511
Short stature-delayed bone age due to thyroid hormone metabolism deficiency,27585,10,18,17,3,14,23,2,21,0.16666666666666666,0.1111111111111111,0.17647058823529413,0.16666666666666666,0.08695652173913043,0.1111111111111111
Congenital vertical talus,27963,8,13,19,4,15,31,2,29,0.3076923076923077,0.15384615384615385,0.21052631578947367,0.3076923076923077,0.06451612903225806,0.15384615384615385
"Dysplasia of head of femur, Meyer type",98019,4,13,8,0,8,22,2,20,0.0,0.15384615384615385,0.0,0.0,0.09090909090909091,0.15384615384615385
Posttransplant acute limbic encephalitis,97999,18,23,25,6,19,24,7,17,0.2608695652173913,0.30434782608695654,0.24,0.2608695652173913,0.2916666666666667,0.30434782608695654
Mal de Meleda,29337,1,13,15,2,13,11,2,9,0.15384615384615385,0.15384615384615385,0.13333333333333333,0.15384615384615385,0.18181818181818182,0.15384615384615385
Epidermolytic palmoplantar keratoderma,28842,4,15,12,4,8,7,2,5,0.26666666666666666,0.13333333333333333,0.3333333333333333,0.26666666666666666,0.2857142857142857,0.13333333333333333
Transgrediens et progrediens palmoplantar keratoderma,30262,8,18,18,3,15,18,4,14,0.16666666666666666,0.2222222222222222,0.16666666666666666,0.16666666666666666,0.2222222222222222,0.2222222222222222
Congenital bile acid synthesis defect type 2,28517,8,27,31,14,17,25,7,18,0.5185185185185185,0.25925925925925924,0.45161290322580644,0.5185185185185185,0.28,0.25925925925925924
Congenital bile acid synthesis defect type 3,28517,7,12,36,7,29,26,5,21,0.5833333333333334,0.4166666666666667,0.19444444444444445,0.5833333333333334,0.19230769230769232,0.4166666666666667
Congenital bile acid synthesis defect type 4,28517,6,27,40,6,34,28,0,28,0.2222222222222222,0.0,0.15,0.2222222222222222,0.0,0.0
Maculopapular cutaneous mastocytosis,32209,5,21,22,7,15,25,4,21,0.3333333333333333,0.19047619047619047,0.3181818181818182,0.3333333333333333,0.16,0.19047619047619047
CNTNAP2-related developmental and epileptic encephalopathy,30986,3,49,19,9,10,26,2,24,0.1836734693877551,0.04081632653061224,0.47368421052631576,0.1836734693877551,0.07692307692307693,0.04081632653061224
Macrophage activation syndrome,95120,11,29,29,6,23,18,5,13,0.20689655172413793,0.1724137931034483,0.20689655172413793,0.20689655172413793,0.2777777777777778,0.1724137931034483
Acquired hemophagocytic lymphohistiocytosis associated with malignant disease,97990,21,39,27,6,21,28,8,20,0.15384615384615385,0.20512820512820512,0.2222222222222222,0.15384615384615385,0.2857142857142857,0.20512820512820512
Subacute inflammatory demyelinating polyneuropathy,27761,2,41,24,8,16,23,5,18,0.1951219512195122,0.12195121951219512,0.3333333333333333,0.1951219512195122,0.21739130434782608,0.12195121951219512
Idiopathic copper-associated cirrhosis,98077,10,6,20,0,20,24,0,24,0.0,0.0,0.0,0.0,0.0,0.0
Phacoanaphylactic uveitis,98078,12,30,18,7,11,18,6,12,0.23333333333333334,0.2,0.3888888888888889,0.23333333333333334,0.3333333333333333,0.2
Solitary rectal ulcer syndrome,98079,10,16,13,5,8,23,10,13,0.3125,0.625,0.38461538461538464,0.3125,0.43478260869565216,0.625
Isolated nail clubbing,30545,10,17,28,3,25,21,3,18,0.17647058823529413,0.17647058823529413,0.10714285714285714,0.17647058823529413,0.14285714285714285,0.17647058823529413
NMDA receptor encephalitis,98931,14,53,26,7,19,28,6,22,0.1320754716981132,0.11320754716981132,0.2692307692307692,0.1320754716981132,0.21428571428571427,0.11320754716981132
Posterior-predominant lissencephaly-broad flat pons and medulla-midline crossing defects syndrome,33583,3,20,17,2,15,37,4,33,0.1,0.2,0.11764705882352941,0.1,0.10810810810810811,0.2
Camptodactyly-arthropathy-coxa-vara-pericarditis syndrome,31821,11,21,24,5,19,34,6,28,0.23809523809523808,0.2857142857142857,0.20833333333333334,0.23809523809523808,0.17647058823529413,0.2857142857142857
Symptomatic form of muscular dystrophy of Duchenne and Becker in female carriers,84273,11,20,25,3,22,19,0,19,0.15,0.0,0.12,0.15,0.0,0.0
Overlap myositis,94778,14,40,19,2,17,25,3,22,0.05,0.075,0.10526315789473684,0.05,0.12,0.075
KID syndrome,35643,0,60,25,0,25,30,0,30,0.0,0.0,0.0,0.0,0.0,0.0
Hidrotic ectodermal dysplasia,32947,0,27,17,4,13,46,2,44,0.14814814814814814,0.07407407407407407,0.23529411764705882,0.14814814814814814,0.043478260869565216,0.07407407407407407
Autosomal dominant palmoplantar keratoderma and congenital alopecia,29558,2,25,22,6,16,23,3,20,0.24,0.12,0.2727272727272727,0.24,0.13043478260869565,0.12
Naegeli-Franceschetti-Jadassohn syndrome,29125,2,30,18,10,8,36,0,36,0.3333333333333333,0.0,0.5555555555555556,0.3333333333333333,0.0,0.0
Keratoderma hereditarium mutilans with ichthyosis,27163,2,18,22,9,13,29,3,26,0.5,0.16666666666666666,0.4090909090909091,0.5,0.10344827586206896,0.16666666666666666
Isolated asymptomatic elevation of creatine phosphokinase,30176,10,3,16,2,14,21,1,20,0.6666666666666666,0.3333333333333333,0.125,0.6666666666666666,0.047619047619047616,0.3333333333333333
Hereditary persistence of fetal hemoglobin-sickle cell disease syndrome,98170,3,13,23,0,23,20,2,18,0.0,0.15384615384615385,0.0,0.0,0.1,0.15384615384615385
1p31p32 microdeletion syndrome,30367,2,18,19,8,11,31,2,29,0.4444444444444444,0.1111111111111111,0.42105263157894735,0.4444444444444444,0.06451612903225806,0.1111111111111111
Leukoencephalopathy with calcifications and cysts,31550,4,27,16,12,4,28,9,19,0.4444444444444444,0.3333333333333333,0.75,0.4444444444444444,0.32142857142857145,0.3333333333333333
Tubulinopathy-associated dysgyria,98588,7,24,27,3,24,22,2,20,0.125,0.08333333333333333,0.1111111111111111,0.125,0.09090909090909091,0.08333333333333333
Lissencephaly due to TUBA1A mutation,31140,1,29,16,11,5,23,2,21,0.3793103448275862,0.06896551724137931,0.6875,0.3793103448275862,0.08695652173913043,0.06896551724137931
Pontocerebellar hypoplasia type 1,27716,4,29,32,7,25,30,6,24,0.2413793103448276,0.20689655172413793,0.21875,0.2413793103448276,0.2,0.20689655172413793
Alexander disease type II,31783,1,20,17,2,15,11,1,10,0.1,0.05,0.11764705882352941,0.1,0.09090909090909091,0.05
Alexander disease type I,31783,1,22,54,11,43,9,1,8,0.5,0.045454545454545456,0.2037037037037037,0.5,0.1111111111111111,0.045454545454545456
PRUNE1-related neurological syndrome,99981,15,33,22,1,21,25,1,24,0.030303030303030304,0.030303030303030304,0.045454545454545456,0.030303030303030304,0.04,0.030303030303030304
Familial atrial fibrillation,27948,1,11,18,4,14,24,4,20,0.36363636363636365,0.36363636363636365,0.2222222222222222,0.36363636363636365,0.16666666666666666,0.36363636363636365
Trichomegaly-retina pigmentary degeneration-dwarfism syndrome,29500,1,22,16,9,7,42,6,36,0.4090909090909091,0.2727272727272727,0.5625,0.4090909090909091,0.14285714285714285,0.2727272727272727
FLNA-related X-linked myxomatous valvular dysplasia,30691,1,24,15,4,11,22,4,18,0.16666666666666666,0.16666666666666666,0.26666666666666666,0.16666666666666666,0.18181818181818182,0.16666666666666666
Terminal osseous dysplasia-pigmentary defects syndrome,28996,2,23,18,4,14,31,0,31,0.17391304347826086,0.0,0.2222222222222222,0.17391304347826086,0.0,0.0
Systemic lupus erythematosus,29182,6,44,16,8,8,25,6,19,0.18181818181818182,0.13636363636363635,0.5,0.18181818181818182,0.24,0.13636363636363635
Congenital limbs-face contractures-hypotonia-developmental delay syndrome,31553,0,50,20,15,5,24,3,21,0.3,0.06,0.75,0.3,0.125,0.06
Autoimmune lymphoproliferative syndrome due to CTLA4 haploinsuffiency,30768,7,31,17,11,6,37,5,32,0.3548387096774194,0.16129032258064516,0.6470588235294118,0.3548387096774194,0.13513513513513514,0.16129032258064516
Toriello-Carey syndrome,30886,0,46,17,11,6,4,0,4,0.2391304347826087,0.0,0.6470588235294118,0.2391304347826087,0.0,0.0
"Renal hypoplasia, bilateral",94999,7,31,23,5,18,14,3,11,0.16129032258064516,0.0967741935483871,0.21739130434782608,0.16129032258064516,0.21428571428571427,0.0967741935483871
Split-foot malformation-mesoaxial polydactyly syndrome,31005,10,13,20,2,18,16,3,13,0.15384615384615385,0.23076923076923078,0.1,0.15384615384615385,0.1875,0.23076923076923078
Congenital-onset Steinert myotonic dystrophy,27540,7,34,30,3,27,38,6,32,0.08823529411764706,0.17647058823529413,0.1,0.08823529411764706,0.15789473684210525,0.17647058823529413
Phakomatosis pigmentokeratotica,32602,2,32,21,1,20,31,0,31,0.03125,0.0,0.047619047619047616,0.03125,0.0,0.0
Pilomatrixoma,30972,6,6,21,0,21,23,0,23,0.0,0.0,0.0,0.0,0.0,0.0
Autosomal recessive myogenic arthrogryposis multiplex congenita,99893,21,30,26,1,25,26,1,25,0.03333333333333333,0.03333333333333333,0.038461538461538464,0.03333333333333333,0.038461538461538464,0.03333333333333333
Woolly hair nevus,94935,10,12,20,0,20,25,0,25,0.0,0.0,0.0,0.0,0.0,0.0
Muscle filaminopathy,27707,1,22,16,4,12,19,0,19,0.18181818181818182,0.0,0.25,0.18181818181818182,0.0,0.0
7q31 microdeletion syndrome,98160,15,50,30,3,27,28,3,25,0.06,0.06,0.1,0.06,0.10714285714285714,0.06
Hypertrophic cardiomyopathy with kidney anomalies due to mitochondrial DNA mutation,98414,17,20,25,0,25,26,0,26,0.0,0.0,0.0,0.0,0.0,0.0
14q11.2 microduplication syndrome,98193,19,24,26,5,21,23,3,20,0.20833333333333334,0.125,0.19230769230769232,0.20833333333333334,0.13043478260869565,0.125
Double outlet left ventricle,33375,4,17,23,3,20,26,3,23,0.17647058823529413,0.17647058823529413,0.13043478260869565,0.17647058823529413,0.11538461538461539,0.17647058823529413
Self-limited neonatal-infantile epilepsy,33100,0,15,16,3,13,25,0,25,0.2,0.0,0.1875,0.2,0.0,0.0
Progressive microcephaly-seizures-cortical blindness-developmental delay syndrome,31022,8,22,21,6,15,27,1,26,0.2727272727272727,0.045454545454545456,0.2857142857142857,0.2727272727272727,0.037037037037037035,0.045454545454545456
DIAPH1-related sensorineural hearing loss-thrombocytopenia syndrome,99884,14,6,19,1,18,34,2,32,0.16666666666666666,0.3333333333333333,0.05263157894736842,0.16666666666666666,0.058823529411764705,0.3333333333333333
CADDS,94691,23,17,30,1,29,28,1,27,0.058823529411764705,0.058823529411764705,0.03333333333333333,0.058823529411764705,0.03571428571428571,0.058823529411764705
Severe neonatal-onset encephalopathy with microcephaly,32106,3,19,18,4,14,29,3,26,0.21052631578947367,0.15789473684210525,0.2222222222222222,0.21052631578947367,0.10344827586206896,0.15789473684210525
STXBP1-related encephalopathy,38791,9,31,21,3,18,21,6,15,0.0967741935483871,0.1935483870967742,0.14285714285714285,0.0967741935483871,0.2857142857142857,0.1935483870967742
Spinocerebellar ataxia with epilepsy,39061,4,28,5,2,3,25,5,20,0.07142857142857142,0.17857142857142858,0.4,0.07142857142857142,0.2,0.17857142857142858
Macrocephaly-intellectual disability-autism syndrome,30203,4,24,21,4,17,24,4,20,0.16666666666666666,0.16666666666666666,0.19047619047619047,0.16666666666666666,0.16666666666666666,0.16666666666666666
Activated PI3K-delta syndrome,39078,16,24,26,4,22,38,4,34,0.16666666666666666,0.16666666666666666,0.15384615384615385,0.16666666666666666,0.10526315789473684,0.16666666666666666
