disease,rag_top_node_id,common_symptoms,total_symptoms,rag_total_symptoms,rag_matches,rag_hallucinations,no_rag_total_symptoms,no_rag_matches,no_rag_hallucinations,rag_accuracy,no_rag_accuracy,rag_precision,rag_recall,no_rag_precision,no_rag_recall
Neurodevelopmental disorder with hypotonia and characteristic brain abnormalities,29640,2,48,19,4,15,34,4,30,0.08333333333333333,0.08333333333333333,0.21052631578947367,0.08333333333333333,0.11764705882352941,0.08333333333333333
Tuberous sclerosis-2,31194,8,16,25,5,20,47,7,40,0.3125,0.4375,0.2,0.3125,0.14893617021276595,0.4375
"Autoinflammatory disease, systemic, with vasculitis",38204,12,42,24,6,18,32,10,22,0.14285714285714285,0.23809523809523808,0.25,0.14285714285714285,0.3125,0.23809523809523808
Multiple congenital anomalies-hypotonia-seizures syndrome 2,30436,0,174,22,14,8,18,3,15,0.08045977011494253,0.017241379310344827,0.6363636363636364,0.08045977011494253,0.16666666666666666,0.017241379310344827
Neurodevelopmental disorder with epilepsy and hemochromatosis,30942,0,45,16,3,13,31,0,31,0.06666666666666667,0.0,0.1875,0.06666666666666667,0.0,0.0
"Amyloidosis, hereditary systemic 6",37798,13,8,32,1,31,29,1,28,0.125,0.125,0.03125,0.125,0.034482758620689655,0.125
Developmental and epileptic encephalopathy 4,28987,1,513,22,24,-2,46,28,18,0.04678362573099415,0.05458089668615984,1.0909090909090908,0.04678362573099415,0.6086956521739131,0.05458089668615984
STAR syndrome,27913,0,27,17,0,17,34,0,34,0.0,0.0,0.0,0.0,0.0,0.0
"Amelogenesis imperfecta, type IA",28782,10,3,24,3,21,16,2,14,1.0,0.6666666666666666,0.125,1.0,0.125,0.6666666666666666
Multiple endocrine neoplasia 1,28426,9,17,46,1,45,34,1,33,0.058823529411764705,0.058823529411764705,0.021739130434782608,0.058823529411764705,0.029411764705882353,0.058823529411764705
"Maple syrup urine disease, type Ib",95137,23,7,31,1,30,31,1,30,0.14285714285714285,0.14285714285714285,0.03225806451612903,0.14285714285714285,0.03225806451612903,0.14285714285714285
Combined oxidative phosphorylation deficiency 59,38594,18,27,28,2,26,26,1,25,0.07407407407407407,0.037037037037037035,0.07142857142857142,0.07407407407407407,0.038461538461538464,0.037037037037037035
"Congenital disorder of glycosylation, type Il",35493,8,29,9,0,9,11,0,11,0.0,0.0,0.0,0.0,0.0,0.0
Developmental and epileptic encephalopathy 113,28987,1,24,25,5,20,33,2,31,0.20833333333333334,0.08333333333333333,0.2,0.20833333333333334,0.06060606060606061,0.08333333333333333
Neurodevelopmental disorder with hypotonia and seizures,29640,3,17,27,4,23,27,1,26,0.23529411764705882,0.058823529411764705,0.14814814814814814,0.23529411764705882,0.037037037037037035,0.058823529411764705
"Short stature, optic nerve atrophy, and Pelger-Huet anomaly",28948,2,107,25,9,16,21,3,18,0.08411214953271028,0.028037383177570093,0.36,0.08411214953271028,0.14285714285714285,0.028037383177570093
Long QT syndrome 14,27326,4,6,18,4,14,28,1,27,0.6666666666666666,0.16666666666666666,0.2222222222222222,0.6666666666666666,0.03571428571428571,0.16666666666666666
Prolonged electroretinal response suppression 1,36185,24,5,32,4,28,40,4,36,0.8,0.8,0.125,0.8,0.1,0.8
Aarskog-Scott syndrome,27534,6,72,65,29,36,60,9,51,0.4027777777777778,0.125,0.4461538461538462,0.4027777777777778,0.15,0.125
"Spherocytosis, type 5",27542,6,6,18,3,15,38,6,32,0.5,1.0,0.16666666666666666,0.5,0.15789473684210525,1.0
Distal renal tubular acidosis 1,31011,6,8,21,2,19,22,2,20,0.25,0.25,0.09523809523809523,0.25,0.09090909090909091,0.25
Distal renal tubular acidosis 4 with hemolytic anemia,30435,6,27,20,12,8,21,2,19,0.4444444444444444,0.07407407407407407,0.6,0.4444444444444444,0.09523809523809523,0.07407407407407407
"Spherocytosis, type 4",27542,5,16,17,3,14,26,5,21,0.1875,0.3125,0.17647058823529413,0.1875,0.19230769230769232,0.3125
Cryohydrocytosis,27992,0,9,35,7,28,30,0,30,0.7777777777777778,0.0,0.2,0.7777777777777778,0.0,0.0
"Amyloidosis, hereditary systemic 5",37798,11,10,31,1,30,28,1,27,0.1,0.1,0.03225806451612903,0.1,0.03571428571428571,0.1
Bardet-Biedl syndrome 4,27886,2,18,17,5,12,25,6,19,0.2777777777777778,0.3333333333333333,0.29411764705882354,0.2777777777777778,0.24,0.3333333333333333
Stankiewicz-Isidor syndrome,31267,2,34,17,15,2,39,5,34,0.4411764705882353,0.14705882352941177,0.8823529411764706,0.4411764705882353,0.1282051282051282,0.14705882352941177
Schinzel-Giedion midface retraction syndrome,30565,1,26,49,7,42,14,1,13,0.2692307692307692,0.038461538461538464,0.14285714285714285,0.2692307692307692,0.07142857142857142,0.038461538461538464
"Microcephaly 3, primary, autosomal recessive",27182,3,5,118,4,114,34,1,33,0.8,0.2,0.03389830508474576,0.8,0.029411764705882353,0.2
"Intellectual developmental disorder, X-linked 112",28041,2,77,17,11,6,17,4,13,0.14285714285714285,0.05194805194805195,0.6470588235294118,0.14285714285714285,0.23529411764705882,0.05194805194805195
Hyperekplexia 1,27484,2,4,17,2,15,27,2,25,0.5,0.5,0.11764705882352941,0.5,0.07407407407407407,0.5
CODAS syndrome,29615,2,27,54,15,39,28,2,26,0.5555555555555556,0.07407407407407407,0.2777777777777778,0.5555555555555556,0.07142857142857142,0.07407407407407407
"Maturity-onset diabetes of the young, type IX",30777,0,8,17,0,17,34,3,31,0.0,0.375,0.0,0.0,0.08823529411764706,0.375
"Intellectual developmental disorder, autosomal dominant 42",99663,19,9,24,0,24,42,1,41,0.0,0.1111111111111111,0.0,0.0,0.023809523809523808,0.1111111111111111
"Neurodevelopmental disorder with hyperkinetic movements, seizures and structural brain abnormalities",31178,6,37,18,2,16,31,0,31,0.05405405405405406,0.0,0.1111111111111111,0.05405405405405406,0.0,0.0
"Bleeding disorder, platelet-type, 15",38300,14,3,19,0,19,26,0,26,0.0,0.0,0.0,0.0,0.0,0.0
"Thrombocytopenia 13, syndromic",38329,8,22,25,4,21,22,3,19,0.18181818181818182,0.13636363636363635,0.16,0.18181818181818182,0.13636363636363635,0.13636363636363635
"Cutis laxa, autosomal recessive, type ID",27841,3,45,24,2,22,22,1,21,0.044444444444444446,0.022222222222222223,0.08333333333333333,0.044444444444444446,0.045454545454545456,0.022222222222222223
"Glaucoma 1, open angle, H",30583,2,4,16,3,13,29,2,27,0.75,0.5,0.1875,0.75,0.06896551724137931,0.5
Optic atrophy 16,39830,15,8,26,4,22,27,4,23,0.5,0.5,0.15384615384615385,0.5,0.14814814814814814,0.5
"Ataxia, early-onset, with oculomotor apraxia and hypoalbuminemia",27817,2,6,20,5,15,12,3,9,0.8333333333333334,0.5,0.25,0.8333333333333334,0.25,0.5
"Immunodeficiency 114, folate-responsive",38628,18,28,30,2,28,47,3,44,0.07142857142857142,0.10714285714285714,0.06666666666666667,0.07142857142857142,0.06382978723404255,0.10714285714285714
Autoinflammation with arthritis and vasculitis,38204,24,30,36,4,32,28,3,25,0.13333333333333333,0.1,0.1111111111111111,0.13333333333333333,0.10714285714285714,0.1
"Arthrogryposis, distal, type 12",99362,15,26,34,2,32,53,1,52,0.07692307692307693,0.038461538461538464,0.058823529411764705,0.07692307692307693,0.018867924528301886,0.038461538461538464
Multiple mitochondrial dysfunctions syndrome 7,38367,26,51,43,2,41,30,1,29,0.0392156862745098,0.0196078431372549,0.046511627906976744,0.0392156862745098,0.03333333333333333,0.0196078431372549
Pseudohypoparathyroidism Ia,27647,4,9,27,5,22,35,7,28,0.5555555555555556,0.7777777777777778,0.18518518518518517,0.5555555555555556,0.2,0.7777777777777778
"Osseous heteroplasia, progressive",29358,2,1,17,0,17,43,0,43,0.0,0.0,0.0,0.0,0.0,0.0
Pseudopseudohypoparathyroidism,27647,6,5,25,2,23,40,3,37,0.4,0.6,0.08,0.4,0.075,0.6
"Arthrogryposis, distal, type 2A (Freeman-Sheldon)",99362,14,19,40,1,39,39,1,38,0.05263157894736842,0.05263157894736842,0.025,0.05263157894736842,0.02564102564102564,0.05263157894736842
"Nephrotic syndrome, type 1",28016,4,7,26,8,18,32,3,29,1.1428571428571428,0.42857142857142855,0.3076923076923077,1.1428571428571428,0.09375,0.42857142857142855
Thrombocytopenia 3,38882,16,9,25,3,22,24,3,21,0.3333333333333333,0.3333333333333333,0.12,0.3333333333333333,0.125,0.3333333333333333
Retinitis pigmentosa 11,38253,21,11,33,3,30,32,4,28,0.2727272727272727,0.36363636363636365,0.09090909090909091,0.2727272727272727,0.125,0.36363636363636365
"GM1-gangliosidosis, type III",27167,5,5,34,0,34,42,0,42,0.0,0.0,0.0,0.0,0.0,0.0
Chediak-Higashi syndrome,33060,1,7,17,1,16,17,0,17,0.14285714285714285,0.0,0.058823529411764705,0.14285714285714285,0.0,0.0
Dyggve-Melchior-Clausen disease,27562,0,27,19,7,12,15,0,15,0.25925925925925924,0.0,0.3684210526315789,0.25925925925925924,0.0,0.0
Cleidocranial dysplasia,28472,5,25,36,5,31,26,1,25,0.2,0.04,0.1388888888888889,0.2,0.038461538461538464,0.04
Galactosemia,39443,17,8,25,2,23,29,2,27,0.25,0.25,0.08,0.25,0.06896551724137931,0.25
"Spinocerebellar ataxia, autosomal recessive 20",27662,3,29,35,6,29,16,4,12,0.20689655172413793,0.13793103448275862,0.17142857142857143,0.20689655172413793,0.25,0.13793103448275862
"Spastic paraplegia 93, autosomal recessive",38455,14,42,19,2,17,39,4,35,0.047619047619047616,0.09523809523809523,0.10526315789473684,0.047619047619047616,0.10256410256410256,0.09523809523809523
"Intellectual developmental disorder with dysmorphic facies, seizures, and distal limb anomalies",31772,5,21,19,1,18,40,1,39,0.047619047619047616,0.047619047619047616,0.05263157894736842,0.047619047619047616,0.025,0.047619047619047616
"Cardiac, facial, and digital anomalies with developmental delay",30082,2,360,21,16,5,33,14,19,0.044444444444444446,0.03888888888888889,0.7619047619047619,0.044444444444444446,0.42424242424242425,0.03888888888888889
"Myasthenic syndrome, congenital, 9, associated with acetylcholine receptor deficiency",28418,14,21,23,3,20,26,4,22,0.14285714285714285,0.19047619047619047,0.13043478260869565,0.14285714285714285,0.15384615384615385,0.19047619047619047
Krabbe disease,33153,3,8,41,2,39,29,1,28,0.25,0.125,0.04878048780487805,0.25,0.034482758620689655,0.125
Ovarian dysgenesis 11,28202,7,8,20,4,16,38,4,34,0.5,0.5,0.2,0.5,0.10526315789473684,0.5
Microphthalmia/coloboma 11,27916,3,16,26,6,20,32,7,25,0.375,0.4375,0.23076923076923078,0.375,0.21875,0.4375
Short QT syndrome 3,28737,9,5,17,3,14,27,1,26,0.6,0.2,0.17647058823529413,0.6,0.037037037037037035,0.2
"Spastic paraplegia 78, autosomal recessive",38455,14,35,20,3,17,27,4,23,0.08571428571428572,0.11428571428571428,0.15,0.08571428571428572,0.14814814814814814,0.11428571428571428
Smith-Kingsmore syndrome,29084,0,10,17,0,17,27,0,27,0.0,0.0,0.0,0.0,0.0,0.0
Treacher Collins syndrome 2,30106,4,12,17,6,11,44,4,40,0.5,0.3333333333333333,0.35294117647058826,0.5,0.09090909090909091,0.3333333333333333
"Immunodeficiency 118, mycobacteriosis",38554,13,7,33,0,33,32,2,30,0.0,0.2857142857142857,0.0,0.0,0.0625,0.2857142857142857
"Immunodeficiency 117, mycobacteriosis, autosomal recessive",38554,3,33,30,1,29,32,3,29,0.030303030303030304,0.09090909090909091,0.03333333333333333,0.030303030303030304,0.09375,0.09090909090909091
"Microcephaly 5, primary, autosomal recessive",27447,2,17,16,2,14,33,5,28,0.11764705882352941,0.29411764705882354,0.125,0.11764705882352941,0.15151515151515152,0.29411764705882354
Noonan syndrome 1,27522,5,45,27,8,19,48,9,39,0.17777777777777778,0.2,0.2962962962962963,0.17777777777777778,0.1875,0.2
Metachondromatosis,31364,3,2,26,2,24,21,0,21,1.0,0.0,0.07692307692307693,1.0,0.0,0.0
LEOPARD syndrome 1,29477,0,36,61,15,46,16,0,16,0.4166666666666667,0.0,0.2459016393442623,0.4166666666666667,0.0,0.0
Immunodeficiency 133 with autoimmunity and autoinflammation,30536,2,32,18,3,15,19,0,19,0.09375,0.0,0.16666666666666666,0.09375,0.0,0.0
"Myopathy, myofibrillar, 3",27762,2,11,17,3,14,15,0,15,0.2727272727272727,0.0,0.17647058823529413,0.2727272727272727,0.0,0.0
Developmental and epileptic encephalopathy 28,28987,0,213,28,18,10,18,1,17,0.08450704225352113,0.004694835680751174,0.6428571428571429,0.08450704225352113,0.05555555555555555,0.004694835680751174
"Osteogenesis imperfecta, type IX",27158,6,24,220,23,197,42,5,37,0.9583333333333334,0.20833333333333334,0.10454545454545454,0.9583333333333334,0.11904761904761904,0.20833333333333334
"Acrofacial dysostosis 1, Nager type",27252,0,41,17,6,11,31,3,28,0.14634146341463414,0.07317073170731707,0.35294117647058826,0.14634146341463414,0.0967741935483871,0.07317073170731707
"Intellectual developmental disorder, autosomal recessive 82",28584,3,13,25,7,18,41,5,36,0.5384615384615384,0.38461538461538464,0.28,0.5384615384615384,0.12195121951219512,0.38461538461538464
"Spastic paraplegia 45, autosomal recessive",38455,13,13,19,1,18,14,1,13,0.07692307692307693,0.07692307692307693,0.05263157894736842,0.07692307692307693,0.07142857142857142,0.07692307692307693
"Congenital myopathy 4B, autosomal recessive",28689,5,18,19,1,18,14,0,14,0.05555555555555555,0.0,0.05263157894736842,0.05555555555555555,0.0,0.0
Retinitis pigmentosa 78,31651,8,10,18,6,12,26,3,23,0.6,0.3,0.3333333333333333,0.6,0.11538461538461539,0.3
Werner syndrome,32590,6,18,80,7,73,35,3,32,0.3888888888888889,0.16666666666666666,0.0875,0.3888888888888889,0.08571428571428572,0.16666666666666666
Brugada syndrome 1,28198,4,5,16,5,11,22,2,20,1.0,0.4,0.3125,1.0,0.09090909090909091,0.4
Smith-Lemli-Opitz syndrome,29631,3,13,35,5,30,35,1,34,0.38461538461538464,0.07692307692307693,0.14285714285714285,0.38461538461538464,0.02857142857142857,0.07692307692307693
"Corneal dystrophy, Fuchs endothelial, 4",28626,4,3,13,2,11,27,1,26,0.6666666666666666,0.3333333333333333,0.15384615384615385,0.6666666666666666,0.037037037037037035,0.3333333333333333
Arrhythmogenic cardiomyopathy with variable ectodermal abnormalities,31422,13,30,24,2,22,24,1,23,0.06666666666666667,0.03333333333333333,0.08333333333333333,0.06666666666666667,0.041666666666666664,0.03333333333333333
DiGeorge syndrome,32130,3,24,17,4,13,31,3,28,0.16666666666666666,0.125,0.23529411764705882,0.16666666666666666,0.0967741935483871,0.125
"Intellectual developmental disorder, autosomal dominant 7",99663,22,34,27,0,27,39,0,39,0.0,0.0,0.0,0.0,0.0,0.0
Legius syndrome,38110,0,2,43,0,43,26,0,26,0.0,0.0,0.0,0.0,0.0,0.0
Spermatogenic failure 96,29823,7,3,15,1,14,24,1,23,0.3333333333333333,0.3333333333333333,0.06666666666666667,0.3333333333333333,0.041666666666666664,0.3333333333333333
Premature ovarian failure 25,28340,3,5,29,3,26,30,1,29,0.6,0.2,0.10344827586206896,0.6,0.03333333333333333,0.2
"Osteogenesis imperfecta, type XI",27158,8,8,222,8,214,33,4,29,1.0,0.5,0.036036036036036036,1.0,0.12121212121212122,0.5
KBG syndrome,27930,0,48,42,14,28,20,0,20,0.2916666666666667,0.0,0.3333333333333333,0.2916666666666667,0.0,0.0
"Ciliary dyskinesia, primary, 52",32022,5,18,18,2,16,45,2,43,0.1111111111111111,0.1111111111111111,0.1111111111111111,0.1111111111111111,0.044444444444444446,0.1111111111111111
"Deafness, autosomal recessive 15",27162,7,1,20,1,19,44,1,43,1.0,1.0,0.05,1.0,0.022727272727272728,1.0
"Microcephaly, short stature, and polymicrogyria with seizures",31034,5,18,105,12,93,25,5,20,0.6666666666666666,0.2777777777777778,0.11428571428571428,0.6666666666666666,0.2,0.2777777777777778
"Ehlers-Danlos syndrome, classic type, 2",32436,0,9,31,0,31,31,2,29,0.0,0.2222222222222222,0.0,0.0,0.06451612903225806,0.2222222222222222
"Congenital myopathy 2A, typical, autosomal dominant",28689,7,7,24,1,23,12,0,12,0.14285714285714285,0.0,0.041666666666666664,0.14285714285714285,0.0,0.0
Auroneurodental syndrome,28752,3,27,25,0,25,40,0,40,0.0,0.0,0.0,0.0,0.0,0.0
Immunodeficiency 119,38553,2,12,31,1,30,31,5,26,0.08333333333333333,0.4166666666666667,0.03225806451612903,0.08333333333333333,0.16129032258064516,0.4166666666666667
"Ehlers-Danlos syndrome, classic type, 1",32436,0,9,44,0,44,29,2,27,0.0,0.2222222222222222,0.0,0.0,0.06896551724137931,0.2222222222222222
Tietz albinism-deafness syndrome,29062,6,6,18,6,12,43,1,42,1.0,0.16666666666666666,0.3333333333333333,1.0,0.023255813953488372,0.16666666666666666
Loeys-Dietz syndrome 5,31164,5,73,30,11,19,37,8,29,0.1506849315068493,0.1095890410958904,0.36666666666666664,0.1506849315068493,0.21621621621621623,0.1095890410958904
Glass syndrome,99458,8,11,37,1,36,23,0,23,0.09090909090909091,0.0,0.02702702702702703,0.09090909090909091,0.0,0.0
Inosine triphosphatase deficiency,94957,19,2,40,0,40,40,0,40,0.0,0.0,0.0,0.0,0.0,0.0
"Ehlers-Danlos syndrome, classic-like, 2",94824,21,49,32,2,30,26,2,24,0.04081632653061224,0.04081632653061224,0.0625,0.04081632653061224,0.07692307692307693,0.04081632653061224
Kabuki syndrome 2,31000,4,87,23,8,15,47,14,33,0.09195402298850575,0.16091954022988506,0.34782608695652173,0.09195402298850575,0.2978723404255319,0.16091954022988506
Holoprosencephaly 5,28672,3,12,51,2,49,51,2,49,0.16666666666666666,0.16666666666666666,0.0392156862745098,0.16666666666666666,0.0392156862745098,0.16666666666666666
"Cardiomyopathy, familial hypertrophic, 30, atrial",31422,11,7,26,2,24,19,2,17,0.2857142857142857,0.2857142857142857,0.07692307692307693,0.2857142857142857,0.10526315789473684,0.2857142857142857
"Maple syrup urine disease, type II",95137,24,3,35,1,34,33,1,32,0.3333333333333333,0.3333333333333333,0.02857142857142857,0.3333333333333333,0.030303030303030304,0.3333333333333333
Prolonged electroretinal response suppression 2,36185,15,4,27,3,24,21,2,19,0.75,0.5,0.1111111111111111,0.75,0.09523809523809523,0.5
Skraban-Deardorff syndrome,31112,0,47,38,13,25,16,0,16,0.2765957446808511,0.0,0.34210526315789475,0.2765957446808511,0.0,0.0
Immunodeficiency 115 with autoinflammation,30536,2,29,19,2,17,32,0,32,0.06896551724137931,0.0,0.10526315789473684,0.06896551724137931,0.0,0.0
Al Kaissi syndrome,28671,1,46,43,34,9,61,2,59,0.7391304347826086,0.043478260869565216,0.7906976744186046,0.7391304347826086,0.03278688524590164,0.043478260869565216
"Acromesomelic dysplasia 1, Maroteaux type",99045,22,9,38,1,37,64,2,62,0.1111111111111111,0.2222222222222222,0.02631578947368421,0.1111111111111111,0.03125,0.2222222222222222
"Ehlers-Danlos syndrome, vascular type",94823,27,15,43,2,41,39,2,37,0.13333333333333333,0.13333333333333333,0.046511627906976744,0.13333333333333333,0.05128205128205128,0.13333333333333333
Polymicrogyria with or without vascular-type EDS,27528,10,26,40,5,35,31,0,31,0.19230769230769232,0.0,0.125,0.19230769230769232,0.0,0.0
Intellectual developmental disorder with dysmorphic facies and ptosis,29158,1,26,24,15,9,25,3,22,0.5769230769230769,0.11538461538461539,0.625,0.5769230769230769,0.12,0.11538461538461539
Macular dystrophy with or without cone dysfunction,30662,11,7,21,3,18,19,1,18,0.42857142857142855,0.14285714285714285,0.14285714285714285,0.42857142857142855,0.05263157894736842,0.14285714285714285
Intellectual developmental disorder with autism and macrocephaly,31672,3,79,19,9,10,35,7,28,0.11392405063291139,0.08860759493670886,0.47368421052631576,0.11392405063291139,0.2,0.08860759493670886
"Progressive external ophthalmoplegia with mitochondrial DNA deletions, autosomal recessive 6",27215,5,22,101,13,88,31,4,27,0.5909090909090909,0.18181818181818182,0.12871287128712872,0.5909090909090909,0.12903225806451613,0.18181818181818182
"Spermatogenic failure, X-linked, 8, susceptibility to",29784,4,5,8,1,7,53,3,50,0.2,0.6,0.125,0.2,0.05660377358490566,0.6
"Palmoplantar keratoderma, epidermolytic, 1",30262,3,3,7,2,5,3,2,1,0.6666666666666666,0.6666666666666666,0.2857142857142857,0.6666666666666666,0.6666666666666666,0.6666666666666666
Mucolipidosis III alpha/beta,27333,0,22,19,3,16,25,0,25,0.13636363636363635,0.0,0.15789473684210525,0.13636363636363635,0.0,0.0
"Neurodevelopmental disorder with hypotonia and speech delay, with or without seizures",29588,2,74,18,7,11,22,3,19,0.0945945945945946,0.04054054054054054,0.3888888888888889,0.0945945945945946,0.13636363636363635,0.04054054054054054
"Deafness, autosomal recessive 124",27162,11,1,24,1,23,40,1,39,1.0,1.0,0.041666666666666664,1.0,0.025,1.0
"Osteogenesis imperfecta, type XV",27158,8,8,221,8,213,35,3,32,1.0,0.375,0.03619909502262444,1.0,0.08571428571428572,0.375
Intellectual developmental disorder with dysmorphic facies and behavioral abnormalities,31805,3,126,18,13,5,22,7,15,0.10317460317460317,0.05555555555555555,0.7222222222222222,0.10317460317460317,0.3181818181818182,0.05555555555555555
Alpha-thalassemia/impaired intellectual development syndrome,27529,6,12,44,1,43,47,1,46,0.08333333333333333,0.08333333333333333,0.022727272727272728,0.08333333333333333,0.02127659574468085,0.08333333333333333
Autoinflammation with episodic fever and immune dysregulation,38204,10,12,37,1,36,31,2,29,0.08333333333333333,0.16666666666666666,0.02702702702702703,0.08333333333333333,0.06451612903225806,0.16666666666666666
Ullrich congenital muscular dystrophy 1B,27258,4,35,62,29,33,36,7,29,0.8285714285714286,0.2,0.46774193548387094,0.8285714285714286,0.19444444444444445,0.2
"Neurofibromatosis, type 1",27275,2,36,27,4,23,39,7,32,0.1111111111111111,0.19444444444444445,0.14814814814814814,0.1111111111111111,0.1794871794871795,0.19444444444444445
"Diarrhea 3, secretory sodium, congenital, syndromic",99693,17,10,28,2,26,20,2,18,0.2,0.2,0.07142857142857142,0.2,0.1,0.2
Noonan syndrome 3,27522,3,26,36,5,31,41,3,38,0.19230769230769232,0.11538461538461539,0.1388888888888889,0.19230769230769232,0.07317073170731707,0.11538461538461539
Cardiofaciocutaneous syndrome 2,28065,2,14,17,2,15,45,1,44,0.14285714285714285,0.07142857142857142,0.11764705882352941,0.14285714285714285,0.022222222222222223,0.07142857142857142
Joubert syndrome 10,27986,1,37,23,2,21,2,0,2,0.05405405405405406,0.0,0.08695652173913043,0.05405405405405406,0.0,0.0
"Simpson-Golabi-Behmel syndrome, type 2",30745,5,13,121,13,108,33,0,33,1.0,0.0,0.10743801652892562,1.0,0.0,0.0
Orofaciodigital syndrome I,27672,2,42,24,4,20,45,6,39,0.09523809523809523,0.14285714285714285,0.16666666666666666,0.09523809523809523,0.13333333333333333,0.14285714285714285
"Hemophagocytic lymphohistiocytosis, familial, 2",29161,7,18,51,12,39,28,3,25,0.6666666666666666,0.16666666666666666,0.23529411764705882,0.6666666666666666,0.10714285714285714,0.16666666666666666
"Autoinflammatory syndrome, familial, with or without immunodeficiency",38204,16,44,24,3,21,20,4,16,0.06818181818181818,0.09090909090909091,0.125,0.06818181818181818,0.2,0.09090909090909091
"Intellectual developmental disorder, autosomal recessive 80, with variant lissencephaly",28369,1,23,18,4,14,39,3,36,0.17391304347826086,0.13043478260869565,0.2222222222222222,0.17391304347826086,0.07692307692307693,0.13043478260869565
Luscan-Lumish syndrome,29882,0,64,32,24,8,35,0,35,0.375,0.0,0.75,0.375,0.0,0.0
"Intellectual developmental disorder, autosomal dominant 70",99663,19,16,21,0,21,33,1,32,0.0,0.0625,0.0,0.0,0.030303030303030304,0.0625
Hyaline fibromatosis syndrome,27621,7,10,25,1,24,44,0,44,0.1,0.0,0.04,0.1,0.0,0.0
Alzheimer disease-4,28780,7,11,27,3,24,32,5,27,0.2727272727272727,0.45454545454545453,0.1111111111111111,0.2727272727272727,0.15625,0.45454545454545453
"Congenital disorder of glycosylation, type Iip",35493,2,15,19,1,18,11,0,11,0.06666666666666667,0.0,0.05263157894736842,0.06666666666666667,0.0,0.0
GAPO syndrome,31188,0,12,70,6,64,15,0,15,0.5,0.0,0.08571428571428572,0.5,0.0,0.0
Van den Ende-Gupta syndrome,27554,0,29,35,11,24,11,0,11,0.3793103448275862,0.0,0.3142857142857143,0.3793103448275862,0.0,0.0
Leber congenital amaurosis 6,28852,7,39,52,20,32,36,9,27,0.5128205128205128,0.23076923076923078,0.38461538461538464,0.5128205128205128,0.25,0.23076923076923078
Cone-rod dystrophy 13,29580,3,21,17,5,12,26,5,21,0.23809523809523808,0.23809523809523808,0.29411764705882354,0.23809523809523808,0.19230769230769232,0.23809523809523808
"Pulmonary fibrosis and/or bone marrow failure syndrome, telomere-related, 8",28081,1,17,24,6,18,26,2,24,0.35294117647058826,0.11764705882352941,0.25,0.35294117647058826,0.07692307692307693,0.11764705882352941
Inclusion body myopathy with early-onset Paget disease and frontotemporal dementia 1,28751,0,12,30,1,29,21,1,20,0.08333333333333333,0.08333333333333333,0.03333333333333333,0.08333333333333333,0.047619047619047616,0.08333333333333333
"Ectodermal dysplasia 1, hypohidrotic, X-linked",29412,1,9,21,2,19,66,1,65,0.2222222222222222,0.1111111111111111,0.09523809523809523,0.2222222222222222,0.015151515151515152,0.1111111111111111
Developmental and epileptic encephalopathy 115,28987,3,17,39,8,31,38,4,34,0.47058823529411764,0.23529411764705882,0.20512820512820512,0.47058823529411764,0.10526315789473684,0.23529411764705882
Neurodevelopmental disorder plus optic atrophy,31888,2,13,34,3,31,41,4,37,0.23076923076923078,0.3076923076923077,0.08823529411764706,0.23076923076923078,0.0975609756097561,0.3076923076923077
Multiple endocrine neoplasia IIA,28426,12,5,58,2,56,40,2,38,0.4,0.4,0.034482758620689655,0.4,0.05,0.4
"Lipodystrophy, familial partial, type 8",30508,2,12,18,2,16,33,3,30,0.16666666666666666,0.25,0.1111111111111111,0.16666666666666666,0.09090909090909091,0.25
Severe combined immunodeficiency due to ADA deficiency,38629,20,13,22,0,22,45,3,42,0.0,0.23076923076923078,0.0,0.0,0.06666666666666667,0.23076923076923078
"Epilepsy, early-onset, 3, with or without developmental delay",28025,1,77,20,2,18,38,5,33,0.025974025974025976,0.06493506493506493,0.1,0.025974025974025976,0.13157894736842105,0.06493506493506493
Galactosialidosis,28079,0,17,16,2,14,28,0,28,0.11764705882352941,0.0,0.125,0.11764705882352941,0.0,0.0
Immunodeficiency 112,29890,14,16,31,2,29,49,3,46,0.125,0.1875,0.06451612903225806,0.125,0.061224489795918366,0.1875
Developmental and epileptic encephalopathy 9,28987,1,8,24,5,19,27,0,27,0.625,0.0,0.20833333333333334,0.625,0.0,0.0
Pseudoachondroplasia,27298,1,20,62,18,44,33,0,33,0.9,0.0,0.2903225806451613,0.9,0.0,0.0
Spermatogenic failure 94,29823,12,7,23,1,22,31,2,29,0.14285714285714285,0.2857142857142857,0.043478260869565216,0.14285714285714285,0.06451612903225806,0.2857142857142857
"Pulmonary hypertension, primary, 6",27519,0,17,17,4,13,27,2,25,0.23529411764705882,0.11764705882352941,0.23529411764705882,0.23529411764705882,0.07407407407407407,0.11764705882352941
"Congenital disorder of glycosylation, type IIbb",35493,4,30,32,2,30,10,0,10,0.06666666666666667,0.0,0.0625,0.06666666666666667,0.0,0.0
Weiss-Kruszka syndrome,30327,0,32,25,13,12,27,0,27,0.40625,0.0,0.52,0.40625,0.0,0.0
"Neurodevelopmental disorder with progressive microcephaly, spasticity, and brain anomalies",28189,2,47,34,2,32,26,1,25,0.0425531914893617,0.02127659574468085,0.058823529411764705,0.0425531914893617,0.038461538461538464,0.02127659574468085
"Spastic paraplegia 91, autosomal dominant, with or without cerebellar ataxia",27739,2,23,22,11,11,26,5,21,0.4782608695652174,0.21739130434782608,0.5,0.4782608695652174,0.19230769230769232,0.21739130434782608
Developmental delay with or without epilepsy,29718,3,27,18,6,12,29,3,26,0.2222222222222222,0.1111111111111111,0.3333333333333333,0.2222222222222222,0.10344827586206896,0.1111111111111111
"Neuronopathy, distal hereditary motor, autosomal dominant 11",38458,20,41,23,3,20,30,3,27,0.07317073170731707,0.07317073170731707,0.13043478260869565,0.07317073170731707,0.1,0.07317073170731707
Developmental and epileptic encephalopathy 5,28987,1,36,20,10,10,44,8,36,0.2777777777777778,0.2222222222222222,0.5,0.2777777777777778,0.18181818181818182,0.2222222222222222
"Ventricular tachycardia, catecholaminergic polymorphic, 1",27503,5,5,18,1,17,23,1,22,0.2,0.2,0.05555555555555555,0.2,0.043478260869565216,0.2
"Thrombocytopenia 8, with dysmorphic features and developmental delay",38471,17,32,34,2,32,36,1,35,0.0625,0.03125,0.058823529411764705,0.0625,0.027777777777777776,0.03125
Hypochondroplasia,98702,9,7,51,0,51,29,2,27,0.0,0.2857142857142857,0.0,0.0,0.06896551724137931,0.2857142857142857
Muenke syndrome,27500,2,4,39,3,36,48,1,47,0.75,0.25,0.07692307692307693,0.75,0.020833333333333332,0.25
"Diarrhea 8, secretory sodium, congenital",29691,4,11,25,2,23,22,0,22,0.18181818181818182,0.0,0.08,0.18181818181818182,0.0,0.0
Pitt-Hopkins like syndrome 1,38983,14,70,23,4,19,25,3,22,0.05714285714285714,0.04285714285714286,0.17391304347826086,0.05714285714285714,0.12,0.04285714285714286
Muckle-Wells syndrome,29681,4,8,20,1,19,40,0,40,0.125,0.0,0.05,0.125,0.0,0.0
"Intellectual developmental disorder, autosomal dominant 39",99663,13,7,22,1,21,29,1,28,0.14285714285714285,0.14285714285714285,0.045454545454545456,0.14285714285714285,0.034482758620689655,0.14285714285714285
Amyotrophic lateral sclerosis 1,28624,11,7,25,3,22,19,1,18,0.42857142857142855,0.14285714285714285,0.12,0.42857142857142855,0.05263157894736842,0.14285714285714285
Apert syndrome,30316,4,20,17,1,16,37,1,36,0.05,0.05,0.058823529411764705,0.05,0.02702702702702703,0.05
"Basal ganglia calcification, idiopathic, 9, autosomal recessive",28938,4,39,18,10,8,48,8,40,0.2564102564102564,0.20512820512820512,0.5555555555555556,0.2564102564102564,0.16666666666666666,0.20512820512820512
Auriculocondylar syndrome 2B,30422,1,24,48,8,40,29,0,29,0.3333333333333333,0.0,0.16666666666666666,0.3333333333333333,0.0,0.0
Neurodevelopmental disorder with or without variable brain abnormalities,31839,2,90,24,11,13,30,4,26,0.12222222222222222,0.044444444444444446,0.4583333333333333,0.12222222222222222,0.13333333333333333,0.044444444444444446
"Nemaline myopathy 7, autosomal recessive",27294,6,22,111,16,95,20,0,20,0.7272727272727273,0.0,0.14414414414414414,0.7272727272727273,0.0,0.0
Bethlem myopathy 1A,30345,2,28,46,13,33,21,0,21,0.4642857142857143,0.0,0.2826086956521739,0.4642857142857143,0.0,0.0
"Intellectual developmental disorder, autosomal recessive 5",28584,3,16,26,6,20,22,1,21,0.375,0.0625,0.23076923076923078,0.375,0.045454545454545456,0.0625
Craniometaphyseal dysplasia,27596,2,40,16,5,11,37,0,37,0.125,0.0,0.3125,0.125,0.0,0.0
"Intellectual developmental disorder, autosomal recessive 81",28584,5,54,26,8,18,33,3,30,0.14814814814814814,0.05555555555555555,0.3076923076923077,0.14814814814814814,0.09090909090909091,0.05555555555555555
"Cerebral dysgenesis, neuropathy, ichthyosis, and palmoplantar keratoderma syndrome",29867,12,20,28,1,27,42,2,40,0.05,0.1,0.03571428571428571,0.05,0.047619047619047616,0.1
"Nephrotic syndrome, type 5, with or without ocular abnormalities",28016,3,21,22,12,10,24,1,23,0.5714285714285714,0.047619047619047616,0.5454545454545454,0.5714285714285714,0.041666666666666664,0.047619047619047616
Noonan syndrome 2,27522,5,92,36,13,23,39,3,36,0.14130434782608695,0.03260869565217391,0.3611111111111111,0.14130434782608695,0.07692307692307693,0.03260869565217391
"Hypomagnesemia 3, renal",27337,1,49,17,8,9,17,1,16,0.16326530612244897,0.02040816326530612,0.47058823529411764,0.16326530612244897,0.058823529411764705,0.02040816326530612
Ayme-Gripp syndrome,30872,0,11,16,1,15,13,0,13,0.09090909090909091,0.0,0.0625,0.09090909090909091,0.0,0.0
"Ehlers-Danlos syndrome, spondylodysplastic type, 2",31142,0,27,33,5,28,18,1,17,0.18518518518518517,0.037037037037037035,0.15151515151515152,0.18518518518518517,0.05555555555555555,0.037037037037037035
"Spondyloepimetaphyseal dysplasia with joint laxity, type 1, with or without fractures",38339,15,26,40,0,40,32,0,32,0.0,0.0,0.0,0.0,0.0,0.0
Spermatogenic failure 93,29823,12,9,24,1,23,27,2,25,0.1111111111111111,0.2222222222222222,0.041666666666666664,0.1111111111111111,0.07407407407407407,0.2222222222222222
MHC class II deficiency 4,31044,2,19,26,4,22,27,0,27,0.21052631578947367,0.0,0.15384615384615385,0.21052631578947367,0.0,0.0
Immunodeficiency 120,29890,13,21,27,1,26,44,2,42,0.047619047619047616,0.09523809523809523,0.037037037037037035,0.047619047619047616,0.045454545454545456,0.09523809523809523
Structural heart defects and renal anomalies syndrome,31035,1,29,21,16,5,29,1,28,0.5517241379310345,0.034482758620689655,0.7619047619047619,0.5517241379310345,0.034482758620689655,0.034482758620689655
Centronuclear myopathy 1,30705,4,12,30,2,28,25,1,24,0.16666666666666666,0.08333333333333333,0.06666666666666667,0.16666666666666666,0.04,0.08333333333333333
"Neuronopathy, distal hereditary motor, autosomal recessive 9",38458,19,12,24,2,22,31,2,29,0.16666666666666666,0.16666666666666666,0.08333333333333333,0.16666666666666666,0.06451612903225806,0.16666666666666666
"Cholestasis, progressive familial intrahepatic 4",32629,6,11,27,2,25,23,2,21,0.18181818181818182,0.18181818181818182,0.07407407407407407,0.18181818181818182,0.08695652173913043,0.18181818181818182
"Neurodevelopmental disorder with motor regression, progressive spastic paraplegia, and oromotor dysfunction",31715,2,13,17,3,14,35,4,31,0.23076923076923078,0.3076923076923077,0.17647058823529413,0.23076923076923078,0.11428571428571428,0.3076923076923077
"Contractural arachnodactyly, congenital",97927,16,17,38,1,37,36,2,34,0.058823529411764705,0.11764705882352941,0.02631578947368421,0.058823529411764705,0.05555555555555555,0.11764705882352941
"Chronic granulomatous disease 2, autosomal recessive",28556,5,17,16,2,14,52,5,47,0.11764705882352941,0.29411764705882354,0.125,0.11764705882352941,0.09615384615384616,0.29411764705882354
Elliptocytosis-2,30071,2,7,14,5,9,47,3,44,0.7142857142857143,0.42857142857142855,0.35714285714285715,0.7142857142857143,0.06382978723404255,0.42857142857142855
"Leukoencephalopathy, porphyria-related",36707,12,14,27,2,25,30,3,27,0.14285714285714285,0.21428571428571427,0.07407407407407407,0.14285714285714285,0.1,0.21428571428571427
"Encephalopathy, porphyria-related",27843,3,28,21,0,21,32,0,32,0.0,0.0,0.0,0.0,0.0,0.0
Developmental and epileptic encephalopathy 116,28987,3,18,38,5,33,25,1,24,0.2777777777777778,0.05555555555555555,0.13157894736842105,0.2777777777777778,0.04,0.05555555555555555
"Trichorhinophalangeal syndrome, type I",27224,0,8,18,0,18,18,0,18,0.0,0.0,0.0,0.0,0.0,0.0
Galloway-Mowat syndrome 4,31695,2,22,17,4,13,37,3,34,0.18181818181818182,0.13636363636363635,0.23529411764705882,0.18181818181818182,0.08108108108108109,0.13636363636363635
"Anemia, sideroblastic, and spinocerebellar ataxia",29390,0,52,20,4,16,33,5,28,0.07692307692307693,0.09615384615384616,0.2,0.07692307692307693,0.15151515151515152,0.09615384615384616
Premature ovarian failure 24,28340,4,8,29,6,23,27,1,26,0.75,0.125,0.20689655172413793,0.75,0.037037037037037035,0.125
"Intellectual developmental disorder, autosomal dominant 74",99663,20,31,38,2,36,32,4,28,0.06451612903225806,0.12903225806451613,0.05263157894736842,0.06451612903225806,0.125,0.12903225806451613
Fibrodysplasia ossificans progressiva,30328,1,5,28,2,26,28,1,27,0.4,0.2,0.07142857142857142,0.4,0.03571428571428571,0.2
"Robinow syndrome, autosomal dominant 2",29073,1,58,17,13,4,38,3,35,0.22413793103448276,0.05172413793103448,0.7647058823529411,0.22413793103448276,0.07894736842105263,0.05172413793103448
"Trichothiodystrophy 3, photosensitive",38885,19,25,34,0,34,38,1,37,0.0,0.04,0.0,0.0,0.02631578947368421,0.04
"Hypotrichosis, congenital, with juvenile macular dystrophy",27196,4,10,17,5,12,32,3,29,0.5,0.3,0.29411764705882354,0.5,0.09375,0.3
"Immunodeficiency, common variable, 13",27188,5,63,17,7,10,44,11,33,0.1111111111111111,0.1746031746031746,0.4117647058823529,0.1111111111111111,0.25,0.1746031746031746
"Dyskeratosis congenita, autosomal dominant 3",28228,2,11,18,1,17,54,1,53,0.09090909090909091,0.09090909090909091,0.05555555555555555,0.09090909090909091,0.018518518518518517,0.09090909090909091
"Neurodevelopmental disorder with impaired language, behavioral abnormalities, and dysmorphic facies",29115,4,81,31,14,17,35,6,29,0.1728395061728395,0.07407407407407407,0.45161290322580644,0.1728395061728395,0.17142857142857143,0.07407407407407407
Aplasia cutis-enamel dysplasia syndrome,99062,24,10,45,2,43,52,2,50,0.2,0.2,0.044444444444444446,0.2,0.038461538461538464,0.2
Wolfram syndrome 1,31066,0,7,16,2,14,25,2,23,0.2857142857142857,0.2857142857142857,0.125,0.2857142857142857,0.08,0.2857142857142857
"Vitamin D-dependent rickets, type I",31053,2,18,23,2,21,29,4,25,0.1111111111111111,0.2222222222222222,0.08695652173913043,0.1111111111111111,0.13793103448275862,0.2222222222222222
Craniometadiaphyseal osteosclerosis with hip dysplasia,32488,3,28,17,5,12,42,3,39,0.17857142857142858,0.10714285714285714,0.29411764705882354,0.17857142857142858,0.07142857142857142,0.10714285714285714
Tuberous sclerosis-1,31194,16,9,28,4,24,41,9,32,0.4444444444444444,1.0,0.14285714285714285,0.4444444444444444,0.21951219512195122,1.0
Polydactyly-macrocephaly syndrome,32294,1,18,19,2,17,52,2,50,0.1111111111111111,0.1111111111111111,0.10526315789473684,0.1111111111111111,0.038461538461538464,0.1111111111111111
Combined oxidative phosphorylation deficiency 56,38594,23,20,35,3,32,35,2,33,0.15,0.1,0.08571428571428572,0.15,0.05714285714285714,0.1
Spinal muscular atrophy with progressive myoclonic epilepsy,27253,2,11,18,2,16,28,0,28,0.18181818181818182,0.0,0.1111111111111111,0.18181818181818182,0.0,0.0
Mitochondrial DNA depletion syndrome 13 (encephalomyopathic type),38675,24,91,37,5,32,39,4,35,0.054945054945054944,0.04395604395604396,0.13513513513513514,0.054945054945054944,0.10256410256410256,0.04395604395604396
Citrullinemia,30729,8,19,35,0,35,33,1,32,0.0,0.05263157894736842,0.0,0.0,0.030303030303030304,0.05263157894736842
"Coenzyme Q10 deficiency, primary, 7",39003,18,73,40,2,38,26,0,26,0.0273972602739726,0.0,0.05,0.0273972602739726,0.0,0.0
"Spastic ataxia 10, autosomal recessive",27721,1,20,19,6,13,26,6,20,0.3,0.3,0.3157894736842105,0.3,0.23076923076923078,0.3
Jeffries-Lakhani neurodevelopmental syndrome,31494,8,105,21,8,13,34,5,29,0.0761904761904762,0.047619047619047616,0.38095238095238093,0.0761904761904762,0.14705882352941177,0.047619047619047616
Loeys-Dietz syndrome 1,31164,3,65,19,10,9,34,7,27,0.15384615384615385,0.1076923076923077,0.5263157894736842,0.15384615384615385,0.20588235294117646,0.1076923076923077
"Multiple self-healing squamous epithelioma, susceptibility to",31659,2,1,27,0,27,6,0,6,0.0,0.0,0.0,0.0,0.0,0.0
Branched-chain keto acid dehydrogenase kinase deficiency,32008,8,13,26,1,25,27,0,27,0.07692307692307693,0.0,0.038461538461538464,0.07692307692307693,0.0,0.0
"Intellectual developmental disorder, autosomal dominant 73",99663,20,104,25,1,24,46,5,41,0.009615384615384616,0.04807692307692308,0.04,0.009615384615384616,0.10869565217391304,0.04807692307692308
"Stickler syndrome, type II",32565,3,17,23,2,21,12,0,12,0.11764705882352941,0.0,0.08695652173913043,0.11764705882352941,0.0,0.0
"Charcot-Marie-Tooth disease, axonal, type 2A2A",27530,7,8,39,2,37,18,1,17,0.25,0.125,0.05128205128205128,0.25,0.05555555555555555,0.125
"Osteogenesis imperfecta, type XII",27158,10,17,221,15,206,33,3,30,0.8823529411764706,0.17647058823529413,0.06787330316742081,0.8823529411764706,0.09090909090909091,0.17647058823529413
Geleophysic dysplasia 1,27363,0,16,18,2,16,32,0,32,0.125,0.0,0.1111111111111111,0.125,0.0,0.0
Imerslund-Grasbeck syndrome 2,27327,5,3,33,1,32,31,0,31,0.3333333333333333,0.0,0.030303030303030304,0.3333333333333333,0.0,0.0
"Adrenal hyperplasia, congenital, due to 21-hydroxylase deficiency",30111,2,23,20,2,18,25,3,22,0.08695652173913043,0.13043478260869565,0.1,0.08695652173913043,0.12,0.13043478260869565
Long QT syndrome 15,27326,4,9,18,5,13,27,2,25,0.5555555555555556,0.2222222222222222,0.2777777777777778,0.5555555555555556,0.07407407407407407,0.2222222222222222
Sick sinus syndrome 2,36046,7,11,14,0,14,35,0,35,0.0,0.0,0.0,0.0,0.0,0.0
Bardet-Biedl syndrome 1,27886,3,14,18,3,15,29,3,26,0.21428571428571427,0.21428571428571427,0.16666666666666666,0.21428571428571427,0.10344827586206896,0.21428571428571427
"Trichothiodystrophy 2, photosensitive",38885,22,7,39,2,37,41,1,40,0.2857142857142857,0.14285714285714285,0.05128205128205128,0.2857142857142857,0.024390243902439025,0.14285714285714285
Retinitis pigmentosa 19,31651,9,7,20,4,16,30,2,28,0.5714285714285714,0.2857142857142857,0.2,0.5714285714285714,0.06666666666666667,0.2857142857142857
"Basal ganglia calcification, idiopathic, 10, autosomal recessive",28938,2,9,18,5,13,40,2,38,0.5555555555555556,0.2222222222222222,0.2777777777777778,0.5555555555555556,0.05,0.2222222222222222
"Spastic paraplegia 90B, autosomal recessive",38455,16,9,16,1,15,37,1,36,0.1111111111111111,0.1111111111111111,0.0625,0.1111111111111111,0.02702702702702703,0.1111111111111111
"Spastic paraplegia 90A, autosomal dominant",38901,14,19,17,1,16,24,1,23,0.05263157894736842,0.05263157894736842,0.058823529411764705,0.05263157894736842,0.041666666666666664,0.05263157894736842
Acromelic frontonasal dysostosis,31586,2,39,16,6,10,53,2,51,0.15384615384615385,0.05128205128205128,0.375,0.15384615384615385,0.03773584905660377,0.05128205128205128
"Neurodevelopmental disorder with movement abnormalities, abnormal gait, and autistic features",29499,1,46,17,9,8,25,5,20,0.1956521739130435,0.10869565217391304,0.5294117647058824,0.1956521739130435,0.2,0.10869565217391304
"Vasculitis, autoinflammation, immunodeficiency, and hematologic defects syndrome",38204,18,22,28,0,28,39,2,37,0.0,0.09090909090909091,0.0,0.0,0.05128205128205128,0.09090909090909091
Garg-Mishra progeroid syndrome,31991,4,28,107,7,100,67,2,65,0.25,0.07142857142857142,0.06542056074766354,0.25,0.029850746268656716,0.07142857142857142
"Neurodevelopmental disorder with language impairment, autism, and attention deficit-hyperactivity disorder",31463,0,34,20,4,16,32,2,30,0.11764705882352941,0.058823529411764705,0.2,0.11764705882352941,0.0625,0.058823529411764705
"Neurodegeneration, childhood-onset, with cerebellar ataxia and cognitive decline",29503,1,16,18,3,15,25,3,22,0.1875,0.1875,0.16666666666666666,0.1875,0.12,0.1875
"Neurodevelopmental disorder with motor and language delay, ocular defects, and brain abnormalities",29131,2,43,21,5,16,32,4,28,0.11627906976744186,0.09302325581395349,0.23809523809523808,0.11627906976744186,0.125,0.09302325581395349
Hoxha-Aliu syndrome,30947,6,51,29,1,28,53,1,52,0.0196078431372549,0.0196078431372549,0.034482758620689655,0.0196078431372549,0.018867924528301886,0.0196078431372549
"Spondyloepimetaphyseal dysplasia, Guo-Campeau type",38339,21,55,33,3,30,52,7,45,0.05454545454545454,0.12727272727272726,0.09090909090909091,0.05454545454545454,0.1346153846153846,0.12727272727272726
"Lipodystrophy, familial partial, type 9",30508,2,44,18,4,14,30,3,27,0.09090909090909091,0.06818181818181818,0.2222222222222222,0.09090909090909091,0.1,0.06818181818181818
Coffin-Siris syndrome 8,27378,3,116,24,9,15,50,7,43,0.07758620689655173,0.0603448275862069,0.375,0.07758620689655173,0.14,0.0603448275862069
"Hyperoxaluria, primary, type II",29946,7,3,28,2,26,21,1,20,0.6666666666666666,0.3333333333333333,0.07142857142857142,0.6666666666666666,0.047619047619047616,0.3333333333333333
"Developmental delay, dysmorphic facies, and brain anomalies",32066,3,173,20,9,11,49,9,40,0.05202312138728324,0.05202312138728324,0.45,0.05202312138728324,0.1836734693877551,0.05202312138728324
Premature ovarian failure 23,28340,4,6,29,4,25,33,2,31,0.6666666666666666,0.3333333333333333,0.13793103448275862,0.6666666666666666,0.06060606060606061,0.3333333333333333
"Homocystinuria, B6-responsive and nonresponsive types",37603,18,16,37,0,37,42,0,42,0.0,0.0,0.0,0.0,0.0,0.0
Glycine encephalopathy 2,28289,2,20,17,4,13,21,1,20,0.2,0.05,0.23529411764705882,0.2,0.047619047619047616,0.05
"Seizures, benign familial infantile, 3",33100,0,61,16,11,5,34,5,29,0.18032786885245902,0.08196721311475409,0.6875,0.18032786885245902,0.14705882352941177,0.08196721311475409
Developmental and epileptic encephalopathy 11,28987,0,279,33,19,14,13,3,10,0.06810035842293907,0.010752688172043012,0.5757575757575758,0.06810035842293907,0.23076923076923078,0.010752688172043012
Camurati-Engelmann disease,29176,1,12,67,5,62,35,1,34,0.4166666666666667,0.08333333333333333,0.07462686567164178,0.4166666666666667,0.02857142857142857,0.08333333333333333
"Cutis laxa, autosomal recessive, type IA",27841,6,20,22,4,18,31,0,31,0.2,0.0,0.18181818181818182,0.2,0.0,0.0
"Megalocornea 1, X-linked",31677,11,4,33,1,32,30,2,28,0.25,0.5,0.030303030303030304,0.25,0.06666666666666667,0.5
"Arthrogryposis, distal, with impaired proprioception and touch",29212,0,33,32,20,12,42,3,39,0.6060606060606061,0.09090909090909091,0.625,0.6060606060606061,0.07142857142857142,0.09090909090909091
Polycystic kidney disease 8,28262,3,12,23,3,20,35,4,31,0.25,0.3333333333333333,0.13043478260869565,0.25,0.11428571428571428,0.3333333333333333
"Hyper-IgE syndrome 2, autosomal recessive, with recurrent infections",31806,7,66,17,7,10,36,17,19,0.10606060606060606,0.25757575757575757,0.4117647058823529,0.10606060606060606,0.4722222222222222,0.25757575757575757
Greig cephalopolysyndactyly syndrome,30921,2,20,40,10,30,38,2,36,0.5,0.1,0.25,0.5,0.05263157894736842,0.1
Pallister-Hall syndrome,27488,8,10,107,8,99,51,3,48,0.8,0.3,0.07476635514018691,0.8,0.058823529411764705,0.3
"Polydactyly, postaxial, types A1 and B",98290,9,5,26,1,25,36,2,34,0.2,0.4,0.038461538461538464,0.2,0.05555555555555555,0.4
"Deafness, autosomal recessive 122",27162,1,1,19,1,18,18,0,18,1.0,0.0,0.05263157894736842,1.0,0.0,0.0
Retinitis pigmentosa 18,38253,20,6,32,2,30,31,2,29,0.3333333333333333,0.3333333333333333,0.0625,0.3333333333333333,0.06451612903225806,0.3333333333333333
"Congenital disorder of glycosylation, type IIc",35493,3,14,3,0,3,8,0,8,0.0,0.0,0.0,0.0,0.0,0.0
Tan-Almurshedi syndrome,31536,1,25,17,1,16,19,1,18,0.04,0.04,0.058823529411764705,0.04,0.05263157894736842,0.04
Trichohepatoenteric syndrome 1,27187,1,19,26,5,21,29,1,28,0.2631578947368421,0.05263157894736842,0.19230769230769232,0.2631578947368421,0.034482758620689655,0.05263157894736842
"Congenital disorder of glycosylation, type IIh",35493,7,52,26,1,25,10,0,10,0.019230769230769232,0.0,0.038461538461538464,0.019230769230769232,0.0,0.0
Branchiooculofacial syndrome,28514,0,21,21,3,18,7,0,7,0.14285714285714285,0.0,0.14285714285714285,0.14285714285714285,0.0,0.0
"Metabolic encephalomyopathic crises, recurrent, with rhabdomyolysis, cardiac arrhythmias, and neurodegeneration",29006,1,35,17,9,8,33,3,30,0.2571428571428571,0.08571428571428572,0.5294117647058824,0.2571428571428571,0.09090909090909091,0.08571428571428572
Cohen syndrome,30788,2,25,18,3,15,35,4,31,0.12,0.16,0.16666666666666666,0.12,0.11428571428571428,0.16
"Ehlers-Danlos syndrome, musculocontractural type 1",28883,2,14,25,4,21,35,1,34,0.2857142857142857,0.07142857142857142,0.16,0.2857142857142857,0.02857142857142857,0.07142857142857142
"Neuromuscular disorder, congenital, with dysmorphic facies",31772,1,66,19,8,11,42,4,38,0.12121212121212122,0.06060606060606061,0.42105263157894735,0.12121212121212122,0.09523809523809523,0.06060606060606061
"Intellectual developmental disorder, X-linked syndromic 37",31959,1,198,17,7,10,35,11,24,0.03535353535353535,0.05555555555555555,0.4117647058823529,0.03535353535353535,0.3142857142857143,0.05555555555555555
"Leukodystrophy, hypomyelinating, 27",31084,2,38,20,7,13,14,1,13,0.18421052631578946,0.02631578947368421,0.35,0.18421052631578946,0.07142857142857142,0.02631578947368421
Craniofrontonasal dysplasia,27877,0,22,18,0,18,20,0,20,0.0,0.0,0.0,0.0,0.0,0.0
"Albinism, oculocutaneous, type III",84278,11,4,26,3,23,37,2,35,0.75,0.5,0.11538461538461539,0.75,0.05405405405405406,0.5
"Intellectual developmental disorder, X-linked 114",28041,1,24,17,4,13,18,0,18,0.16666666666666666,0.0,0.23529411764705882,0.16666666666666666,0.0,0.0
"Spinocerebellar ataxia, autosomal recessive 12",27662,2,12,35,8,27,6,3,3,0.6666666666666666,0.25,0.22857142857142856,0.6666666666666666,0.5,0.25
MHC class I deficiency 2,28896,4,7,18,4,14,19,0,19,0.5714285714285714,0.0,0.2222222222222222,0.5714285714285714,0.0,0.0
"Amyloidosis, hereditary systemic 3",37798,19,27,33,1,32,33,1,32,0.037037037037037035,0.037037037037037035,0.030303030303030304,0.037037037037037035,0.030303030303030304,0.037037037037037035
Gillespie syndrome,31381,0,81,19,2,17,20,0,20,0.024691358024691357,0.0,0.10526315789473684,0.024691358024691357,0.0,0.0
"Spinocerebellar ataxia 29, congenital nonprogressive",27662,4,138,31,19,12,15,10,5,0.13768115942028986,0.07246376811594203,0.6129032258064516,0.13768115942028986,0.6666666666666666,0.07246376811594203
Spinocerebellar ataxia 15,27662,3,35,31,18,13,14,9,5,0.5142857142857142,0.2571428571428571,0.5806451612903226,0.5142857142857142,0.6428571428571429,0.2571428571428571
Opsismodysplasia,29407,1,23,43,12,31,56,0,56,0.5217391304347826,0.0,0.27906976744186046,0.5217391304347826,0.0,0.0
Fliedner-Zweier syndrome,31824,1,36,40,13,27,32,1,31,0.3611111111111111,0.027777777777777776,0.325,0.3611111111111111,0.03125,0.027777777777777776
"Spastic ataxia 8, autosomal recessive, with hypomyelinating leukodystrophy",27721,3,38,21,8,13,30,8,22,0.21052631578947367,0.21052631578947367,0.38095238095238093,0.21052631578947367,0.26666666666666666,0.21052631578947367
Developmental and epileptic encephalopathy 112,28987,3,28,30,10,20,27,2,25,0.35714285714285715,0.07142857142857142,0.3333333333333333,0.35714285714285715,0.07407407407407407,0.07142857142857142
"Ventricular tachycardia, catecholaminergic polymorphic, 3",27503,7,7,23,3,20,24,2,22,0.42857142857142855,0.2857142857142857,0.13043478260869565,0.42857142857142855,0.08333333333333333,0.2857142857142857
"Deafness, autosomal recessive 125",27162,11,2,27,1,26,33,1,32,0.5,0.5,0.037037037037037035,0.5,0.030303030303030304,0.5
"Parkinson disease 7, autosomal recessive early-onset",28547,7,14,19,3,16,33,3,30,0.21428571428571427,0.21428571428571427,0.15789473684210525,0.21428571428571427,0.09090909090909091,0.21428571428571427
"Encephalopathy, neonatal severe, with lactic acidosis and brain abnormalities",29788,2,23,18,11,7,24,5,19,0.4782608695652174,0.21739130434782608,0.6111111111111112,0.4782608695652174,0.20833333333333334,0.21739130434782608
"Diabetes, deafness, developmental delay, and short stature syndrome",28062,1,14,18,2,16,32,1,31,0.14285714285714285,0.07142857142857142,0.1111111111111111,0.14285714285714285,0.03125,0.07142857142857142
Combined oxidative phosphorylation deficiency 58,38594,19,32,28,3,25,29,3,26,0.09375,0.09375,0.10714285714285714,0.09375,0.10344827586206896,0.09375
MHC class I deficiency 3,28896,7,2,24,0,24,34,0,34,0.0,0.0,0.0,0.0,0.0,0.0
"Weill-Marchesani syndrome 1, recessive",28146,2,9,26,6,20,24,4,20,0.6666666666666666,0.4444444444444444,0.23076923076923078,0.6666666666666666,0.16666666666666666,0.4444444444444444
Pierpont syndrome,30736,0,23,18,2,16,35,0,35,0.08695652173913043,0.0,0.1111111111111111,0.08695652173913043,0.0,0.0
HMG-CoA synthase-2 deficiency,31378,9,42,38,6,32,29,4,25,0.14285714285714285,0.09523809523809523,0.15789473684210525,0.14285714285714285,0.13793103448275862,0.09523809523809523
Loeys-Dietz syndrome 4,31164,4,54,31,12,19,39,8,31,0.2222222222222222,0.14814814814814814,0.3870967741935484,0.2222222222222222,0.20512820512820512,0.14814814814814814
Chitayat syndrome,29317,0,30,16,8,8,36,0,36,0.26666666666666666,0.0,0.5,0.26666666666666666,0.0,0.0
Ataxia-pancytopenia syndrome,31519,5,27,27,11,16,15,4,11,0.4074074074074074,0.14814814814814814,0.4074074074074074,0.4074074074074074,0.26666666666666666,0.14814814814814814
Spinocerebellar ataxia 49,27662,2,16,38,6,32,5,2,3,0.375,0.125,0.15789473684210525,0.375,0.4,0.125
Treacher Collins syndrome 1,30106,2,15,17,7,10,37,3,34,0.4666666666666667,0.2,0.4117647058823529,0.4666666666666667,0.08108108108108109,0.2
Ullrich congenital muscular dystrophy 1C,27258,3,13,63,4,59,26,0,26,0.3076923076923077,0.0,0.06349206349206349,0.3076923076923077,0.0,0.0
Bethlem myopathy 1C,30345,2,15,31,5,26,18,0,18,0.3333333333333333,0.0,0.16129032258064516,0.3333333333333333,0.0,0.0
Chudley-McCullough syndrome,28204,0,12,17,5,12,31,0,31,0.4166666666666667,0.0,0.29411764705882354,0.4166666666666667,0.0,0.0
"Neuronopathy, distal hereditary motor, autosomal recessive 10",38458,22,20,26,1,25,27,2,25,0.05,0.1,0.038461538461538464,0.05,0.07407407407407407,0.1
"Cockayne syndrome, type A",27995,11,18,169,15,154,49,5,44,0.8333333333333334,0.2777777777777778,0.08875739644970414,0.8333333333333334,0.10204081632653061,0.2777777777777778
"Autoimmune disease, multisystem, infantile-onset, 3",39459,25,16,43,0,43,54,0,54,0.0,0.0,0.0,0.0,0.0,0.0
"Autoinflammatory disease, multisystem, with immune dysregulation, X-linked",38204,24,45,35,2,33,35,1,34,0.044444444444444446,0.022222222222222223,0.05714285714285714,0.044444444444444446,0.02857142857142857,0.022222222222222223
Desmosterolosis,30138,1,29,56,18,38,63,0,63,0.6206896551724138,0.0,0.32142857142857145,0.6206896551724138,0.0,0.0
Retinitis pigmentosa 76,31651,13,14,27,7,20,39,3,36,0.5,0.21428571428571427,0.25925925925925924,0.5,0.07692307692307693,0.21428571428571427
"Charcot-Marie-Tooth disease, type 1C",27530,4,8,28,1,27,22,2,20,0.125,0.25,0.03571428571428571,0.125,0.09090909090909091,0.25
Jacobsen syndrome,31052,2,61,84,16,68,40,0,40,0.26229508196721313,0.0,0.19047619047619047,0.26229508196721313,0.0,0.0
Cone-rod retinal dystrophy-2,27861,5,8,31,8,23,25,3,22,1.0,0.375,0.25806451612903225,1.0,0.12,0.375
Neurodevelopmental disorder with progressive movement abnormalities,31932,1,78,17,9,8,12,3,9,0.11538461538461539,0.038461538461538464,0.5294117647058824,0.11538461538461539,0.25,0.038461538461538464
"Ciliary dyskinesia, primary, 53",32022,7,17,23,1,22,29,2,27,0.058823529411764705,0.11764705882352941,0.043478260869565216,0.058823529411764705,0.06896551724137931,0.11764705882352941
Peutz-Jeghers syndrome,31798,4,3,29,1,28,34,1,33,0.3333333333333333,0.3333333333333333,0.034482758620689655,0.3333333333333333,0.029411764705882353,0.3333333333333333
Marfan syndrome,38220,22,37,36,13,23,28,9,19,0.35135135135135137,0.24324324324324326,0.3611111111111111,0.35135135135135137,0.32142857142857145,0.24324324324324326
"Ectopia lentis, familial",29210,17,17,22,4,18,37,5,32,0.23529411764705882,0.29411764705882354,0.18181818181818182,0.23529411764705882,0.13513513513513514,0.29411764705882354
Marfan lipodystrophy syndrome,38220,21,44,34,3,31,55,7,48,0.06818181818181818,0.1590909090909091,0.08823529411764706,0.06818181818181818,0.12727272727272726,0.1590909090909091
Geleophysic dysplasia 2,27363,1,24,31,11,20,36,0,36,0.4583333333333333,0.0,0.3548387096774194,0.4583333333333333,0.0,0.0
Acromicric dysplasia,28047,0,11,27,7,20,29,0,29,0.6363636363636364,0.0,0.25925925925925924,0.6363636363636364,0.0,0.0
Stiff skin syndrome,27904,2,10,20,2,18,24,1,23,0.2,0.1,0.1,0.2,0.041666666666666664,0.1
"Dystonia 22, adult-onset",27743,6,6,29,0,29,30,1,29,0.0,0.16666666666666666,0.0,0.0,0.03333333333333333,0.16666666666666666
Neurodevelopmental disorder with language delay and variable cognitive abnormalities,29131,2,19,26,6,20,34,4,30,0.3157894736842105,0.21052631578947367,0.23076923076923078,0.3157894736842105,0.11764705882352941,0.21052631578947367
"Amelogenesis imperfecta, type IJ",28782,7,2,21,2,19,9,1,8,1.0,0.5,0.09523809523809523,1.0,0.1111111111111111,0.5
Temtamy preaxial brachydactyly syndrome,28256,0,8,25,3,22,17,0,17,0.375,0.0,0.12,0.375,0.0,0.0
Holt-Oram syndrome,31211,1,90,21,5,16,38,2,36,0.05555555555555555,0.022222222222222223,0.23809523809523808,0.05555555555555555,0.05263157894736842,0.022222222222222223
"Leukocyte adhesion deficiency, type III",28125,0,12,19,0,19,25,1,24,0.0,0.08333333333333333,0.0,0.0,0.04,0.08333333333333333
Retinitis pigmentosa with or without skeletal anomalies,38253,20,31,29,2,27,31,2,29,0.06451612903225806,0.06451612903225806,0.06896551724137931,0.06451612903225806,0.06451612903225806,0.06451612903225806
"Waardenburg syndrome, type 3",27569,5,17,31,2,29,53,0,53,0.11764705882352941,0.0,0.06451612903225806,0.11764705882352941,0.0,0.0
Neurodegeneration with brain iron accumulation 1,29074,4,25,19,1,18,27,7,20,0.04,0.28,0.05263157894736842,0.04,0.25925925925925924,0.28
Orofaciodigital syndrome V,27672,2,25,23,2,21,39,2,37,0.08,0.08,0.08695652173913043,0.08,0.05128205128205128,0.08
Developmental and epileptic encephalopathy 17,28987,2,3,17,0,17,37,0,37,0.0,0.0,0.0,0.0,0.0,0.0
"Robinow syndrome, autosomal recessive",29073,1,81,17,13,4,59,6,53,0.16049382716049382,0.07407407407407407,0.7647058823529411,0.16049382716049382,0.1016949152542373,0.07407407407407407
"Heterotaxy, visceral, 1, X-linked",30085,4,6,18,3,15,50,0,50,0.5,0.0,0.16666666666666666,0.5,0.0,0.0
"Dystonia 37, early-onset, with striatal lesions",29547,12,14,26,4,22,30,3,27,0.2857142857142857,0.21428571428571427,0.15384615384615385,0.2857142857142857,0.1,0.21428571428571427
"Albinism, oculocutaneous, type II",84278,12,7,32,8,24,41,5,36,1.1428571428571428,0.7142857142857143,0.25,1.1428571428571428,0.12195121951219512,0.7142857142857143
"Immunodeficiency 103, susceptibility to fungal infection",27169,5,10,19,5,14,45,2,43,0.5,0.2,0.2631578947368421,0.5,0.044444444444444446,0.2
Immunoskeletal dysplasia with neurodevelopmental abnormalitie,32150,1,67,18,8,10,47,4,43,0.11940298507462686,0.05970149253731343,0.4444444444444444,0.11940298507462686,0.0851063829787234,0.05970149253731343
Megalencephaly-polydactyly syndrome,32294,1,33,24,4,20,32,3,29,0.12121212121212122,0.09090909090909091,0.16666666666666666,0.12121212121212122,0.09375,0.09090909090909091
"Intellectual developmental disorder, autosomal dominant 21",28584,4,110,28,15,13,53,14,39,0.13636363636363635,0.12727272727272726,0.5357142857142857,0.13636363636363635,0.2641509433962264,0.12727272727272726
Immunodeficiency 121 with autoinflammation,30536,5,24,17,4,13,42,5,37,0.16666666666666666,0.20833333333333334,0.23529411764705882,0.16666666666666666,0.11904761904761904,0.20833333333333334
Oliver-McFarlane syndrome,28654,0,26,20,1,19,16,0,16,0.038461538461538464,0.0,0.05,0.038461538461538464,0.0,0.0
Cardiofaciocutaneous syndrome,28065,2,19,17,0,17,43,1,42,0.0,0.05263157894736842,0.0,0.0,0.023255813953488372,0.05263157894736842
Nance-Horan syndrome,32072,1,8,17,1,16,48,1,47,0.125,0.125,0.058823529411764705,0.125,0.020833333333333332,0.125
Orofaciodigital syndrome XX,27672,1,29,25,6,19,26,1,25,0.20689655172413793,0.034482758620689655,0.24,0.20689655172413793,0.038461538461538464,0.034482758620689655
Rhabdoid tumor predisposition syndrome 1,31306,16,7,50,1,49,51,0,51,0.14285714285714285,0.0,0.02,0.14285714285714285,0.0,0.0
Coffin-Siris syndrome 3,27378,2,97,22,7,15,21,4,17,0.07216494845360824,0.041237113402061855,0.3181818181818182,0.07216494845360824,0.19047619047619047,0.041237113402061855
Holoprosencephaly 4,28672,2,13,29,2,27,44,1,43,0.15384615384615385,0.07692307692307693,0.06896551724137931,0.15384615384615385,0.022727272727272728,0.07692307692307693
Loeys-Dietz syndrome 6,31164,5,52,26,6,20,41,4,37,0.11538461538461539,0.07692307692307693,0.23076923076923078,0.11538461538461539,0.0975609756097561,0.07692307692307693
"Congenital heart defects, multiple types, 8, with or without heterotaxy",97936,19,37,44,7,37,39,3,36,0.1891891891891892,0.08108108108108109,0.1590909090909091,0.1891891891891892,0.07692307692307693,0.08108108108108109
"Albinism, oculocutaneous, type IV",84278,9,15,46,5,41,25,3,22,0.3333333333333333,0.2,0.10869565217391304,0.3333333333333333,0.12,0.2
"Niemann-Pick disease, type C1",98094,0,12,19,0,19,20,2,18,0.0,0.16666666666666666,0.0,0.0,0.1,0.16666666666666666
Noonan syndrome 6,27522,5,29,51,7,44,42,3,39,0.2413793103448276,0.10344827586206896,0.13725490196078433,0.2413793103448276,0.07142857142857142,0.10344827586206896
Spermatogenic failure 90,29823,16,2,24,1,23,32,1,31,0.5,0.5,0.041666666666666664,0.5,0.03125,0.5
"Rett syndrome, congenital variant",28856,4,15,46,5,41,41,1,40,0.3333333333333333,0.06666666666666667,0.10869565217391304,0.3333333333333333,0.024390243902439025,0.06666666666666667
Townes-Brocks syndrome 1,30460,0,19,17,2,15,32,0,32,0.10526315789473684,0.0,0.11764705882352941,0.10526315789473684,0.0,0.0
Netherton syndrome,29333,4,4,38,1,37,28,0,28,0.25,0.0,0.02631578947368421,0.25,0.0,0.0
Larsen syndrome,31684,1,21,23,0,23,31,2,29,0.0,0.09523809523809523,0.0,0.0,0.06451612903225806,0.09523809523809523
"Mitochondrial complex IV deficiency, nuclear type 2",39785,20,100,23,9,14,29,9,20,0.09,0.09,0.391304347826087,0.09,0.3103448275862069,0.09
Myopia 6,31111,12,4,31,2,29,20,0,20,0.5,0.0,0.06451612903225806,0.5,0.0,0.0
Cerebral creatine deficiency syndrome 1,38803,19,10,36,0,36,32,0,32,0.0,0.0,0.0,0.0,0.0,0.0
Alfadhel syndrome,28063,0,26,22,2,20,31,0,31,0.07692307692307693,0.0,0.09090909090909091,0.07692307692307693,0.0,0.0
Oculopharyngeal muscular dystrophy 2,27548,2,15,24,9,15,4,3,1,0.6,0.2,0.375,0.6,0.75,0.2
Diamond-Blackfan anemia 1,27452,6,13,37,3,34,34,2,32,0.23076923076923078,0.15384615384615385,0.08108108108108109,0.23076923076923078,0.058823529411764705,0.15384615384615385
El Hayek-Chahrour neurodevelopmental syndrome,31839,5,34,22,9,13,37,6,31,0.2647058823529412,0.17647058823529413,0.4090909090909091,0.2647058823529412,0.16216216216216217,0.17647058823529413
Neurodevelopmental disorder with coarse facies and mild distal skeletal abnormalities,30067,1,248,18,12,6,42,16,26,0.04838709677419355,0.06451612903225806,0.6666666666666666,0.04838709677419355,0.38095238095238093,0.06451612903225806
Xerosis and growth failure with immune and pulmonary dysfunction syndrome,29987,0,27,20,1,19,34,2,32,0.037037037037037035,0.07407407407407407,0.05,0.037037037037037035,0.058823529411764705,0.07407407407407407
Retinitis pigmentosa 27,31651,8,4,19,5,14,30,3,27,1.25,0.75,0.2631578947368421,1.25,0.1,0.75
Sulfite oxidase deficiency,27903,1,18,16,4,12,34,0,34,0.2222222222222222,0.0,0.25,0.2222222222222222,0.0,0.0
"Lipodystrophy, congenital generalized, type 5",38009,13,13,36,3,33,36,2,34,0.23076923076923078,0.15384615384615385,0.08333333333333333,0.23076923076923078,0.05555555555555555,0.15384615384615385
"Amyloidosis, Finnish type",27413,0,11,19,1,18,37,2,35,0.09090909090909091,0.18181818181818182,0.05263157894736842,0.09090909090909091,0.05405405405405406,0.18181818181818182
CHARGE syndrome,31003,9,41,92,15,77,59,4,55,0.36585365853658536,0.0975609756097561,0.16304347826086957,0.36585365853658536,0.06779661016949153,0.0975609756097561
Mitochondrial DNA depletion syndrome 6 (hepatocerebral type),38522,18,147,29,8,21,24,8,16,0.05442176870748299,0.05442176870748299,0.27586206896551724,0.05442176870748299,0.3333333333333333,0.05442176870748299
Kleefstra syndrome 1,32549,6,59,26,8,18,40,5,35,0.13559322033898305,0.0847457627118644,0.3076923076923077,0.13559322033898305,0.125,0.0847457627118644
"Bleeding disorder, vascular-type",35765,17,7,26,4,22,21,4,17,0.5714285714285714,0.5714285714285714,0.15384615384615385,0.5714285714285714,0.19047619047619047,0.5714285714285714
"Neuropathy, recurrent, with pressure palsies",29107,3,4,28,0,28,32,0,32,0.0,0.0,0.0,0.0,0.0,0.0
"Intellectual developmental disorder, autosomal dominant 75",99663,18,31,28,0,28,49,3,46,0.0,0.0967741935483871,0.0,0.0,0.061224489795918366,0.0967741935483871
"Myasthenic syndrome, congenital, 8, with pre- and postsynaptic defects",33062,4,11,35,4,31,26,1,25,0.36363636363636365,0.09090909090909091,0.11428571428571428,0.36363636363636365,0.038461538461538464,0.09090909090909091
Bardet-Biedl syndrome 5,27886,3,16,18,3,15,35,5,30,0.1875,0.3125,0.16666666666666666,0.1875,0.14285714285714285,0.3125
"Epidermolytic hyperkeratosis 2B, autosomal recessive",30723,5,10,16,3,13,24,0,24,0.3,0.0,0.1875,0.3,0.0,0.0
"Cortical dysplasia, complex, with other brain malformations 14A, (bilateral frontoparietal)",37897,21,11,27,1,26,37,2,35,0.09090909090909091,0.18181818181818182,0.037037037037037035,0.09090909090909091,0.05405405405405406,0.18181818181818182
Cornelia de Lange syndrome 1,28431,8,86,40,20,20,52,10,42,0.23255813953488372,0.11627906976744186,0.5,0.23255813953488372,0.19230769230769232,0.11627906976744186
Developmental and epileptic encephalopathy 111,28987,3,34,33,5,28,33,1,32,0.14705882352941177,0.029411764705882353,0.15151515151515152,0.14705882352941177,0.030303030303030304,0.029411764705882353
"Rothmund-Thomson syndrome, type 4",27814,4,38,40,5,35,50,5,45,0.13157894736842105,0.13157894736842105,0.125,0.13157894736842105,0.1,0.13157894736842105
Spermatogenic failure 92,29823,10,5,20,1,19,28,2,26,0.2,0.4,0.05,0.2,0.07142857142857142,0.4
"Neurodevelopmental disorder with or without anomalies of the brain, eye, or heart",29669,2,115,32,17,15,40,4,36,0.14782608695652175,0.034782608695652174,0.53125,0.14782608695652175,0.1,0.034782608695652174
Neurodevelopmental disorder with early-onset parkinsonism and behavioral abnormalities,31463,1,30,19,4,15,26,4,22,0.13333333333333333,0.13333333333333333,0.21052631578947367,0.13333333333333333,0.15384615384615385,0.13333333333333333
"Hypotonia, infantile, with psychomotor retardation and characteristic facies 3",31131,1,96,17,6,11,36,6,30,0.0625,0.0625,0.35294117647058826,0.0625,0.16666666666666666,0.0625
"Osteogenesis imperfecta, type XIV",27158,9,10,221,11,210,43,6,37,1.1,0.6,0.049773755656108594,1.1,0.13953488372093023,0.6
Poikiloderma with neutropenia,29551,9,6,22,3,19,34,1,33,0.5,0.16666666666666666,0.13636363636363635,0.5,0.029411764705882353,0.16666666666666666
"Myopathy, distal, Tateyama type",27717,1,14,23,6,17,23,2,21,0.42857142857142855,0.14285714285714285,0.2608695652173913,0.42857142857142855,0.08695652173913043,0.14285714285714285
Jervell and Lange-Nielsen syndrome,38598,19,5,27,2,25,33,1,32,0.4,0.2,0.07407407407407407,0.4,0.030303030303030304,0.2
Alagille syndrome 1,98197,20,19,49,1,48,29,1,28,0.05263157894736842,0.05263157894736842,0.02040816326530612,0.05263157894736842,0.034482758620689655,0.05263157894736842
"Lipodystrophy, familial partial, type 2",30508,2,50,18,8,10,36,6,30,0.16,0.12,0.4444444444444444,0.16,0.16666666666666666,0.12
"Cardiomyopathy, dilated, 1A",27669,3,27,15,2,13,26,0,26,0.07407407407407407,0.0,0.13333333333333333,0.07407407407407407,0.0,0.0
"Emery-Dreifuss muscular dystrophy 2, autosomal dominant",27738,3,39,33,11,22,29,1,28,0.28205128205128205,0.02564102564102564,0.3333333333333333,0.28205128205128205,0.034482758620689655,0.02564102564102564
LMNA-related congenital muscular dystrophy,31690,2,17,28,7,21,27,6,21,0.4117647058823529,0.35294117647058826,0.25,0.4117647058823529,0.2222222222222222,0.35294117647058826
Hutchinson-Gilford progeria,31688,1,24,19,4,15,55,4,51,0.16666666666666666,0.16666666666666666,0.21052631578947367,0.16666666666666666,0.07272727272727272,0.16666666666666666
Glycogen storage disease VI,30301,13,11,20,0,20,35,1,34,0.0,0.09090909090909091,0.0,0.0,0.02857142857142857,0.09090909090909091
Combined oxidative phosphorylation deficiency 30,38594,10,21,10,1,9,37,2,35,0.047619047619047616,0.09523809523809523,0.1,0.047619047619047616,0.05405405405405406,0.09523809523809523
"Cutis laxa, autosomal recessive, type IIB",27841,5,20,30,5,25,27,0,27,0.25,0.0,0.16666666666666666,0.25,0.0,0.0
Multiple mitochondrial dysfunctions syndrome 4,38929,28,59,34,4,30,39,5,34,0.06779661016949153,0.0847457627118644,0.11764705882352941,0.06779661016949153,0.1282051282051282,0.0847457627118644
Renal cysts and diabetes syndrome,30204,1,6,21,1,20,31,1,30,0.16666666666666666,0.16666666666666666,0.047619047619047616,0.16666666666666666,0.03225806451612903,0.16666666666666666
"Neurodevelopemental disorder with hypotonia, feeding difficulties, facial dysmorphism, and brain abnormalities",29640,5,64,32,12,20,41,8,33,0.1875,0.125,0.375,0.1875,0.1951219512195122,0.125
Mucolipidosis IV,27436,2,21,20,2,18,33,2,31,0.09523809523809523,0.09523809523809523,0.1,0.09523809523809523,0.06060606060606061,0.09523809523809523
"Autoimmune polyendocrinopathy syndrome , type I, with or without reversible metaphyseal dysplasia",27834,3,45,72,20,52,19,2,17,0.4444444444444444,0.044444444444444446,0.2777777777777778,0.4444444444444444,0.10526315789473684,0.044444444444444446
Loeys-Dietz syndrome 2,31164,3,92,27,18,9,42,11,31,0.1956521739130435,0.11956521739130435,0.6666666666666666,0.1956521739130435,0.2619047619047619,0.11956521739130435
"Keratoderma, palmoplantar, punctate type IA",30262,10,1,21,1,20,30,0,30,1.0,0.0,0.047619047619047616,1.0,0.0,0.0
"Neurodevelopmental disorder with intracranial hemorrhage, seizures, and spasticity",28189,1,87,34,6,28,42,8,34,0.06896551724137931,0.09195402298850575,0.17647058823529413,0.06896551724137931,0.19047619047619047,0.09195402298850575
Kabuki Syndrome 1,31000,4,130,29,13,16,53,17,36,0.1,0.13076923076923078,0.4482758620689655,0.1,0.32075471698113206,0.13076923076923078
Congenital myopathy 23,38200,21,29,22,2,20,27,3,24,0.06896551724137931,0.10344827586206896,0.09090909090909091,0.06896551724137931,0.1111111111111111,0.10344827586206896
"Cortical dysplasia, complex, with other brain malformations 7",28601,4,13,126,6,120,26,1,25,0.46153846153846156,0.07692307692307693,0.047619047619047616,0.46153846153846156,0.038461538461538464,0.07692307692307693
"Immunodeficiency, common variable, 15",38553,12,15,28,0,28,35,4,31,0.0,0.26666666666666666,0.0,0.0,0.11428571428571428,0.26666666666666666
"Neutropenia, severe congenital, 11, autosomal dominant",30763,18,23,33,5,28,38,5,33,0.21739130434782608,0.21739130434782608,0.15151515151515152,0.21739130434782608,0.13157894736842105,0.21739130434782608
"Spastic paraplegia 7, autosomal recessive",39424,18,13,24,3,21,24,3,21,0.23076923076923078,0.23076923076923078,0.125,0.23076923076923078,0.125,0.23076923076923078
Cornelia de Lange syndrome 3,28431,4,36,26,3,23,46,4,42,0.08333333333333333,0.1111111111111111,0.11538461538461539,0.08333333333333333,0.08695652173913043,0.1111111111111111
"Cutis laxa, autosomal recessive, type IID",27841,5,36,19,4,15,34,1,33,0.1111111111111111,0.027777777777777776,0.21052631578947367,0.1111111111111111,0.029411764705882353,0.027777777777777776
"3-methylglutaconic aciduria with deafness, encephalopathy, and Leigh-like syndrome",31418,4,19,18,5,13,40,1,39,0.2631578947368421,0.05263157894736842,0.2777777777777778,0.2631578947368421,0.025,0.05263157894736842
Noonan syndrome-11,27522,2,23,45,9,36,36,1,35,0.391304347826087,0.043478260869565216,0.2,0.391304347826087,0.027777777777777776,0.043478260869565216
"Stickler syndrome, type I",32565,4,16,23,3,20,11,1,10,0.1875,0.0625,0.13043478260869565,0.1875,0.09090909090909091,0.0625
Proteasome-associated autoinflammatory syndrome 6,29045,4,38,63,4,59,38,3,35,0.10526315789473684,0.07894736842105263,0.06349206349206349,0.10526315789473684,0.07894736842105263,0.07894736842105263
Myoclonic epilepsy of Lafora 2,99971,19,10,43,3,40,34,1,33,0.3,0.1,0.06976744186046512,0.3,0.029411764705882353,0.1
MHC class II deficiency 3,31044,3,18,23,2,21,40,0,40,0.1111111111111111,0.0,0.08695652173913043,0.1111111111111111,0.0,0.0
Bardet-Biedl syndrome 2,27886,5,34,18,2,16,36,5,31,0.058823529411764705,0.14705882352941177,0.1111111111111111,0.058823529411764705,0.1388888888888889,0.14705882352941177
Cornelia de Lange syndrome 6,28431,6,40,25,6,19,50,3,47,0.15,0.075,0.24,0.15,0.06,0.075
EZH1-related neurodevelopmental disorder,32151,1,102,27,8,19,37,5,32,0.0784313725490196,0.049019607843137254,0.2962962962962963,0.0784313725490196,0.13513513513513514,0.049019607843137254
"Cockayne syndrome, type B",27995,10,19,102,9,93,54,5,49,0.47368421052631576,0.2631578947368421,0.08823529411764706,0.47368421052631576,0.09259259259259259,0.2631578947368421
"Ichthyosis, congenital, autosomal recessive 11",39370,23,14,25,1,24,29,1,28,0.07142857142857142,0.07142857142857142,0.04,0.07142857142857142,0.034482758620689655,0.07142857142857142
"Neurodevelopmental disorder with motor abnormalities, seizures, and facial dysmorphism",32066,0,49,22,4,18,30,5,25,0.08163265306122448,0.10204081632653061,0.18181818181818182,0.08163265306122448,0.16666666666666666,0.10204081632653061
"Spastic paraplegia 10, autosomal dominant",38901,13,15,25,3,22,14,3,11,0.2,0.2,0.12,0.2,0.21428571428571427,0.2
"Ehlers-Danlos syndrome, classic-like, 3",94824,21,10,26,1,25,31,1,30,0.1,0.1,0.038461538461538464,0.1,0.03225806451612903,0.1
"Microcephaly 6, primary, autosomal recessive",33109,2,3,17,0,17,26,1,25,0.0,0.3333333333333333,0.0,0.0,0.038461538461538464,0.3333333333333333
Joubert syndrome 30,27986,1,19,133,12,121,1,0,1,0.631578947368421,0.0,0.09022556390977443,0.631578947368421,0.0,0.0
Hajdu-Cheney syndrome,30947,4,9,34,0,34,35,0,35,0.0,0.0,0.0,0.0,0.0,0.0
Smith-Magenis syndrome,27606,2,32,16,4,12,41,3,38,0.125,0.09375,0.25,0.125,0.07317073170731707,0.09375
"Spastic paraplegia 76, autosomal recessive",38455,13,21,16,2,14,33,4,29,0.09523809523809523,0.19047619047619047,0.125,0.09523809523809523,0.12121212121212122,0.19047619047619047
Nail-patella syndrome,29780,2,5,23,0,23,67,1,66,0.0,0.2,0.0,0.0,0.014925373134328358,0.2
Spermatogenic failure 91,29823,10,6,24,1,23,26,3,23,0.16666666666666666,0.5,0.041666666666666664,0.16666666666666666,0.11538461538461539,0.5
Loeys-Dietz syndrome 3,31164,3,26,27,6,21,34,7,27,0.23076923076923078,0.2692307692307692,0.2222222222222222,0.23076923076923078,0.20588235294117646,0.2692307692307692
"Parkinson disease 15, autosomal recessive",27576,4,15,18,3,15,41,5,36,0.2,0.3333333333333333,0.16666666666666666,0.2,0.12195121951219512,0.3333333333333333
"Spondylocostal dysostosis 1, autosomal recessive",29480,4,6,46,5,41,56,0,56,0.8333333333333334,0.0,0.10869565217391304,0.8333333333333334,0.0,0.0
"Generalized epilepsy with febrile seizures plus, type 12",33026,7,9,20,3,17,34,2,32,0.3333333333333333,0.2222222222222222,0.15,0.3333333333333333,0.058823529411764705,0.2222222222222222
Developmental and epileptic encephalopathy 114,28987,1,37,21,8,13,30,1,29,0.21621621621621623,0.02702702702702703,0.38095238095238093,0.21621621621621623,0.03333333333333333,0.02702702702702703
"Intellectual developmental disorder, autosomal recessive 18, with or without epilepsy",28584,6,19,26,2,24,47,2,45,0.10526315789473684,0.10526315789473684,0.07692307692307693,0.10526315789473684,0.0425531914893617,0.10526315789473684
MHC class II deficiency 2,31044,3,19,23,3,20,39,1,38,0.15789473684210525,0.05263157894736842,0.13043478260869565,0.15789473684210525,0.02564102564102564,0.05263157894736842
"Myasthenic syndrome, congenital, 22",30015,2,21,15,2,13,30,5,25,0.09523809523809523,0.23809523809523808,0.13333333333333333,0.09523809523809523,0.16666666666666666,0.23809523809523808
